"ab" = (/obj/structure/closet/secure_closet/bar{req_access_txt = "25"},/obj/item/gun/ballistic/revolver/russian,/turf/open/floor/plasteel/rockvault,/area/crew_quarters/bar)
"ad" = (/obj/machinery/door/window/southleft{dir = 8; name = "Bar Delivery"; req_access_txt = "25"},/obj/structure/window/reinforced,/obj/machinery/navbeacon{codes_txt = "delivery;dir=2"; freq = 1400; location = "Bar"},/obj/effect/turf_decal/delivery,/turf/open/floor/plasteel,/area/crew_quarters/bar)
"al" = (/turf/open/floor/wood,/area/crew_quarters/bar)
"aC" = (/obj/structure/table/wood,/obj/machinery/reagentgrinder,/turf/open/floor/plasteel/rockvault,/area/crew_quarters/bar)
"aH" = (/obj/machinery/atmospherics/pipe/simple/scrubbers/hidden/layer3,/obj/machinery/atmospherics/pipe/simple/supply/hidden/layer1,/obj/structure/disposalpipe/segment,/turf/open/floor/plasteel/showroomfloor,/area/crew_quarters/kitchen/coldroom)
"bf" = (/obj/structure/disposalpipe/segment{dir = 4},/turf/open/floor/wood,/area/crew_quarters/bar)
"bo" = (/obj/machinery/atmospherics/pipe/simple/scrubbers/hidden/layer3,/obj/machinery/atmospherics/pipe/simple/supply/hidden/layer1,/obj/structure/disposalpipe/segment,/obj/machinery/door/airlock/maintenance{name = "Kitchen Maintenance"; req_access_txt = "28"},/obj/machinery/door/firedoor/border_only,/obj/machinery/door/firedoor/border_only{dir = 1},/turf/open/floor/plating,/area/maintenance/department/crew_quarters/bar)
"bv" = (/obj/machinery/atmospherics/pipe/simple/scrubbers/hidden/layer3{dir = 8},/obj/machinery/atmospherics/components/unary/vent_pump/on/layer1{dir = 4; icon_state = "vent_map_on-1"},/turf/open/floor/carpet,/area/crew_quarters/bar)
"bC" = (/obj/structure/table/reinforced,/obj/item/clothing/head/hardhat/cakehat,/turf/open/floor/carpet,/area/crew_quarters/bar)
"bY" = (/obj/machinery/processor,/obj/machinery/firealarm{dir = 8; pixel_x = 26},/turf/open/floor/plasteel/cafeteria,/area/crew_quarters/kitchen)
"cz" = (/turf/closed/wall,/area/crew_quarters/kitchen/coldroom)
"dO" = (/obj/machinery/requests_console{department = "Bar"; departmentType = 2; pixel_x = 30; receive_ore_updates = 1},/obj/machinery/camera{c_tag = "Bar"; dir = 8; network = list("SS13")},/turf/open/floor/wood,/area/crew_quarters/bar)
"eG" = (/obj/structure/sink/kitchen{pixel_y = 28},/obj/structure/disposalpipe/segment{dir = 10},/obj/structure/sign/plaques/deempisi{pixel_y = 38},/turf/open/floor/wood,/area/crew_quarters/bar)
"gi" = (/obj/effect/landmark/start/bartender,/turf/open/floor/wood,/area/crew_quarters/bar)
"gr" = (/obj/structure/disposalpipe/segment{dir = 6},/obj/structure/chair/stool/bar,/turf/open/floor/carpet,/area/crew_quarters/bar)
"gY" = (/obj/structure/chair/americandiner{dir = 4; icon_state = "americhair"; tag = ""},/turf/open/floor/carpet,/area/crew_quarters/bar)
"hw" = (/obj/effect/landmark/event_spawn,/turf/open/floor/plasteel/cafeteria,/area/crew_quarters/kitchen)
"hy" = (/obj/structure/disposalpipe/segment{dir = 5},/turf/open/floor/wood,/area/crew_quarters/bar)
"hD" = (/obj/machinery/camera{c_tag = "Theatre Stage"; dir = 2},/obj/item/radio/intercom{pixel_y = 25},/obj/machinery/atmospherics/pipe/simple/scrubbers/hidden/layer3{dir = 8},/turf/open/floor/carpet,/area/crew_quarters/bar)
"hH" = (/obj/machinery/camera{c_tag = "Bar West"; dir = 4; network = list("SS13")},/turf/open/floor/carpet,/area/crew_quarters/bar)
"it" = (/obj/machinery/atmospherics/components/unary/vent_pump/on/layer1{dir = 1},/turf/open/floor/carpet,/area/crew_quarters/bar)
"iu" = (/obj/machinery/door/firedoor/border_only{dir = 4},/obj/machinery/door/firedoor/border_only{dir = 8},/obj/machinery/door/airlock/public/glass{name = "Diner"},/turf/open/floor/plasteel,/area/crew_quarters/bar)
"iP" = (/obj/structure/table/reinforced,/obj/machinery/door/firedoor,/obj/machinery/door/poddoor/preopen{id = "kitchenwindow"; name = "kitchen shutters"},/turf/open/floor/plasteel/cafeteria,/area/crew_quarters/kitchen)
"jn" = (/obj/machinery/atmospherics/components/unary/vent_pump/on/layer1{dir = 8; icon_state = "vent_map_on-1"},/obj/effect/spawner/lootdrop/mob/kitchen_animal,/turf/open/floor/plasteel/showroomfloor,/area/crew_quarters/kitchen/coldroom)
"jD" = (/obj/structure/table/reinforced,/obj/item/clothing/head/that,/turf/open/floor/wood,/area/crew_quarters/bar)
"jJ" = (/obj/structure/sink/kitchen{pixel_y = 28},/obj/machinery/food_cart,/turf/open/floor/plasteel/cafeteria,/area/crew_quarters/kitchen)
"ka" = (/obj/machinery/atmospherics/pipe/simple/supply/hidden/layer1{dir = 8},/turf/open/floor/carpet,/area/crew_quarters/bar)
"kw" = (/obj/machinery/vending/wardrobe/chef_wardrobe,/obj/machinery/light/small{dir = 4},/turf/open/floor/plasteel/showroomfloor,/area/crew_quarters/kitchen/coldroom)
"kY" = (/obj/machinery/smartfridge/drinks,/turf/open/floor/wood,/area/crew_quarters/bar)
"le" = (/obj/machinery/door/airlock/maintenance{name = "Bar Maintenance"; req_access_txt = "12"},/obj/machinery/door/firedoor/border_only{dir = 8},/obj/machinery/door/firedoor/border_only{dir = 4},/turf/open/floor/plating,/area/maintenance/department/crew_quarters/bar)
"lz" = (/obj/structure/chair/americandiner{dir = 8; icon_state = "americhair"; tag = ""},/turf/open/floor/carpet,/area/crew_quarters/bar)
"lU" = (/obj/machinery/light{dir = 1},/obj/machinery/atmospherics/components/unary/vent_scrubber/on/layer3{dir = 4; icon_state = "scrub_map_on-3"},/turf/open/floor/carpet,/area/crew_quarters/bar)
"ml" = (/obj/structure/chair/office/light{dir = 1},/turf/open/floor/plasteel,/area/crew_quarters/bar)
"mE" = (/obj/machinery/atmospherics/components/unary/vent_scrubber/on/layer3{dir = 1; icon_state = "scrub_map_on-3"},/turf/open/floor/carpet,/area/crew_quarters/bar)
"mH" = (/obj/machinery/button/door{id = "kitchenwindow"; name = "Bar Shutter Control"; pixel_y = -26; req_access_txt = "28"},/obj/machinery/light,/obj/structure/disposalpipe/segment{dir = 4},/turf/open/floor/plasteel/cafeteria,/area/crew_quarters/kitchen)
"mV" = (/obj/machinery/atmospherics/pipe/simple/scrubbers/hidden/layer3{dir = 8},/obj/machinery/atmospherics/pipe/simple/supply/hidden/layer1{dir = 8},/turf/open/floor/carpet,/area/crew_quarters/bar)
"nd" = (/obj/structure/table,/obj/item/book/manual/chef_recipes,/obj/item/book/manual/wiki/cooking_to_serve_man{pixel_x = -4; pixel_y = 4},/turf/open/floor/plasteel/cafeteria,/area/crew_quarters/kitchen)
"nn" = (/obj/machinery/door/airlock/public/glass{name = "Kitchen"; req_access_txt = "28"},/obj/machinery/door/firedoor/border_only{dir = 8},/obj/machinery/door/firedoor/border_only{dir = 4},/turf/open/floor/plasteel/cafeteria,/area/crew_quarters/kitchen)
"nr" = (/obj/structure/disposalpipe/segment,/mob/living/carbon/monkey/punpun,/turf/open/floor/wood,/area/crew_quarters/bar)
"nJ" = (/obj/machinery/door/firedoor/border_only{dir = 1},/obj/machinery/door/firedoor/border_only,/obj/machinery/door/airlock/public/glass{name = "Diner"},/turf/open/floor/plasteel,/area/crew_quarters/bar)
"oK" = (/obj/machinery/atmospherics/pipe/simple/scrubbers/hidden/layer3{dir = 1},/obj/machinery/atmospherics/pipe/simple/supply/hidden/layer1,/turf/open/floor/carpet,/area/crew_quarters/bar)
"pB" = (/obj/effect/landmark/event_spawn,/turf/open/floor/carpet,/area/crew_quarters/bar)
"pG" = (/obj/structure/table/wood,/obj/item/reagent_containers/food/drinks/shaker,/obj/item/stack/spacecash/c1000,/obj/item/stack/spacecash/c1000,/obj/item/stack/spacecash/c1000,/obj/item/stack/spacecash/c1000,/obj/item/coin/gold,/turf/open/floor/plasteel/rockvault,/area/crew_quarters/bar)
"qc" = (/obj/structure/table,/obj/item/reagent_containers/food/condiment/saltshaker{pixel_x = -9; pixel_y = 9},/obj/item/reagent_containers/food/condiment/saltshaker{pixel_x = -3; pixel_y = 9},/obj/item/reagent_containers/food/condiment/peppermill{dir = 1; pixel_x = -3},/obj/item/reagent_containers/food/condiment/peppermill{pixel_x = -9},/obj/item/sharpener{pixel_x = 8},/turf/open/floor/plasteel/cafeteria,/area/crew_quarters/kitchen)
"qt" = (/obj/structure/reagent_dispensers/cooking_oil,/turf/open/floor/plasteel/cafeteria,/area/crew_quarters/kitchen)
"qw" = (/obj/machinery/door/airlock/maintenance{name = "Bar Maintenance"; req_access_txt = "25"},/obj/machinery/door/firedoor/border_only{dir = 1},/obj/machinery/door/firedoor/border_only,/obj/machinery/atmospherics/pipe/simple/supply/hidden/layer1,/obj/machinery/atmospherics/pipe/simple/scrubbers/hidden/layer3,/obj/structure/disposalpipe/segment,/turf/open/floor/plating,/area/maintenance/department/crew_quarters/bar)
"rc" = (/obj/machinery/button/door{id = "kitchen"; name = "Kitchen Shutters Control"; pixel_x = -1; pixel_y = -24; req_access_txt = "28"},/obj/structure/disposalpipe/junction/yjunction{dir = 1},/turf/open/floor/plasteel/cafeteria,/area/crew_quarters/kitchen)
"rz" = (/obj/machinery/vending/wardrobe/bar_wardrobe,/turf/open/floor/plasteel/rockvault,/area/crew_quarters/bar)
"rV" = (/turf/closed/wall,/area/crew_quarters/bar)
"sf" = (/obj/effect/landmark/start/cook,/turf/open/floor/plasteel/cafeteria,/area/crew_quarters/kitchen)
"so" = (/obj/machinery/atmospherics/pipe/simple/scrubbers/hidden/layer3{dir = 1},/obj/machinery/atmospherics/pipe/simple/supply/hidden/layer1{dir = 5},/turf/open/floor/carpet,/area/crew_quarters/bar)
"su" = (/obj/structure/chair/stool/bar,/turf/open/floor/carpet,/area/crew_quarters/bar)
"sV" = (/obj/structure/disposalpipe/segment{dir = 5},/obj/machinery/atmospherics/pipe/manifold/supply/hidden/layer1{dir = 4},/obj/machinery/atmospherics/pipe/manifold/scrubbers/hidden/layer3{dir = 4},/turf/open/floor/carpet,/area/crew_quarters/bar)
"tn" = (/obj/effect/spawner/structure/window/reinforced,/turf/open/floor/plating,/area/crew_quarters/bar)
"ts" = (/obj/machinery/light,/obj/machinery/disposal/bin,/obj/structure/disposalpipe/trunk{dir = 8},/turf/open/floor/plasteel/cafeteria,/area/crew_quarters/kitchen)
"tu" = (/obj/machinery/reagentgrinder,/obj/structure/table,/obj/machinery/requests_console{department = "Kitchen"; departmentType = 2; pixel_x = 30},/turf/open/floor/plasteel/cafeteria,/area/crew_quarters/kitchen)
"tK" = (/obj/machinery/airalarm{dir = 2; pixel_y = 24},/turf/open/floor/carpet,/area/crew_quarters/bar)
"tY" = (/obj/machinery/computer/security/telescreen/entertainment{pixel_x = 32},/turf/open/floor/carpet,/area/crew_quarters/bar)
"ud" = (/obj/structure/noticeboard{desc = "A board for pinning important notices upon."; dir = 1; name = "notice board"; pixel_y = -27},/turf/open/floor/carpet,/area/crew_quarters/bar)
"ui" = (/obj/structure/table,/obj/item/storage/box/donkpockets{pixel_x = 3; pixel_y = 5},/obj/item/storage/box/donkpockets{pixel_x = 2; pixel_y = 1},/obj/item/reagent_containers/glass/beaker{pixel_x = -5; pixel_y = 3},/turf/open/floor/plasteel/cafeteria,/area/crew_quarters/kitchen)
"un" = (/obj/machinery/light/small{dir = 4},/obj/structure/rack,/obj/item/stack/spacecash/c500,/obj/item/stack/spacecash/c500,/obj/item/stack/spacecash/c500,/obj/item/stack/spacecash/c500,/obj/item/coin/silver,/obj/item/coin/silver,/turf/open/floor/wood,/area/crew_quarters/bar)
"uw" = (/obj/machinery/deepfryer,/turf/open/floor/plasteel/cafeteria,/area/crew_quarters/kitchen)
"vb" = (/obj/structure/table,/obj/item/kitchen/rollingpin,/turf/open/floor/plasteel/cafeteria,/area/crew_quarters/kitchen)
"vx" = (/obj/machinery/firealarm{dir = 1; pixel_y = -26},/obj/machinery/light,/turf/open/floor/carpet,/area/crew_quarters/bar)
"vX" = (/obj/machinery/computer/security/telescreen/entertainment{pixel_x = 32},/obj/machinery/disposal/bin,/obj/structure/disposalpipe/trunk{dir = 1},/turf/open/floor/carpet,/area/crew_quarters/bar)
"wk" = (/obj/structure/extinguisher_cabinet{pixel_x = -5; pixel_y = 30},/turf/open/floor/plasteel/cafeteria,/area/crew_quarters/kitchen)
"wA" = (/obj/machinery/airalarm{dir = 1; pixel_y = -24},/turf/open/floor/carpet,/area/crew_quarters/bar)
"wC" = (/obj/machinery/atmospherics/pipe/manifold/scrubbers/hidden/layer3{dir = 8},/obj/machinery/atmospherics/pipe/simple/scrubbers/hidden/layer3,/obj/machinery/atmospherics/pipe/simple/supply/hidden/layer1,/obj/structure/disposalpipe/segment,/turf/open/floor/plasteel/showroomfloor,/area/crew_quarters/kitchen/coldroom)
"wG" = (/obj/effect/turf_decal/loading_area,/obj/machinery/airalarm{dir = 8; pixel_x = 24},/turf/open/floor/plasteel/showroomfloor,/area/crew_quarters/kitchen/coldroom)
"wX" = (/obj/structure/table/reinforced,/turf/open/floor/carpet,/area/crew_quarters/bar)
"xE" = (/obj/machinery/vending/dinnerware{contraband = list(/obj/item/kitchen/rollingpin = 2, /obj/item/kitchen/knife/butcher = 2, /obj/item/reagent_containers/food/condiment/flour = 4)},/turf/open/floor/plasteel/cafeteria,/area/crew_quarters/kitchen)
"xJ" = (/obj/machinery/icecream_vat,/turf/open/floor/plasteel/showroomfloor,/area/crew_quarters/kitchen/coldroom)
"xK" = (/obj/structure/table,/obj/machinery/chem_dispenser/drinks/beer{dir = 8},/obj/machinery/firealarm{dir = 8; pixel_x = 26},/turf/open/floor/wood,/area/crew_quarters/bar)
"zd" = (/obj/structure/disposalpipe/segment,/obj/machinery/atmospherics/pipe/simple/supply/hidden/layer1,/obj/machinery/atmospherics/pipe/simple/scrubbers/hidden/layer3,/obj/machinery/door/airlock{name = "Kitchen Cold Room"; req_access_txt = "28"},/turf/open/floor/plasteel/showroomfloor,/area/crew_quarters/kitchen/coldroom)
"zN" = (/turf/template_noop,/area/template_noop)
"zW" = (/obj/machinery/atmospherics/components/unary/vent_scrubber/on/layer3{dir = 8; icon_state = "scrub_map_on-3"},/turf/open/floor/plasteel/showroomfloor,/area/crew_quarters/kitchen/coldroom)
"zX" = (/obj/structure/table/reinforced,/obj/machinery/door/window/northright{name = "Teller's Desk"},/obj/machinery/door/window/southright{name = "Teller's Desk"; req_access_txt = "25"; req_one_access_txt = null},/turf/open/floor/plasteel,/area/crew_quarters/bar)
"Ah" = (/obj/machinery/light{dir = 8},/turf/open/floor/carpet,/area/crew_quarters/bar)
"AB" = (/turf/closed/wall{icon = 'icons/turf/walls/reinforced_wall.dmi'; icon_state = "r_wall"},/area/crew_quarters/bar)
"AV" = (/obj/effect/landmark/event_spawn,/obj/effect/spawner/structure/window/reinforced,/turf/open/floor/plating,/area/crew_quarters/bar)
"Bt" = (/obj/machinery/door/airlock{name = "Teller's desk"; req_access_txt = "25"},/obj/machinery/door/firedoor/border_only,/obj/machinery/door/firedoor/border_only{dir = 1},/turf/open/floor/plasteel,/area/crew_quarters/bar)
"Bx" = (/obj/structure/sign/barsign,/obj/effect/spawner/structure/window/reinforced,/turf/open/floor/plating,/area/crew_quarters/bar)
"BJ" = (/obj/machinery/atmospherics/pipe/simple/supply/hidden/layer1{dir = 8},/obj/machinery/atmospherics/components/unary/vent_scrubber/on/layer3{dir = 4},/turf/open/floor/plasteel/cafeteria,/area/crew_quarters/kitchen)
"CA" = (/turf/open/floor/plasteel/showroomfloor,/area/crew_quarters/kitchen/coldroom)
"CB" = (/obj/structure/chair/americandiner{dir = 8; icon_state = "americhair"; tag = ""},/obj/machinery/atmospherics/pipe/simple/supply/hidden/layer1,/turf/open/floor/carpet,/area/crew_quarters/bar)
"CD" = (/obj/machinery/disposal/bin,/obj/structure/disposalpipe/trunk{dir = 4},/obj/structure/window/reinforced{dir = 8},/turf/open/floor/wood,/area/crew_quarters/bar)
"CP" = (/turf/open/floor/plasteel/cafeteria,/area/crew_quarters/kitchen)
"Db" = (/obj/structure/chair/office/light{dir = 4},/turf/open/floor/plasteel,/area/crew_quarters/bar)
"El" = (/obj/machinery/door/firedoor/border_only{dir = 8},/obj/machinery/door/firedoor/border_only{dir = 4},/obj/structure/disposalpipe/segment{dir = 4},/obj/machinery/door/airlock{icon = 'icons/obj/doors/airlocks/vault/vault.dmi'; name = "Casino Vault"; req_access_txt = "25"},/turf/open/floor/plasteel/rockvault,/area/crew_quarters/bar)
"EE" = (/obj/structure/table,/obj/item/reagent_containers/food/snacks/mint,/turf/open/floor/plasteel/cafeteria,/area/crew_quarters/kitchen)
"EG" = (/obj/machinery/atmospherics/pipe/simple/supply/hidden/layer1,/turf/open/floor/carpet,/area/crew_quarters/bar)
"Fg" = (/obj/structure/table/wood/poker,/turf/open/floor/carpet/black,/area/crew_quarters/bar)
"Fi" = (/obj/machinery/light/small,/turf/open/floor/plasteel,/area/crew_quarters/bar)
"Fn" = (/obj/structure/reagent_dispensers/beerkeg,/turf/open/floor/plasteel/rockvault,/area/crew_quarters/bar)
"Fx" = (/obj/structure/disposalpipe/segment{dir = 5},/obj/machinery/atmospherics/pipe/simple/supply/hidden/layer1{dir = 9},/obj/machinery/atmospherics/pipe/simple/scrubbers/hidden/layer3{dir = 9},/turf/open/floor/plasteel/cafeteria,/area/crew_quarters/kitchen)
"Fy" = (/obj/structure/table/reinforced,/obj/machinery/door/firedoor,/obj/machinery/door/poddoor/preopen{id = "kitchenwindow"; name = "kitchen shutters"},/obj/structure/disposalpipe/segment{dir = 4},/turf/open/floor/plasteel/cafeteria,/area/crew_quarters/kitchen)
"Fz" = (/turf/closed/wall,/area/crew_quarters/theatre)
"FD" = (/obj/structure/table/reinforced,/turf/open/floor/plasteel,/area/crew_quarters/bar)
"FV" = (/obj/machinery/camera{c_tag = "Kitchen Cold Room"},/obj/machinery/chem_master/condimaster{name = "CondiMaster Neo"},/turf/open/floor/plasteel/showroomfloor,/area/crew_quarters/kitchen/coldroom)
"Ga" = (/obj/structure/table/reinforced,/obj/machinery/chem_dispenser/drinks,/obj/machinery/door/window/westright,/turf/open/floor/wood,/area/crew_quarters/bar)
"Gc" = (/obj/structure/disposalpipe/segment,/obj/machinery/atmospherics/pipe/simple/scrubbers/hidden/layer3,/obj/machinery/atmospherics/pipe/simple/supply/hidden/layer1,/turf/open/floor/plasteel/cafeteria,/area/crew_quarters/kitchen)
"Gq" = (/obj/structure/disposalpipe/segment,/turf/open/floor/plasteel/cafeteria,/area/crew_quarters/kitchen)
"GK" = (/obj/machinery/door/airlock/maintenance{name = "Bar Maintenance"; req_access_txt = "12"},/obj/machinery/door/firedoor/border_only,/obj/machinery/door/firedoor/border_only{dir = 1},/obj/machinery/atmospherics/pipe/simple/supply/hidden/layer1,/obj/machinery/atmospherics/pipe/simple/scrubbers/hidden/layer3{dir = 1},/obj/structure/disposalpipe/segment,/turf/open/floor/plating,/area/maintenance/department/crew_quarters/bar)
"GZ" = (/obj/machinery/door/airlock{name = "Theatre Backstage"; req_access_txt = "46"},/obj/machinery/door/firedoor/border_only{dir = 1},/obj/machinery/door/firedoor/border_only,/turf/open/floor/plasteel,/area/crew_quarters/theatre)
"Hh" = (/turf/closed/wall,/area/crew_quarters/dorms/a)
"Hm" = (/turf/open/floor/plasteel,/area/crew_quarters/bar)
"Hv" = (/obj/machinery/atmospherics/components/unary/vent_pump/on/layer1{dir = 4; icon_state = "vent_map_on-1"},/obj/effect/landmark/start/cook,/turf/open/floor/plasteel/cafeteria,/area/crew_quarters/kitchen)
"HJ" = (/obj/structure/table,/obj/item/reagent_containers/food/condiment/enzyme{layer = 5},/obj/item/stack/packageWrap,/turf/open/floor/plasteel/cafeteria,/area/crew_quarters/kitchen)
"IE" = (/obj/machinery/computer/security/telescreen/entertainment{pixel_y = -32},/turf/open/floor/carpet,/area/crew_quarters/bar)
"IP" = (/obj/structure/table/reinforced,/obj/machinery/door/poddoor/shutters/preopen{id = "kitchen"; name = "kitchen shutters"},/obj/machinery/door/firedoor,/turf/open/floor/plasteel/cafeteria,/area/crew_quarters/kitchen)
"Jm" = (/obj/machinery/atmospherics/pipe/simple/scrubbers/hidden/layer3{dir = 5},/turf/open/floor/carpet,/area/crew_quarters/bar)
"JP" = (/obj/structure/disposalpipe/segment{dir = 4},/turf/open/floor/plasteel/cafeteria,/area/crew_quarters/kitchen)
"KA" = (/obj/structure/window/reinforced{dir = 8},/obj/machinery/door/window/southleft{base_state = "left"; dir = 2; icon_state = "left"; name = "Kitchen Delivery"; req_access_txt = "28"},/obj/effect/turf_decal/delivery,/obj/machinery/navbeacon{codes_txt = "delivery;dir=2"; freq = 1400; location = "Kitchen"},/turf/open/floor/plasteel,/area/crew_quarters/kitchen/coldroom)
"KH" = (/obj/machinery/atmospherics/components/unary/vent_pump/on/layer1{dir = 4; icon_state = "vent_map_on-1"},/obj/structure/disposalpipe/segment{dir = 4},/turf/open/floor/plasteel/rockvault,/area/crew_quarters/bar)
"KN" = (/obj/machinery/atmospherics/pipe/simple/scrubbers/hidden/layer3{dir = 10},/turf/open/floor/carpet,/area/crew_quarters/bar)
"LQ" = (/obj/structure/table/reinforced,/obj/machinery/door/window/eastleft{dir = 8; name = "Kitchen Window"; req_access_txt = "28"},/obj/machinery/door/window/eastleft{name = "Hydroponics Window"; req_one_access_txt = "30;35"},/obj/machinery/door/firedoor/border_only{dir = 4},/obj/machinery/door/firedoor/border_only{dir = 8},/turf/open/floor/plasteel/cafeteria,/area/crew_quarters/kitchen)
"Ms" = (/obj/machinery/atmospherics/components/unary/vent_scrubber/on/layer3{dir = 1; icon_state = "scrub_map_on-3"},/obj/machinery/atmospherics/pipe/simple/supply/hidden/layer1,/obj/structure/disposalpipe/segment,/turf/open/floor/plasteel/rockvault,/area/crew_quarters/bar)
"Om" = (/obj/structure/table/wood/poker,/obj/item/toy/cards/deck{pixel_x = 2},/turf/open/floor/carpet/black,/area/crew_quarters/bar)
"OB" = (/obj/structure/table,/obj/machinery/microwave{pixel_y = 6},/turf/open/floor/plasteel/cafeteria,/area/crew_quarters/kitchen)
"Pn" = (/obj/machinery/atmospherics/pipe/simple/supply/hidden/layer1,/obj/machinery/atmospherics/pipe/simple/scrubbers/hidden/layer3{dir = 1},/turf/open/floor/carpet,/area/crew_quarters/bar)
"PG" = (/obj/machinery/atmospherics/pipe/manifold/supply/hidden/layer1{dir = 8},/obj/machinery/atmospherics/pipe/simple/scrubbers/hidden/layer3,/obj/structure/disposalpipe/segment,/turf/open/floor/plasteel/showroomfloor,/area/crew_quarters/kitchen/coldroom)
"PL" = (/obj/machinery/light/small{dir = 4},/obj/machinery/disposal/bin,/obj/structure/disposalpipe/trunk{dir = 8},/turf/open/floor/carpet,/area/crew_quarters/bar)
"PX" = (/obj/machinery/vending/boozeomat,/turf/open/floor/wood,/area/crew_quarters/bar)
"Qd" = (/obj/structure/disposalpipe/segment,/turf/open/floor/wood,/area/crew_quarters/bar)
"QG" = (/obj/machinery/atmospherics/pipe/simple/supply/hidden/layer1{dir = 8},/turf/open/floor/plasteel/cafeteria,/area/crew_quarters/kitchen)
"QR" = (/obj/machinery/light/small,/obj/effect/landmark/xeno_spawn,/turf/open/floor/plasteel/rockvault,/area/crew_quarters/bar)
"Rb" = (/obj/structure/closet/secure_closet/freezer/meat,/obj/item/storage/box/mixedcubes,/obj/item/storage/box/mixedcubes,/turf/open/floor/plasteel/showroomfloor,/area/crew_quarters/kitchen/coldroom)
"Rr" = (/obj/machinery/gibber,/turf/open/floor/plasteel/showroomfloor,/area/crew_quarters/kitchen/coldroom)
"Rz" = (/obj/structure/closet/secure_closet/freezer/kitchen,/obj/machinery/airalarm{pixel_y = 24},/obj/machinery/light{dir = 1},/turf/open/floor/plasteel/cafeteria,/area/crew_quarters/kitchen)
"Sd" = (/obj/structure/plasticflaps/opaque,/turf/open/floor/plasteel,/area/crew_quarters/bar)
"Sf" = (/obj/effect/landmark/event_spawn,/obj/effect/spawner/xmastree{pixel_x = -16},/turf/open/floor/carpet,/area/crew_quarters/bar)
"Ss" = (/obj/item/stack/sheet/metal/fifty,/obj/item/stack/sheet/glass/fifty,/obj/item/stack/cable_coil,/obj/item/flashlight/lamp,/obj/item/flashlight/lamp/green,/obj/structure/closet/secure_closet/bartender,/turf/open/floor/plasteel/rockvault,/area/crew_quarters/bar)
"SS" = (/obj/structure/extinguisher_cabinet{pixel_y = -30},/obj/machinery/camera{c_tag = "Bar South"; dir = 1},/turf/open/floor/carpet,/area/crew_quarters/bar)
"ST" = (/obj/structure/table/reinforced,/obj/item/book/manual/wiki/barman_recipes,/obj/item/reagent_containers/glass/rag,/turf/open/floor/wood,/area/crew_quarters/bar)
"Tk" = (/obj/structure/table/reinforced,/obj/machinery/door/firedoor,/obj/machinery/door/poddoor/shutters/preopen{id = "kitchen"; name = "kitchen shutters"},/turf/open/floor/plasteel/cafeteria,/area/crew_quarters/kitchen)
"Tw" = (/obj/machinery/atmospherics/pipe/simple/supply/hidden/layer1{dir = 9},/obj/structure/disposalpipe/segment{dir = 9},/turf/open/floor/plasteel/rockvault,/area/crew_quarters/bar)
"TU" = (/obj/structure/table/reinforced,/obj/machinery/door/window/southright{dir = 8; name = "Teller's Desk"; req_access_txt = "25"; req_one_access_txt = null},/obj/machinery/door/window/northright{dir = 4; name = "Teller's Desk"},/turf/open/floor/plasteel,/area/crew_quarters/bar)
"TZ" = (/obj/machinery/atmospherics/pipe/simple/supply/hidden/layer1{dir = 10},/turf/open/floor/carpet,/area/crew_quarters/bar)
"Uj" = (/obj/structure/kitchenspike,/turf/open/floor/plasteel/showroomfloor,/area/crew_quarters/kitchen/coldroom)
"Un" = (/obj/structure/table/reinforced,/obj/machinery/door/firedoor,/obj/machinery/door/poddoor/shutters/preopen{id = "kitchen"; name = "kitchen shutters"},/obj/item/storage/box/fancy/donut_box,/turf/open/floor/plasteel/cafeteria,/area/crew_quarters/kitchen)
"Ut" = (/obj/machinery/door/window/southright{name = "Bar Door"; req_one_access_txt = "25;28"},/obj/machinery/light{dir = 4},/turf/open/floor/wood,/area/crew_quarters/bar)
"UK" = (/obj/machinery/light/small{dir = 8},/turf/open/floor/carpet,/area/crew_quarters/bar)
"UP" = (/obj/structure/table/reinforced,/obj/machinery/door/firedoor,/obj/machinery/door/poddoor/preopen{id = "kitchenwindow"; name = "kitchen shutters"},/obj/item/storage/box/fancy/donut_box,/turf/open/floor/plasteel/cafeteria,/area/crew_quarters/kitchen)
"Vn" = (/obj/machinery/holopad,/turf/open/floor/carpet,/area/crew_quarters/bar)
"VK" = (/obj/machinery/computer/slot_machine/casino,/turf/open/floor/carpet/black,/area/crew_quarters/bar)
"Wv" = (/turf/closed/wall,/area/crew_quarters/kitchen)
"WQ" = (/obj/machinery/atmospherics/pipe/simple/supply/hidden/layer1,/obj/machinery/atmospherics/pipe/simple/scrubbers/hidden/layer3,/obj/structure/disposalpipe/segment,/turf/open/floor/plasteel/rockvault,/area/crew_quarters/bar)
"Xb" = (/obj/machinery/light,/turf/open/floor/carpet,/area/crew_quarters/bar)
"Xd" = (/obj/structure/chair/americandiner{dir = 4; icon_state = "americhair"; tag = ""},/obj/machinery/atmospherics/pipe/simple/scrubbers/hidden/layer3{dir = 1},/turf/open/floor/carpet,/area/crew_quarters/bar)
"XD" = (/obj/structure/plasticflaps{opacity = 1},/turf/open/floor/plasteel,/area/crew_quarters/kitchen/coldroom)
"Yb" = (/obj/structure/disposalpipe/segment{dir = 10},/turf/open/floor/plasteel/cafeteria,/area/crew_quarters/kitchen)
"Yc" = (/obj/machinery/smartfridge,/turf/open/floor/plasteel/cafeteria,/area/crew_quarters/kitchen)
"YF" = (/obj/structure/closet/secure_closet/freezer/kitchen,/turf/open/floor/plasteel/cafeteria,/area/crew_quarters/kitchen)
"YG" = (/obj/structure/disposalpipe/segment{dir = 4},/obj/item/storage/secure/safe{pixel_x = 5; pixel_y = 32},/turf/open/floor/wood,/area/crew_quarters/bar)
"YX" = (/turf/open/floor/carpet,/area/crew_quarters/bar)
"ZA" = (/obj/structure/table/reinforced,/turf/open/floor/wood,/area/crew_quarters/bar)

(1,1,1) = {"
HhFzFzFzFzFzGZFzrVGKrVrVzNzNzNzNzNzNzNzNzNzNzNzNzN
HhYXYXtKlUhDbvmVmVsVPLrVzNzNzNzNzNzNzNzNzNzNzNzNzN
HhsuVKsuVKsuVKsuVKPnYXlezNzNzNzNzNzNzNzNzNzNzNzNzN
HhsuVKsuVKsuVKsuVKPntYrVrVrVrVrVzNzNzNzNzNzNzNzNzN
rVsuVKsuVKsuVKsuVKPnYXCDYGeGxKABABqwSdABczboczXDcz
iuYXYXYXYXYXYXYXYXoKYXGaalQdunABpGWQadABRbaHFVKAcz
iuYXYXYXYXYXpBYXYXoKsuZAalnrPXABaCMsFnABxJaHCAwGcz
rVYXYXsusuYXYXsusuoKsujDgihybfElKHTwabABUjwCzWkwcz
tnUKYXFgFgYXYXFgFgoKsuZAalaldOABSsQRrzABUjPGjnRrcz
rVYXgYOmFgYXgYOmFgoKsuZASTkYUtABABABABABczzdczczcz
rVhHYXFgFgYXYXFgFgPnVnsusuYXYXnnCPqtxEjJwkGcRzYFWv
AVAhYXsusuYXYXsususokakaTZYXYXiPCPCPHvQGBJFxYbCPYc
rVYXYXYXIEYXYXYXYXJmKNYXEGYXsuiPCPuwEEqcndOBGqCPLQ
rVBtzXtnrVYXYXYXYXYXXdbCCBYXsuUPCPuwvbHJuiOBGqbYWv
rVHmmlFDtnYXYXYXSfYXmEYXitYXsuiPCPCPCPhwsfCPGqtuWv
rVHmHmDbTUYXYXYXYXYXgYwXlzYXgrFymHJPJPJPJPJPrctsWv
rVFDFiHmrVvxYXYXYXYXSSudwAXbvXWvWvTkTkUnIPIPWvWvWv
rVrVrVrVrVrVnJBxtnnJrVrVrVrVrVWvzNzNzNzNzNzNzNzNzN
"}
