//MAP CONVERTED BY dmm2tgm.py THIS HEADER COMMENT PREVENTS RECONVERSION, DO NOT REMOVE
"a" = (
/turf/open/floor/plating/asteroid/basalt/lava_land_surface,
/area/lavaland/surface/outdoors/explored)
"b" = (
/turf/closed/wall/mineral/silver,
/area/ruin/powered{
	name = "King Goat Lair"
	})
"c" = (
/turf/closed/wall/mineral/gold,
/area/ruin/powered{
	name = "King Goat Lair"
	})
"d" = (
/obj/structure/mineral_door/transparent/diamond{
	sheetAmount = 1
	},
/turf/open/floor/mineral/silver,
/area/ruin/powered{
	name = "King Goat Lair"
	})
"e" = (
/obj/machinery/light{
	dir = 1
	},
/turf/open/floor/mineral/gold,
/area/ruin/powered{
	name = "King Goat Lair"
	})
"f" = (
/obj/machinery/light{
	dir = 8
	},
/turf/open/floor/mineral/gold,
/area/ruin/powered{
	name = "King Goat Lair"
	})
"g" = (
/turf/open/floor/mineral/diamond,
/area/ruin/powered{
	name = "King Goat Lair"
	})
"h" = (
/turf/closed/indestructible/riveted/uranium,
/area/ruin/powered{
	name = "King Goat Arena";
	noteleport = 1
	})
"i" = (
/turf/open/indestructible/hotelwood{
	desc = "Very rich floor made out of pure diamond! This floor seems indestructible for some reason...";
	icon_state = "diamond";
	name = "diamond floor"
	},
/area/ruin/powered{
	name = "King Goat Arena";
	noteleport = 1
	})
"j" = (
/obj/structure/chair/bronze,
/obj/machinery/light{
	dir = 1
	},
/mob/living/simple_animal/hostile/retaliate/goat/king,
/turf/open/indestructible/hotelwood{
	desc = "Very rich floor made out of pure diamond! This floor seems indestructible for some reason...";
	icon_state = "diamond";
	name = "diamond floor"
	},
/area/ruin/powered{
	name = "King Goat Arena";
	noteleport = 1
	})
"k" = (
/mob/living/simple_animal/hostile/retaliate/goat/guard/master,
/turf/open/indestructible/hotelwood{
	desc = "Very rich floor made out of pure diamond! This floor seems indestructible for some reason...";
	icon_state = "diamond";
	name = "diamond floor"
	},
/area/ruin/powered{
	name = "King Goat Arena";
	noteleport = 1
	})
"l" = (
/obj/machinery/light{
	dir = 8
	},
/turf/open/indestructible/hotelwood{
	desc = "Very rich floor made out of pure diamond! This floor seems indestructible for some reason...";
	icon_state = "diamond";
	name = "diamond floor"
	},
/area/ruin/powered{
	name = "King Goat Arena";
	noteleport = 1
	})
"m" = (
/obj/machinery/light{
	dir = 4
	},
/turf/open/indestructible/hotelwood{
	desc = "Very rich floor made out of pure diamond! This floor seems indestructible for some reason...";
	icon_state = "diamond";
	name = "diamond floor"
	},
/area/ruin/powered{
	name = "King Goat Arena";
	noteleport = 1
	})
"n" = (
/obj/machinery/light,
/turf/open/indestructible/hotelwood{
	desc = "Very rich floor made out of pure diamond! This floor seems indestructible for some reason...";
	icon_state = "diamond";
	name = "diamond floor"
	},
/area/ruin/powered{
	name = "King Goat Arena";
	noteleport = 1
	})
"p" = (
/obj/structure/ladder/unbreakable{
	desc = "This seems to be the ladder to the king of goats lair. Looks to be a one way trip...";
	id = "goatlayer";
	name = "Ladder to the King of Goats Lair"
	},
/obj/item/gps/internal{
	desc = "Something about this signal seems a bit more rich then the average signal.";
	gpstag = "Bleating Signal";
	name = "kinggoat"
	},
/turf/open/floor/mineral/gold,
/area/ruin/powered{
	name = "King Goat Lair"
	})
"q" = (
/turf/open/floor/mineral/gold,
/area/ruin/powered{
	name = "King Goat Lair"
	})
"r" = (
/obj/machinery/light{
	dir = 4
	},
/turf/open/floor/mineral/gold,
/area/ruin/powered{
	name = "King Goat Lair"
	})
"s" = (
/obj/item/paper/crumpled{
	info = "Lest ye be prepared abandon all hope ye who enter here.";
	name = "Wise Mans Warning."
	},
/turf/open/floor/mineral/diamond,
/area/ruin/powered{
	name = "King Goat Lair"
	})
"t" = (
/obj/machinery/light,
/turf/open/floor/mineral/gold,
/area/ruin/powered{
	name = "King Goat Lair"
	})
"w" = (
/obj/structure/ladder/unbreakable{
	desc = "This seems to be the ladder to the king of goats lair. Looks to be a one way trip...";
	height = 1;
	id = "goatlayer";
	name = "Ladder to the King of Goats Lair"
	},
/turf/open/indestructible/hotelwood{
	desc = "Very rich floor made out of pure gold! This floor seems indestructible for some reason...";
	icon_state = "gold";
	name = "gold floor"
	},
/area/ruin/powered{
	name = "King Goat Arena";
	noteleport = 1
	})
"y" = (
/obj/effect/portal/permanent/one_way/destroy{
	id = "king goat arena";
	name = "king goat arena portal"
	},
/turf/open/indestructible/hotelwood{
	desc = "Very rich floor made out of pure diamond! This floor seems indestructible for some reason...";
	icon_state = "diamond";
	name = "diamond floor"
	},
/area/ruin/powered{
	name = "King Goat Arena";
	noteleport = 1
	})
"C" = (
/obj/effect/mob_spawn/human/miner{
	assignedrole = "null";
	desc = "Seems this miner tried to cheese the arena using bluespace crystals. Did not turn out well";
	mob_gender = "female";
	mob_name = "Lyna Lavas";
	name = "Lyna Lavas"
	},
/obj/item/stack/ore/bluespace_crystal,
/turf/open/indestructible/hotelwood{
	desc = "Very rich floor made out of pure gold! This floor seems indestructible for some reason...";
	icon_state = "gold";
	name = "gold floor"
	},
/area/ruin/powered{
	name = "King Goat Arena";
	noteleport = 1
	})
"H" = (
/obj/machinery/light,
/turf/open/indestructible/hotelwood{
	desc = "Very rich floor made out of pure gold! This floor seems indestructible for some reason...";
	icon_state = "gold";
	name = "gold floor"
	},
/area/ruin/powered{
	name = "King Goat Arena";
	noteleport = 1
	})
"S" = (
/obj/machinery/light/small{
	dir = 4
	},
/obj/effect/portal/permanent/one_way/keep{
	hard_target = null;
	hardlinked = 0;
	id = "king goat arena";
	name = "king goat arena portal"
	},
/turf/open/indestructible/hotelwood{
	desc = "Very rich floor made out of pure gold! This floor seems indestructible for some reason...";
	icon_state = "gold";
	name = "gold floor"
	},
/area/ruin/powered{
	name = "King Goat Arena";
	noteleport = 1
	})
"T" = (
/turf/open/indestructible/hotelwood{
	desc = "Very rich floor made out of pure gold! This floor seems indestructible for some reason...";
	icon_state = "gold";
	name = "gold floor"
	},
/area/ruin/powered{
	name = "King Goat Arena";
	noteleport = 1
	})
"U" = (
/obj/machinery/door/airlock/gold/glass{
	desc = "Once you go in the portal past this door there is no going back...";
	name = "POINT OF NO RETURN"
	},
/turf/open/indestructible/hotelwood{
	desc = "Very rich floor made out of pure gold! This floor seems indestructible for some reason...";
	icon_state = "gold";
	name = "gold floor"
	},
/area/ruin/powered{
	name = "King Goat Arena";
	noteleport = 1
	})

(1,1,1) = {"
a
a
a
a
a
a
a
a
a
a
a
a
a
"}
(2,1,1) = {"
a
a
a
a
a
a
a
a
a
a
a
a
a
"}
(3,1,1) = {"
a
a
a
a
a
a
a
a
a
a
a
a
a
"}
(4,1,1) = {"
a
a
a
b
b
c
d
c
b
b
a
a
a
"}
(5,1,1) = {"
a
a
a
b
q
f
q
f
q
b
a
a
a
"}
(6,1,1) = {"
a
a
a
c
e
g
g
g
t
c
a
a
a
"}
(7,1,1) = {"
a
a
a
d
q
g
p
s
q
d
a
a
a
"}
(8,1,1) = {"
a
a
a
c
e
g
g
g
t
c
a
a
a
"}
(9,1,1) = {"
a
a
a
b
q
r
q
r
q
b
a
a
a
"}
(10,1,1) = {"
a
a
a
b
b
c
d
c
b
b
a
a
a
"}
(11,1,1) = {"
a
a
a
a
a
a
a
a
a
a
a
a
a
"}
(12,1,1) = {"
a
a
a
a
a
a
a
a
a
a
a
a
a
"}
(13,1,1) = {"
a
a
a
a
a
a
a
a
a
a
a
a
a
"}

(1,1,2) = {"
h
h
h
h
h
h
h
h
h
h
h
h
h
"}
(2,1,2) = {"
h
i
i
i
i
l
i
i
i
i
h
w
h
"}
(3,1,2) = {"
h
i
i
i
i
i
i
i
i
i
h
T
h
"}
(4,1,2) = {"
h
i
i
i
i
i
i
i
i
i
h
T
h
"}
(5,1,2) = {"
h
i
i
i
i
i
i
i
i
i
h
T
h
"}
(6,1,2) = {"
h
i
k
i
i
i
i
i
i
n
h
T
h
"}
(7,1,2) = {"
h
j
i
i
i
i
i
i
i
y
h
H
h
"}
(8,1,2) = {"
h
i
k
i
i
i
i
i
i
n
h
T
h
"}
(9,1,2) = {"
h
i
i
i
i
i
i
i
i
i
h
T
h
"}
(10,1,2) = {"
h
i
i
i
i
i
i
i
i
i
h
C
h
"}
(11,1,2) = {"
h
i
i
i
i
i
i
i
i
i
h
U
h
"}
(12,1,2) = {"
h
i
i
i
i
m
i
i
i
i
h
S
h
"}
(13,1,2) = {"
h
h
h
h
h
h
h
h
h
h
h
h
h
"}
