//MAP CONVERTED BY dmm2tgm.py THIS HEADER COMMENT PREVENTS RECONVERSION, DO NOT REMOVE
"a" = (
/turf/open/floor/plating/asteroid/basalt/lava_land_surface,
/area/lavaland/surface/outdoors/explored)
"b" = (
/obj/effect/mob_spawn/human/corpse/nanotrasensoldier,
/turf/open/floor/plating/asteroid/basalt/lava_land_surface,
/area/lavaland/surface/outdoors/explored)
"c" = (
/turf/closed/mineral/volcanic/lava_land_surface,
/area/lavaland/surface/outdoors/explored)
"d" = (
/turf/open/lava/smooth/lava_land_surface,
/area/lavaland/surface/outdoors/explored)
"e" = (
/mob/living/simple_animal/hostile/asteroid/goliath/beast,
/turf/open/floor/plating/asteroid/basalt/lava_land_surface,
/area/lavaland/surface/outdoors/explored)
"f" = (
/turf/closed/mineral/volcanic/lava_land_surface,
/area/ruin/unpowered)
"g" = (
/mob/living/simple_animal/hostile/asteroid/goliath/beast,
/turf/open/floor/plating/asteroid/basalt/lava_land_surface,
/area/ruin/unpowered)
"h" = (
/turf/open/floor/plating/asteroid/basalt/lava_land_surface,
/area/ruin/unpowered)
"i" = (
/obj/item/flashlight/lantern,
/turf/open/floor/plating/asteroid/basalt/lava_land_surface,
/area/ruin/unpowered)
"j" = (
/obj/item/storage/bag/ore/holding,
/mob/living/simple_animal/hostile/asteroid/goliath/beast,
/turf/open/floor/plating/asteroid/basalt/lava_land_surface,
/area/ruin/unpowered)
"k" = (
/obj/item/lazarus_injector,
/turf/open/floor/plating/asteroid/basalt/lava_land_surface,
/area/ruin/unpowered)
"l" = (
/obj/effect/mob_spawn/human/corpse/damaged,
/obj/item/gun/energy/kinetic_accelerator,
/obj/item/borg/upgrade/modkit/chassis_mod/orange,
/obj/item/borg/upgrade/modkit/tracer/adjustable,
/obj/item/borg/upgrade/modkit/resonator_blasts,
/turf/open/floor/plating/asteroid/basalt/lava_land_surface,
/area/ruin/unpowered)
"m" = (
/obj/item/mining_voucher,
/turf/open/floor/plating/asteroid/basalt/lava_land_surface,
/area/ruin/unpowered)

(1,1,1) = {"
a
a
a
a
c
a
a
a
a
c
a
c
a
c
c
a
a
a
a
"}
(2,1,1) = {"
a
a
a
a
c
a
a
c
a
a
a
a
a
c
c
a
a
a
a
"}
(3,1,1) = {"
a
d
d
a
a
a
a
e
a
a
a
a
a
a
a
a
a
a
c
"}
(4,1,1) = {"
a
a
a
a
a
b
a
a
b
a
a
d
d
d
d
b
a
c
a
"}
(5,1,1) = {"
a
a
a
a
a
d
a
a
f
a
a
a
a
c
a
a
a
e
a
"}
(6,1,1) = {"
a
d
a
a
f
d
f
a
f
d
f
d
a
f
f
a
a
a
a
"}
(7,1,1) = {"
a
c
c
a
f
f
f
f
f
f
f
f
a
a
f
d
d
d
a
"}
(8,1,1) = {"
b
c
a
a
a
f
f
f
f
f
f
f
f
f
f
a
a
a
a
"}
(9,1,1) = {"
a
a
a
a
f
f
f
f
h
g
h
g
f
f
f
f
a
a
a
"}
(10,1,1) = {"
a
a
a
a
f
f
f
g
h
h
h
f
f
f
a
a
a
c
c
"}
(11,1,1) = {"
a
c
c
a
f
f
f
h
g
k
g
h
f
f
f
d
a
a
a
"}
(12,1,1) = {"
a
a
c
e
a
f
f
h
i
l
m
g
f
f
a
d
a
b
a
"}
(13,1,1) = {"
a
a
d
a
f
f
f
h
j
m
g
h
f
f
f
f
a
a
c
"}
(14,1,1) = {"
c
a
c
a
a
f
f
g
h
h
h
h
g
f
f
f
f
a
c
"}
(15,1,1) = {"
a
a
b
a
a
f
f
f
f
g
g
h
g
f
f
a
a
e
a
"}
(16,1,1) = {"
a
a
d
a
a
a
f
f
f
f
f
f
f
f
f
f
a
a
c
"}
(17,1,1) = {"
a
a
a
a
a
a
a
f
f
f
f
f
f
f
a
a
c
a
c
"}
(18,1,1) = {"
a
d
d
d
d
a
a
f
a
f
f
f
a
a
a
a
a
a
a
"}
(19,1,1) = {"
a
a
a
c
c
c
a
d
b
a
f
d
d
a
d
d
d
d
a
"}
(20,1,1) = {"
a
c
a
a
c
c
a
a
a
e
a
a
a
a
a
a
a
c
a
"}
(21,1,1) = {"
a
a
a
a
a
a
a
a
a
a
c
c
a
a
c
a
a
a
a
"}
