//MAP CONVERTED BY dmm2tgm.py THIS HEADER COMMENT PREVENTS RECONVERSION, DO NOT REMOVE
"aa" = (
/turf/template_noop,
/area/lavaland/surface/outdoors)
"ab" = (
/turf/open/floor/plating/asteroid/basalt/lava_land_surface,
/area/lavaland/surface/outdoors)
"ac" = (
/turf/open/lava/smooth/lava_land_surface,
/area/lavaland/surface/outdoors)
"ad" = (
/turf/closed/indestructible/abductor{
	icon_state = "alien8"
	},
/area/ruin/powered)
"ae" = (
/turf/closed/wall/mineral/abductor,
/area/ruin/powered)
"af" = (
/turf/closed/indestructible/abductor{
	icon_state = "alien7"
	},
/area/ruin/powered)
"ag" = (
/obj/structure/table/abductor,
/turf/open/floor/mineral/abductor,
/area/ruin/powered)
"ah" = (
/obj/machinery/light/floor,
/turf/open/floor/mineral/abductor,
/area/ruin/powered)
"ai" = (
/obj/effect/decal/remains/human,
/obj/effect/decal/cleanable/blood/old,
/turf/open/floor/mineral/abductor,
/area/ruin/powered)
"aj" = (
/turf/open/floor/mineral/abductor,
/area/lavaland/surface/outdoors)
"ak" = (
/obj/structure/closet/abductor,
/obj/item/stack/sheet/mineral/uranium{
	amount = 5
	},
/turf/open/floor/mineral/abductor,
/area/ruin/powered)
"al" = (
/obj/structure/table/abductor,
/obj/item/firing_pin/abductor,
/obj/item/firing_pin/abductor,
/obj/item/firing_pin/abductor,
/obj/item/firing_pin/abductor,
/obj/item/firing_pin/abductor,
/turf/open/floor/mineral/abductor,
/area/ruin/powered)
"am" = (
/obj/effect/decal/remains/human,
/obj/effect/decal/cleanable/blood/splatter,
/turf/open/floor/mineral/abductor,
/area/ruin/powered)
"an" = (
/obj/effect/decal/cleanable/blood/drip,
/turf/open/floor/mineral/abductor,
/area/ruin/powered)
"ao" = (
/obj/effect/decal/cleanable/blood/drip,
/mob/living/simple_animal/hostile/abomination,
/turf/open/floor/mineral/abductor,
/area/ruin/powered)
"ap" = (
/obj/structure/table/abductor,
/obj/item/organ/brain{
	pixel_x = 4
	},
/obj/item/organ/tongue,
/obj/item/organ/tongue/alien{
	pixel_x = -5;
	pixel_y = -3
	},
/turf/open/floor/mineral/abductor,
/area/ruin/powered)
"aq" = (
/obj/machinery/door/airlock/abductor{
	locked = 1
	},
/obj/structure/fans/tiny/invisible,
/turf/open/floor/mineral/abductor,
/area/ruin/powered)
"ar" = (
/obj/structure/closet/abductor,
/obj/item/organ/appendix,
/obj/item/organ/appendix,
/turf/open/floor/mineral/abductor,
/area/ruin/powered)
"as" = (
/obj/structure/closet/abductor,
/obj/item/reagent_containers/food/snacks/burger/human,
/obj/item/reagent_containers/food/snacks/burger/human,
/turf/open/floor/mineral/abductor,
/area/ruin/powered)
"at" = (
/obj/structure/kitchenspike,
/obj/effect/decal/remains/human,
/obj/effect/decal/cleanable/blood/old,
/turf/open/floor/mineral/abductor,
/area/ruin/powered)
"au" = (
/obj/structure/closet/abductor,
/obj/item/reagent_containers/food/snacks/meat/slab/human,
/obj/item/reagent_containers/food/snacks/meat/slab/human,
/obj/item/reagent_containers/food/snacks/meat/slab/human,
/obj/item/reagent_containers/food/snacks/meat/slab/human,
/turf/open/floor/mineral/abductor,
/area/ruin/powered)
"av" = (
/mob/living/simple_animal/hostile/abomination/altform1,
/turf/open/floor/mineral/abductor,
/area/ruin/powered)
"aw" = (
/obj/item/organ/appendix,
/turf/open/floor/mineral/abductor,
/area/ruin/powered)
"ay" = (
/obj/machinery/door/airlock/abductor,
/obj/structure/fans/tiny/invisible,
/turf/open/floor/mineral/abductor,
/area/ruin/powered)
"aA" = (
/obj/structure/table/abductor,
/obj/item/stack/ore/diamond,
/turf/open/floor/mineral/abductor,
/area/ruin/powered)
"aB" = (
/obj/structure/table/abductor,
/obj/item/stack/ore/gold,
/turf/open/floor/mineral/abductor,
/area/ruin/powered)
"aC" = (
/obj/structure/table/abductor,
/obj/item/stack/ore/silver,
/turf/open/floor/mineral/abductor,
/area/ruin/powered)
"aD" = (
/obj/structure/table/abductor,
/obj/item/pickaxe/drill,
/turf/open/floor/mineral/abductor,
/area/ruin/powered)
"aE" = (
/obj/structure/closet/abductor,
/obj/item/organ/appendix,
/obj/item/organ/tongue,
/obj/item/organ/tongue,
/obj/item/organ/brain/alien{
	pixel_x = 5
	},
/obj/item/organ/brain/alien{
	pixel_x = 5
	},
/turf/open/floor/mineral/abductor,
/area/ruin/powered)
"aF" = (
/obj/structure/closet/abductor,
/obj/item/stack/sheet/animalhide/human{
	amount = 35
	},
/turf/open/floor/mineral/abductor,
/area/ruin/powered)
"aG" = (
/obj/structure/table/abductor,
/obj/item/circular_saw/alien,
/obj/item/surgicaldrill/alien,
/obj/item/scalpel/alien,
/turf/open/floor/mineral/abductor,
/area/ruin/powered)
"aH" = (
/obj/structure/table/abductor,
/obj/item/pickaxe/drill,
/obj/item/clothing/glasses/meson/night,
/turf/open/floor/mineral/abductor,
/area/ruin/powered)
"aI" = (
/obj/effect/decal/cleanable/blood/tracks,
/turf/open/floor/mineral/abductor,
/area/ruin/powered)
"aJ" = (
/obj/structure/table/abductor,
/obj/item/organ/tongue/fly{
	pixel_x = 5;
	pixel_y = 3
	},
/obj/item/organ/tongue/alien{
	pixel_x = -5;
	pixel_y = -3
	},
/turf/open/floor/mineral/abductor,
/area/ruin/powered)
"aK" = (
/obj/structure/table/abductor,
/obj/item/stack/ore/uranium,
/turf/open/floor/mineral/abductor,
/area/ruin/powered)
"aL" = (
/obj/structure/closet/abductor,
/obj/item/stack/sheet/mineral/abductor{
	amount = 50
	},
/turf/open/floor/mineral/abductor,
/area/ruin/powered)
"aM" = (
/obj/effect/decal/remains/human,
/obj/effect/decal/cleanable/blood/tracks,
/obj/effect/decal/cleanable/blood/splatter,
/turf/open/floor/mineral/abductor,
/area/ruin/powered)
"aN" = (
/obj/structure/table/abductor,
/obj/item/restraints/handcuffs/alien,
/turf/open/floor/mineral/abductor,
/area/ruin/powered)
"aO" = (
/obj/item/gps/mining{
	gpstag = "COSMIC_READING"
	},
/turf/open/floor/mineral/abductor,
/area/ruin/powered)
"aP" = (
/obj/structure/closet/abductor,
/obj/item/clothing/under/yogs/ronaldmcdonald,
/turf/open/floor/mineral/abductor,
/area/ruin/powered)
"aQ" = (
/mob/living/simple_animal/hostile/abomination/altform2,
/turf/open/floor/mineral/abductor,
/area/ruin/powered)
"aR" = (
/obj/structure/showcase/horrific_experiment,
/turf/open/floor/mineral/abductor,
/area/ruin/powered)
"aS" = (
/obj/structure/table/abductor,
/obj/item/clothing/under/yogs/tourist,
/turf/open/floor/mineral/abductor,
/area/ruin/powered)
"aT" = (
/obj/structure/table/abductor,
/obj/item/clothing/under/schoolgirl,
/obj/item/clothing/under/schoolgirl/green,
/obj/item/clothing/under/schoolgirl/orange,
/obj/item/clothing/under/schoolgirl/red,
/turf/open/floor/mineral/abductor,
/area/ruin/powered)
"aU" = (
/obj/structure/closet/abductor,
/obj/item/clothing/under/syndicate/sniper,
/turf/open/floor/mineral/abductor,
/area/ruin/powered)
"aV" = (
/obj/structure/bed/abductor,
/obj/item/clothing/under/soviet,
/obj/effect/decal/cleanable/blood/old,
/turf/open/floor/mineral/abductor,
/area/ruin/powered)
"aW" = (
/turf/open/floor/mineral/abductor,
/area/ruin/powered)
"aX" = (
/obj/effect/decal/cleanable/blood/old,
/turf/open/floor/mineral/abductor,
/area/ruin/powered)
"aY" = (
/obj/effect/decal/remains/human,
/turf/open/floor/mineral/abductor,
/area/ruin/powered)
"aZ" = (
/obj/structure/table/abductor,
/obj/item/stack/sheet/mineral/bananium{
	amount = 30
	},
/turf/open/floor/mineral/abductor,
/area/ruin/powered)
"ba" = (
/obj/structure/table/abductor,
/obj/item/gun/energy/temperature{
	pin = /obj/item/firing_pin
	},
/turf/open/floor/mineral/abductor,
/area/ruin/powered)
"bb" = (
/mob/living/simple_animal/hostile/abomination/altform3,
/turf/open/floor/mineral/abductor,
/area/ruin/powered)
"bc" = (
/obj/structure/table/abductor,
/obj/item/gun/energy/gravity_gun,
/turf/open/floor/mineral/abductor,
/area/ruin/powered)
"bd" = (
/obj/structure/table/abductor,
/obj/item/gun/energy/decloner{
	pin = /obj/item/firing_pin
	},
/turf/open/floor/mineral/abductor,
/area/ruin/powered)
"be" = (
/obj/structure/table/abductor,
/obj/item/gun/energy/kinetic_accelerator,
/obj/item/borg/upgrade/modkit/chassis_mod,
/turf/open/floor/mineral/abductor,
/area/ruin/powered)
"bh" = (
/obj/machinery/door/airlock/abductor,
/obj/structure/fans/tiny/invisible,
/obj/effect/decal/cleanable/blood/tracks,
/turf/open/floor/mineral/abductor,
/area/ruin/powered)
"bo" = (
/turf/closed/wall/mineral/abductor,
/area/lavaland/surface/outdoors)
"bE" = (
/obj/machinery/abductor/gland_dispenser,
/turf/open/floor/mineral/abductor,
/area/ruin/powered)
"bZ" = (
/obj/structure/bed/abductor,
/obj/effect/decal/remains/xeno,
/obj/effect/decal/cleanable/xenoblood,
/turf/open/floor/mineral/abductor,
/area/ruin/powered)
"ce" = (
/obj/effect/spawner/structure/window/reinforced,
/turf/open/floor/mineral/abductor,
/area/ruin/powered)
"cf" = (
/obj/structure/closet/abductor{
	name = "Armor Code: Primitive"
	},
/obj/item/clothing/gloves/plate/blue{
	armor = list("melee" = 5, "bullet" = 5, "laser" = 5, "energy" = 0, "bomb" = 0, "bio" = 0, "rad" = 0);
	desc = "A pair of heavily modified traditional gauntlets";
	name = "Cosmic Gauntlets"
	},
/obj/item/clothing/head/helmet/knight/blue{
	desc = "A heavily modified traditional helmet";
	name = "Cosmic Helmet"
	},
/obj/item/clothing/suit/armor/riot/knight/blue{
	armor = list("melee" = 50, "bullet" = 30, "laser" = 50, "energy" = 10, "bomb" = 0, "bio" = 0, "rad" = 0);
	desc = "A modified suit of traditional plate armor, you can see some circuitry shoved into the joints";
	name = "Cosmic Armor"
	},
/obj/item/clothing/shoes/plate/blue{
	name = "Cosmic Boots"
	},
/obj/item/clothing/under/roman{
	name = "Undergarments"
	},
/turf/open/floor/mineral/abductor,
/area/ruin/powered)
"cg" = (
/obj/item/rune_scimmy,
/obj/structure/closet/abductor{
	name = "Weapon Code: Primitive"
	},
/obj/item/shield/riot/roman{
	desc = "Bears an inscription on the inside: <i>\"Ashwalker venio domus\"</i>.";
	name = "Cosmic Ashwalker Shield"
	},
/turf/open/floor/mineral/abductor,
/area/ruin/powered)
"ch" = (
/obj/structure/bed/abductor,
/obj/effect/mob_spawn/human/ash_walker/cosmic,
/turf/open/floor/mineral/abductor,
/area/ruin/powered)
"ci" = (
/obj/machinery/door/airlock/abductor{
	name = "Subject Cell: Scales"
	},
/turf/open/floor/mineral/abductor,
/area/ruin/powered)
"cj" = (
/obj/machinery/door/airlock/abductor{
	locked = 0
	},
/obj/structure/fans/tiny/invisible,
/turf/open/floor/mineral/abductor,
/area/ruin/powered)
"cp" = (
/obj/machinery/door/airlock/abductor{
	locked = 1;
	state_open = 1
	},
/obj/structure/fans/tiny/invisible,
/turf/open/floor/mineral/abductor,
/area/ruin/powered)
"cC" = (
/mob/living/simple_animal/hostile/abomination/super,
/turf/open/floor/mineral/abductor,
/area/ruin/powered)
"cV" = (
/obj/structure/table/abductor,
/obj/item/stack/ore/bananium,
/turf/open/floor/mineral/abductor,
/area/ruin/powered)
"dK" = (
/obj/structure/table/abductor,
/obj/item/switchblade,
/turf/open/floor/mineral/abductor,
/area/ruin/powered)
"ex" = (
/obj/structure/closet/abductor,
/obj/item/clothing/suit/armor/abductor/vest,
/obj/item/clothing/suit/armor/abductor/vest,
/obj/item/clothing/suit/armor/abductor/vest,
/turf/open/floor/mineral/abductor,
/area/ruin/powered)
"eE" = (
/obj/structure/table/abductor,
/obj/item/cautery/alien,
/obj/item/circular_saw/alien,
/obj/item/hemostat/alien,
/obj/item/retractor/alien,
/obj/item/scalpel/alien,
/obj/item/surgicaldrill/alien,
/obj/item/surgical_drapes,
/turf/open/floor/mineral/abductor,
/area/ruin/powered)
"eF" = (
/obj/structure/closet/abductor,
/obj/item/stack/tile/mineral/abductor{
	amount = 50
	},
/turf/open/floor/mineral/abductor,
/area/ruin/powered)
"fa" = (
/obj/structure/table/abductor,
/obj/item/storage/box/alienhandcuffs,
/obj/item/storage/box/alienhandcuffs,
/turf/open/floor/mineral/abductor,
/area/ruin/powered)
"fM" = (
/obj/structure/table/abductor,
/obj/item/toy/figure/clown,
/turf/open/floor/mineral/abductor,
/area/ruin/powered)
"ga" = (
/obj/structure/table/abductor,
/obj/item/storage/toolbox/mechanical,
/turf/open/floor/mineral/abductor,
/area/ruin/powered)
"gd" = (
/obj/effect/decal/remains/human,
/obj/effect/decal/cleanable/blood/drip,
/turf/open/floor/mineral/abductor,
/area/ruin/powered)
"gq" = (
/obj/machinery/abductor/pad,
/turf/open/floor/mineral/abductor,
/area/ruin/powered)
"gt" = (
/obj/structure/closet/abductor,
/turf/open/floor/mineral/abductor,
/area/ruin/powered)
"hi" = (
/obj/structure/table/abductor,
/obj/item/clothing/head/helmet/abductor,
/turf/open/floor/mineral/abductor,
/area/ruin/powered)
"iw" = (
/obj/structure/closet/abductor,
/obj/item/stack/sheet/mineral/silver,
/turf/open/floor/mineral/abductor,
/area/ruin/powered)
"jW" = (
/obj/structure/closet/abductor,
/obj/item/stack/sheet/mineral/plasma{
	amount = 10
	},
/turf/open/floor/mineral/abductor,
/area/ruin/powered)
"kN" = (
/obj/structure/table/abductor,
/obj/item/stack/ore/iron,
/turf/open/floor/mineral/abductor,
/area/ruin/powered)
"kQ" = (
/obj/structure/closet/abductor,
/obj/item/clothing/under/geisha,
/turf/open/floor/mineral/abductor,
/area/ruin/powered)
"lo" = (
/obj/effect/decal/cleanable/blood/drip,
/obj/effect/decal/cleanable/blood/splatter,
/turf/open/floor/mineral/abductor,
/area/ruin/powered)
"md" = (
/obj/structure/table/abductor,
/obj/item/toy/figure/secofficer,
/turf/open/floor/mineral/abductor,
/area/ruin/powered)
"mN" = (
/obj/structure/closet/abductor,
/obj/item/stack/sheet/xenochitin{
	amount = 35
	},
/turf/open/floor/mineral/abductor,
/area/ruin/powered)
"mU" = (
/obj/structure/table/abductor,
/obj/item/stack/sheet/animalhide/lizard{
	amount = 1
	},
/turf/open/floor/mineral/abductor,
/area/ruin/powered)
"nb" = (
/obj/structure/table/abductor,
/obj/item/stack/sheet/animalhide/human{
	amount = 1
	},
/turf/open/floor/mineral/abductor,
/area/ruin/powered)
"nl" = (
/obj/structure/table/abductor,
/obj/item/organ/tongue/abductor,
/turf/open/floor/mineral/abductor,
/area/ruin/powered)
"nn" = (
/obj/item/storage/fancy/donut_box,
/obj/effect/decal/cleanable/blood/old,
/turf/open/floor/mineral/abductor,
/area/ruin/powered)
"nw" = (
/obj/structure/closet/abductor,
/obj/item/gun/energy/alien{
	pin = /obj/item/firing_pin
	},
/turf/open/floor/mineral/abductor,
/area/ruin/powered)
"nX" = (
/obj/item/flashlight/lantern,
/turf/open/floor/mineral/abductor,
/area/ruin/powered)
"os" = (
/obj/structure/closet/abductor,
/obj/item/clothing/under/gimmick/rank/captain/suit,
/turf/open/floor/mineral/abductor,
/area/ruin/powered)
"pi" = (
/obj/structure/closet/abductor,
/obj/item/stack/sheet/animalhide/xeno{
	amount = 25
	},
/turf/open/floor/mineral/abductor,
/area/ruin/powered)
"pv" = (
/obj/structure/bed/abductor,
/obj/effect/decal/remains/human,
/obj/effect/decal/cleanable/blood/old,
/turf/open/floor/mineral/abductor,
/area/ruin/powered)
"px" = (
/obj/structure/table/abductor,
/obj/item/toy/syndicateballoon,
/turf/open/floor/mineral/abductor,
/area/ruin/powered)
"pC" = (
/obj/structure/closet/abductor,
/obj/item/stack/sheet/cloth{
	amount = 50
	},
/turf/open/floor/mineral/abductor,
/area/ruin/powered)
"pE" = (
/obj/structure/table/abductor,
/obj/item/organ/lungs,
/obj/item/organ/lungs,
/obj/item/organ/tongue,
/obj/item/organ/tail,
/turf/open/floor/mineral/abductor,
/area/ruin/powered)
"rL" = (
/obj/structure/table/abductor,
/obj/item/abductor/baton,
/turf/open/floor/mineral/abductor,
/area/ruin/powered)
"sf" = (
/obj/structure/closet/abductor,
/obj/item/stack/sheet/mineral/gold{
	amount = 10
	},
/turf/open/floor/mineral/abductor,
/area/ruin/powered)
"sB" = (
/obj/structure/closet/abductor,
/obj/item/stack/sheet/metal/fifty,
/obj/item/stack/sheet/glass/fifty,
/turf/open/floor/mineral/abductor,
/area/ruin/powered)
"vj" = (
/obj/effect/decal/cleanable/xenoblood,
/turf/open/floor/mineral/abductor,
/area/ruin/powered)
"vs" = (
/obj/structure/bed/abductor,
/obj/effect/decal/remains/human,
/turf/open/floor/mineral/abductor,
/area/ruin/powered)
"vA" = (
/obj/structure/bed/abductor,
/turf/open/floor/mineral/abductor,
/area/ruin/powered)
"vT" = (
/obj/structure/closet/abductor,
/obj/item/stack/sheet/mineral/diamond{
	amount = 10
	},
/turf/open/floor/mineral/abductor,
/area/ruin/powered)
"vX" = (
/obj/structure/closet/abductor,
/obj/item/storage/box/alienhandcuffs,
/obj/item/paper/guides/antag/abductor,
/turf/open/floor/mineral/abductor,
/area/ruin/powered)
"wG" = (
/obj/structure/table/abductor,
/obj/item/toy/figure/mime,
/turf/open/floor/mineral/abductor,
/area/ruin/powered)
"wO" = (
/obj/effect/decal/remains/human,
/obj/effect/decal/cleanable/blood/splatter,
/obj/machinery/light/floor,
/turf/open/floor/mineral/abductor,
/area/ruin/powered)
"xq" = (
/obj/structure/table/abductor,
/obj/item/organ/lungs{
	pixel_y = 8
	},
/obj/item/organ/heart{
	pixel_x = -7;
	pixel_y = -5
	},
/obj/item/organ/brain{
	pixel_x = 4
	},
/obj/item/organ/heart{
	pixel_x = -10;
	pixel_y = -3
	},
/turf/open/floor/mineral/abductor,
/area/ruin/powered)
"xt" = (
/obj/structure/closet/abductor,
/obj/item/organ/heart,
/obj/item/organ/heart,
/obj/item/organ/lungs,
/obj/item/organ/lungs,
/obj/item/organ/tongue/alien{
	pixel_x = -5;
	pixel_y = -3
	},
/turf/open/floor/mineral/abductor,
/area/ruin/powered)
"xZ" = (
/obj/structure/table/abductor,
/obj/item/clothing/under/sexymime,
/turf/open/floor/mineral/abductor,
/area/ruin/powered)
"ye" = (
/obj/structure/closet/abductor,
/obj/item/clothing/suit/space/freedom,
/turf/open/floor/mineral/abductor,
/area/ruin/powered)
"yO" = (
/obj/structure/table/abductor,
/obj/item/grenade/spawnergrenade/syndiesoap,
/turf/open/floor/mineral/abductor,
/area/ruin/powered)
"yX" = (
/obj/structure/table/abductor,
/obj/item/radio/headset/abductor,
/turf/open/floor/mineral/abductor,
/area/ruin/powered)
"zC" = (
/mob/living/simple_animal/hostile/abomination/altform4,
/turf/open/floor/mineral/abductor,
/area/ruin/powered)
"zF" = (
/obj/structure/table/optable/abductor,
/turf/open/floor/mineral/abductor,
/area/ruin/powered)
"zW" = (
/obj/effect/decal/cleanable/greenglow,
/turf/open/floor/mineral/abductor,
/area/ruin/powered)
"AB" = (
/obj/structure/table/abductor,
/obj/item/throwing_star,
/turf/open/floor/mineral/abductor,
/area/ruin/powered)
"Bc" = (
/obj/effect/spawner/structure/window,
/turf/open/floor/mineral/abductor,
/area/ruin/powered)
"BF" = (
/obj/effect/decal/cleanable/blood/splatter,
/turf/open/floor/mineral/abductor,
/area/ruin/powered)
"Dx" = (
/obj/structure/bed/abductor,
/obj/effect/decal/remains/xeno,
/turf/open/floor/mineral/abductor,
/area/ruin/powered)
"Et" = (
/obj/machinery/computer/camera_advanced/abductor,
/turf/open/floor/mineral/abductor,
/area/ruin/powered)
"EA" = (
/obj/structure/table/abductor,
/obj/item/stack/ore/bluespace_crystal,
/turf/open/floor/mineral/abductor,
/area/ruin/powered)
"Fv" = (
/obj/structure/closet/abductor,
/obj/item/clothing/head/helmet/abductor,
/obj/item/clothing/head/helmet/abductor,
/obj/item/clothing/head/helmet/abductor,
/turf/open/floor/mineral/abductor,
/area/ruin/powered)
"FV" = (
/obj/structure/table/abductor,
/obj/item/organ/brain/alien{
	pixel_x = 5
	},
/obj/item/organ/tongue/lizard{
	pixel_x = -5;
	pixel_y = 6
	},
/turf/open/floor/mineral/abductor,
/area/ruin/powered)
"FZ" = (
/obj/structure/table/abductor,
/obj/item/stack/ore/plasma,
/turf/open/floor/mineral/abductor,
/area/ruin/powered)
"Hc" = (
/obj/structure/table/abductor,
/obj/item/organ/tongue,
/obj/item/organ/tongue,
/obj/item/organ/appendix,
/obj/item/organ/tail,
/obj/item/organ/tail,
/turf/open/floor/mineral/abductor,
/area/ruin/powered)
"Hz" = (
/obj/structure/closet/abductor,
/obj/item/paper/guides/antag/abductor,
/turf/open/floor/mineral/abductor,
/area/ruin/powered)
"HP" = (
/obj/structure/closet/abductor,
/obj/item/stack/sheet/animalhide/corgi{
	amount = 10
	},
/obj/item/stack/sheet/animalhide/lizard{
	amount = 1
	},
/obj/item/stack/sheet/animalhide/monkey{
	amount = 10
	},
/turf/open/floor/mineral/abductor,
/area/ruin/powered)
"JN" = (
/obj/structure/closet/abductor,
/obj/item/stock_parts/cell/infinite/abductor,
/turf/open/floor/mineral/abductor,
/area/ruin/powered)
"MQ" = (
/obj/effect/decal/cleanable/blood/drip,
/obj/machinery/light/floor,
/turf/open/floor/mineral/abductor,
/area/ruin/powered)

(1,1,1) = {"
aa
aa
aa
aa
aa
aa
aa
aa
aa
aa
aa
aa
aa
aa
aa
aa
aa
aa
aa
aa
aa
aa
aa
aa
aa
aa
aa
aa
aa
aa
aa
aa
aa
aa
aa
aa
aa
aa
aa
aa
aa
aa
aa
aa
aa
aa
aa
aa
aa
aa
"}
(2,1,1) = {"
aa
aa
aa
aa
aa
aa
aa
aa
aa
aa
aa
aa
aa
aa
aa
aa
aa
aa
aa
aa
aa
aa
aa
aa
aa
aa
aa
aa
aa
aa
aa
aa
aa
aa
aa
aa
aa
aa
aa
aa
aa
aa
aa
aa
aa
aa
aa
aa
aa
aa
"}
(3,1,1) = {"
aa
aa
aa
aa
aa
aa
aa
aa
aa
aa
aa
aa
aa
aa
aa
aa
aa
aa
aa
aa
aa
aa
aa
aa
aa
aa
aa
aa
aa
aa
aa
aa
aa
aa
aa
aa
aa
aa
aa
aa
aa
aa
aa
aa
aa
aa
aa
aa
aa
aa
"}
(4,1,1) = {"
aa
aa
aa
aa
aa
aa
aa
aa
aa
aa
aa
aa
aa
aa
aa
aa
aa
aa
aa
aa
aa
aa
aa
aa
aa
aa
aa
aa
aa
aa
aa
aa
aa
aa
aa
aa
aa
aa
aa
aa
aa
aa
aa
aa
aa
aa
aa
aa
aa
aa
"}
(5,1,1) = {"
aa
aa
aa
aa
aa
aa
aa
aa
aa
aa
aa
aa
aa
aa
ab
ab
ab
ab
ab
ab
ab
aa
aa
aa
aa
aa
ab
ab
ab
ab
aa
aa
aa
aa
aa
aa
aa
aa
aa
aa
aa
aa
aa
aa
aa
aa
aa
aa
aa
aa
"}
(6,1,1) = {"
aa
aa
aa
aa
aa
aa
aa
aa
aa
aa
aa
aa
aa
aa
ab
ab
ab
ab
ab
ab
ab
aa
aa
aa
aa
aa
ab
ab
ab
ab
aa
aa
aa
aa
aa
aa
aa
aa
aa
aa
aa
aa
aa
aa
aa
aa
aa
aa
aa
aa
"}
(7,1,1) = {"
aa
aa
aa
ab
ab
ab
ab
ab
ab
ab
ab
ab
ab
ab
ab
ab
ab
ab
ab
ab
ab
ab
ab
ab
ab
ab
ab
ab
ab
ab
ab
ab
ab
ab
aa
aa
aa
aa
aa
aa
aa
aa
aa
aa
aa
aa
aa
aa
aa
aa
"}
(8,1,1) = {"
aa
aa
aa
ab
ab
ab
ac
ab
ab
ab
ab
ab
ab
ab
ab
ab
ac
ac
ab
ab
ab
ac
ab
ab
ab
ab
ab
ab
ab
ab
ab
ab
ab
ab
aa
aa
aa
aa
aa
aa
aa
aa
aa
aa
aa
aa
aa
aa
aa
aa
"}
(9,1,1) = {"
aa
aa
aa
ab
ab
ab
ac
ab
ab
ab
ac
ac
ac
ab
ab
ab
ac
ab
ab
ac
ab
ac
ab
ab
ac
ac
ac
ac
ac
ac
ac
ac
ab
ab
aa
aa
aa
aa
aa
aa
aa
aa
aa
aa
aa
aa
aa
aa
aa
aa
"}
(10,1,1) = {"
aa
aa
aa
ab
ab
ac
ac
ac
ac
ac
ac
ac
ac
ab
ac
ab
ac
ac
ac
ac
ac
ac
ac
ac
ac
ac
ac
ac
ac
ac
ac
ac
ab
ab
aa
aa
aa
aa
aa
aa
aa
aa
aa
aa
aa
aa
aa
aa
aa
aa
"}
(11,1,1) = {"
aa
ab
ab
ab
ab
ab
ac
ac
ac
ac
ac
ac
ac
ac
ac
ac
ac
ac
ac
ac
ac
ac
ac
ac
ac
ac
ac
ab
ac
ac
ac
ac
ab
ab
ab
ab
ab
ab
ab
aa
aa
aa
aa
aa
aa
aa
aa
aa
aa
aa
"}
(12,1,1) = {"
aa
ab
ab
ab
ab
ab
ac
ac
ac
ac
ac
ac
ac
ac
ac
ac
ac
ac
ac
ac
ac
ab
ac
ac
ab
ab
ac
ac
ab
ab
ac
ab
ab
ab
ab
ab
ab
ab
ab
aa
aa
aa
aa
aa
aa
aa
aa
aa
aa
aa
"}
(13,1,1) = {"
aa
ab
ab
ab
ac
ab
ac
ac
ab
ac
ac
ac
ac
ac
ab
ac
ab
ab
ab
ab
ac
ab
ac
ac
ab
ab
ab
ac
ab
ab
ac
ac
ac
ac
ac
ab
ab
ab
ab
aa
aa
aa
aa
aa
aa
aa
aa
aa
aa
aa
"}
(14,1,1) = {"
aa
ab
ab
ab
ac
ab
ac
ac
ac
ac
ac
ac
ab
ac
ab
ab
ac
ac
ac
ac
ac
ab
ac
ab
ac
ac
ac
ac
ab
ab
ab
ac
ac
ab
ab
ab
ab
ab
ac
ab
ab
ab
aa
aa
aa
aa
aa
aa
aa
aa
"}
(15,1,1) = {"
ab
ab
ab
ab
ac
ab
ac
ab
ab
ab
ac
ac
ab
ab
ab
ab
ab
ab
ab
ac
ac
ab
ab
ab
ac
ac
ac
ac
ab
ab
ac
ac
ab
ac
ab
ab
ac
ac
ac
ab
ac
ab
aa
aa
aa
aa
aa
aa
aa
aa
"}
(16,1,1) = {"
ab
ab
ab
ab
ac
ac
ac
ac
ab
ae
ae
ae
ae
ae
ae
ae
ae
ae
ae
ae
ae
ae
ae
ae
ae
ae
ae
ae
ae
ac
ac
ac
ac
ab
ab
ac
ac
ac
ab
ab
ac
ab
ab
ab
ab
ab
ab
aa
aa
aa
"}
(17,1,1) = {"
ab
ab
ab
ac
ac
ac
ac
ac
ab
ae
mN
aW
Hc
sB
aW
aW
HP
aW
aE
ae
aL
aW
aW
aW
aW
eF
aW
Hz
ae
ac
ac
ac
ac
ab
ab
ac
ab
ab
ab
ab
ac
ab
ab
ac
ac
ac
ab
aa
aa
aa
"}
(18,1,1) = {"
ab
ab
ab
ac
ac
ac
ac
ac
ab
ae
jW
aW
aW
am
pC
aW
aW
aW
aW
ae
aW
aW
JN
aW
gd
aW
aW
aW
ae
ac
ac
ac
ac
ac
ac
ac
ac
ac
ac
ac
ac
ac
ab
ab
ac
ac
ab
aa
aa
aa
"}
(19,1,1) = {"
ab
ab
ab
ab
ac
ac
ac
ac
ab
ae
sf
aW
ak
an
ap
aW
pi
av
aF
ae
fM
aW
gt
an
aQ
eF
aW
Hz
ae
ac
ab
ac
ac
ac
ac
ac
ac
ac
ac
ac
ac
ac
ab
ab
ac
ac
ab
aa
aa
aa
"}
(20,1,1) = {"
ab
ab
ac
ac
ac
ac
ac
ac
ac
ae
aW
aW
iw
ao
ar
am
pE
aW
aF
ae
wG
aW
aW
an
eF
aW
aW
gt
ae
ac
ab
ac
ac
ac
ab
ac
ab
ab
ab
ac
ac
ac
ac
ac
ac
ab
ab
aa
aa
aa
"}
(21,1,1) = {"
ab
ab
ab
ab
ac
ac
ab
ac
ab
ae
vT
aW
aW
an
aW
aW
aW
aW
xt
ae
md
aW
aL
aW
an
aW
aY
ag
ae
ac
ac
ac
ab
ac
ac
ac
ac
ac
ab
ac
ac
ac
ac
ac
ac
ab
ab
ab
ab
aa
"}
(22,1,1) = {"
ab
ac
ab
ab
ac
ac
ac
ab
ab
ae
ae
ae
ae
ae
aq
ae
ae
ae
ae
ae
ae
ae
ae
ae
ae
ae
aq
ae
ae
ac
ab
ac
ac
ac
ac
ac
ab
ac
ac
ac
ac
ab
ab
ac
ac
ac
ab
ac
ab
aa
"}
(23,1,1) = {"
ab
ac
ac
ac
ac
ac
ac
ac
ab
ae
aW
aW
aW
aW
lo
an
aW
aW
ae
aW
aW
aX
ae
px
kQ
aW
aW
aT
ae
ac
ac
ac
ac
ae
ae
ae
ae
ae
ae
ae
ae
ae
ab
ab
ac
ac
ac
ac
ab
aa
"}
(24,1,1) = {"
ab
ac
ab
ac
ac
ac
ac
ac
ac
ae
aW
aW
aW
aW
aW
an
an
an
bh
aI
aM
aW
ay
aW
aW
aW
aY
aU
ae
ac
ac
ac
ab
ae
ag
ag
ba
ae
bc
yO
bd
ae
ab
ab
ac
ac
ac
ac
ab
aa
"}
(25,1,1) = {"
aa
aa
ac
ab
ac
ac
ac
ac
ac
ae
aW
aW
aW
aW
aW
aW
aW
aW
ae
aW
aW
aW
ae
aP
xZ
aS
aW
os
ae
ac
ab
ac
ac
ae
aW
aW
aW
ae
aW
aW
aW
ae
ab
ab
ac
ac
ab
ab
ab
aa
"}
(26,1,1) = {"
aa
aa
ac
ab
ac
ac
ac
ac
ab
ae
ae
ae
ae
ae
ae
ae
ae
ae
ae
ae
ay
ae
ae
ae
ae
ae
ae
ae
ae
ac
ac
ac
ab
ae
ye
aW
bb
ae
nw
aW
zC
ae
ab
ab
ac
ac
ab
ab
ab
aa
"}
(27,1,1) = {"
aa
aa
ac
ac
ac
ac
ac
ac
ab
ab
ab
ab
ab
ae
aW
ai
ae
aW
aW
ae
aW
ae
nn
ay
aW
aW
ay
aW
ae
ac
ac
ae
ae
ae
ae
aq
ae
ae
ae
aq
ae
ae
ab
ab
ac
ac
ac
ac
ab
aa
"}
(28,1,1) = {"
aa
aa
ac
ac
ac
ac
ac
ae
ae
ae
ae
ae
ae
ae
aW
aW
ae
ai
ai
ae
aW
ae
vs
ae
aW
aW
ae
bZ
ae
ab
ac
ae
aW
cj
aW
aW
aW
aW
aW
aW
am
ae
ab
ab
ac
ac
ac
ac
ab
aa
"}
(29,1,1) = {"
aa
aa
aa
aa
ac
ac
ac
ae
rL
rL
aW
ex
gt
ae
ai
aW
ae
aW
aW
ae
aW
ae
ae
ae
aW
aW
ae
ae
ae
ab
ab
ae
aW
ae
ae
ae
ae
cp
ae
ae
ae
ae
ac
ac
ac
ac
ab
ab
ab
aa
"}
(30,1,1) = {"
aa
aa
ae
ae
ae
ae
ae
ae
aW
aW
aW
aW
aW
ae
ae
ay
ae
ay
ae
ae
ai
ae
aW
ay
aW
aW
ay
aW
ae
ab
ab
ae
aW
ae
ag
aW
aW
aW
aW
ag
ag
ae
ab
ab
ab
ac
ab
ab
ab
aa
"}
(31,1,1) = {"
aa
aa
ae
gt
ag
ag
gt
ae
Fv
aW
aW
fa
al
ae
aN
aW
ae
aW
aN
ae
aW
ae
vA
ae
aW
aW
ae
vA
ae
ab
ab
ae
aW
ae
aZ
aW
ag
dK
cC
aW
aW
ae
ab
ab
ac
ac
ac
ab
ab
aa
"}
(32,1,1) = {"
aa
ad
ae
aW
aW
aW
aW
ae
ae
ae
aq
ae
ae
ae
aW
aW
aW
aW
aX
aW
aW
ae
ae
ae
aW
aW
ae
ae
ae
ab
ac
ae
aW
ae
aW
am
aW
aW
aW
aW
be
ae
ac
ac
ac
ac
ab
ab
ab
aa
"}
(33,1,1) = {"
aa
ae
Et
aW
aW
ai
aW
ae
gq
aW
aW
aW
aW
ae
aW
ae
as
aw
aG
aJ
aW
ae
bE
bE
aW
aW
aW
vX
ae
ab
ac
ae
aW
ae
ag
ag
ga
AB
ag
aW
aD
ae
ab
ab
ac
ac
ab
ab
ab
aa
"}
(34,1,1) = {"
aa
ae
Et
aW
aW
aW
aW
aq
aW
aW
aW
aW
aW
ay
aW
ae
at
aY
nb
mU
aW
ay
aW
aW
aW
aW
zF
eE
ae
ae
ae
ae
ay
ae
ae
ae
ae
ae
ae
ae
ae
ae
ab
ac
ac
ac
ab
ab
ab
aa
"}
(35,1,1) = {"
aa
ae
ag
aW
aW
aW
aW
ae
gq
aW
aW
aW
aW
ae
aW
ae
au
aW
xq
FV
aW
ae
aW
aW
aW
aW
aW
rL
ae
ah
BF
aW
aW
BF
aW
ah
ae
ab
ab
ac
ab
ac
ab
ac
ac
ac
ab
ab
ab
aa
"}
(36,1,1) = {"
aa
af
ae
aW
aW
aW
aW
ae
ae
ae
ay
ae
ae
ae
aW
aW
aW
aW
aW
aW
aW
ae
ae
ae
aW
aW
ae
ae
ae
aW
ce
ce
ce
ce
ce
am
ae
ab
ab
ac
ab
ac
ab
ac
ac
ab
ab
ab
ab
aa
"}
(37,1,1) = {"
aa
aa
ae
yX
hi
nl
rL
ae
vA
vA
aW
vA
vA
ae
aN
aW
ae
aW
aN
ae
aW
ae
aO
ay
aW
aW
ay
aY
ae
aW
ce
cf
nX
aY
ce
aW
ae
ac
ab
ab
ac
ac
ab
ac
ac
ab
ab
ab
ab
aa
"}
(38,1,1) = {"
aa
aa
ae
ae
ae
ae
ae
ae
aW
aW
aW
aW
aW
ae
ae
ay
ae
ay
ae
ae
aW
ae
pv
ae
aW
aW
ae
aV
ae
aW
ce
ah
ch
ah
ce
an
ae
ab
ab
ab
ac
ac
ac
ac
ac
ab
ab
ab
ab
aa
"}
(39,1,1) = {"
aa
aa
aa
aa
aa
aa
aa
ae
vA
vA
vA
vA
vA
ae
aW
aW
ae
aX
aY
ae
aW
ae
ae
ae
aW
aW
ae
ae
ae
aW
ce
cg
nX
aW
ce
aW
ae
ac
ac
ac
ac
ac
ac
ac
ac
ac
ab
ab
ab
aa
"}
(40,1,1) = {"
aa
aa
aa
aa
aa
aa
aa
ae
ae
ae
ae
ae
ae
ae
ai
aW
ae
aW
aY
ae
aW
ae
vj
ay
aW
aW
ay
aW
ae
aW
ce
ce
ci
ce
ce
an
ae
ac
ac
ac
ac
ac
ac
ac
ac
ab
ab
ab
ab
aa
"}
(41,1,1) = {"
aa
aa
aa
aa
aa
aa
aa
ac
ac
ac
ac
ac
ac
ae
aW
ai
ae
aY
aX
ae
aW
ae
Dx
ae
aW
aW
ae
vA
ae
wO
aW
aW
am
BF
an
MQ
ae
ac
ac
ac
ac
ac
ac
ac
ac
ac
ac
ac
ab
aa
"}
(42,1,1) = {"
aa
aa
aa
aa
aa
aa
ac
ac
ac
ac
ac
ac
ac
ae
ae
ae
ae
ae
ae
ae
ay
ae
ae
ae
ae
ae
ae
ae
ae
ae
ay
ae
ae
ae
ae
ae
ae
ac
ac
ac
ac
ac
ac
ac
ac
ab
ab
ab
ab
aa
"}
(43,1,1) = {"
aa
aa
aa
aa
aa
aa
ab
ac
ac
ac
ac
ac
ac
ac
ac
ac
ae
FZ
aW
aK
aW
aW
aW
ae
aR
aW
aR
aW
aR
ae
an
ae
ab
ac
ac
ac
ac
ac
ac
ab
ac
ab
ab
ac
ab
ab
aa
aa
aa
aa
"}
(44,1,1) = {"
aa
aa
aa
aa
aa
aa
ab
ab
ab
ac
ac
ac
ac
ac
ac
ac
ae
aW
aW
aW
aW
aW
aW
ae
aW
aW
aR
aW
zW
ae
aW
ae
ac
ac
ac
ac
ac
ac
ac
ab
ac
ab
ab
ab
ab
ab
aa
aa
aa
aa
"}
(45,1,1) = {"
aa
aa
aa
aa
aa
aa
ab
ab
ac
ac
ac
ac
ac
ac
ac
ac
ae
aA
aW
cV
aW
aW
aW
ae
Bc
Bc
Bc
Bc
Bc
ae
an
ae
ab
ab
ab
ab
ac
ac
ac
ab
ab
ab
aa
aa
aa
aa
aa
aa
aa
aa
"}
(46,1,1) = {"
aa
aa
aa
aa
aa
aa
ab
ab
ac
ab
ab
ac
ac
ac
ac
ac
ae
aW
ai
aW
aW
ai
aW
ay
aW
aW
aW
aW
aW
ay
am
ae
ab
ab
ab
ab
ac
ac
ac
ab
ab
ab
aa
aa
aa
aa
aa
aa
aa
aa
"}
(47,1,1) = {"
aa
aa
aa
aa
aa
aa
ab
ab
ac
ab
ac
ac
ac
ac
ac
ac
ae
aB
aW
EA
aW
aW
aW
ae
Bc
Bc
Bc
Bc
Bc
ae
ae
ae
ab
aa
aa
ab
ab
ab
ac
ab
aa
aa
aa
aa
aa
aa
aa
aa
aa
aa
"}
(48,1,1) = {"
aa
aa
aa
aa
aa
aa
ab
ab
ab
ab
ab
ab
ac
ac
ac
ac
ae
aW
aW
aW
aW
aW
gt
ae
aR
zW
aW
aR
aW
ae
ab
ab
ab
aa
aa
ab
ab
ab
ab
ab
aa
aa
aa
aa
aa
aa
aa
aa
aa
aa
"}
(49,1,1) = {"
aa
aa
aa
aa
aa
aa
ab
ab
ab
ab
ab
ac
ac
ac
ac
ac
ae
aC
aW
kN
aW
aW
gt
ae
aR
aW
aR
aW
aR
ae
ab
ab
ab
aa
aa
aa
aa
aa
aa
aa
aa
aa
aa
aa
aa
aa
aa
aa
aa
aa
"}
(50,1,1) = {"
aa
aa
aa
aa
aa
aa
ab
ab
ab
ab
ab
ab
ab
ac
ac
ac
ae
aW
aW
aW
aW
ai
gt
ae
ae
ae
ae
ae
ae
ae
ab
ab
ab
aa
aa
aa
aa
aa
aa
aa
aa
aa
aa
aa
aa
aa
aa
aa
aa
aa
"}
(51,1,1) = {"
aa
aa
aa
aa
aa
aa
ab
ab
ab
ab
ab
ab
ab
ac
ac
ab
ae
aD
aH
aH
aW
aW
gt
ae
ab
ab
ab
ab
ab
ab
ab
ab
ab
aa
aa
aa
aa
aa
aa
aa
aa
aa
aa
aa
aa
aa
aa
aa
aa
aa
"}
(52,1,1) = {"
aa
aa
aa
aa
aa
aa
aa
aa
aa
aa
aa
aa
ab
ab
ac
ab
ae
ae
ae
ae
ay
ae
ae
ae
ab
ab
ab
aa
aa
aa
aa
aa
aa
aa
aa
aa
aa
aa
aa
aa
aa
aa
aa
aa
aa
aa
aa
aa
aa
aa
"}
(53,1,1) = {"
aa
aa
aa
aa
aa
aa
aa
aa
aa
aa
aa
aa
ab
ab
ab
ab
aj
aj
aj
aj
aj
aj
aj
aj
aj
ab
ab
aa
aa
aa
aa
aa
aa
aa
aa
aa
aa
aa
aa
aa
aa
aa
aa
aa
aa
aa
aa
aa
aa
aa
"}
(54,1,1) = {"
aa
aa
aa
aa
aa
aa
aa
aa
aa
aa
aa
aa
ab
ab
ab
ab
ab
aj
aj
aj
aj
aj
aj
aj
ab
ab
ab
aa
aa
aa
aa
aa
aa
aa
aa
aa
aa
aa
aa
aa
aa
aa
aa
aa
aa
aa
aa
aa
aa
aa
"}
(55,1,1) = {"
aa
aa
aa
aa
aa
aa
aa
aa
aa
aa
aa
aa
ab
ab
ab
ab
ab
ab
bo
aj
aj
aj
bo
ab
ab
ab
ab
aa
aa
aa
aa
aa
aa
aa
aa
aa
aa
aa
aa
aa
aa
aa
aa
aa
aa
aa
aa
aa
aa
aa
"}
