//MAP CONVERTED BY dmm2tgm.py THIS HEADER COMMENT PREVENTS RECONVERSION, DO NOT REMOVE
"a" = (
/turf/template_noop,
/area/template_noop)
"c" = (
/obj/effect/decal/cleanable/blood/bubblegum,
/obj/structure/stone_tile/block/cracked{
	dir = 8
	},
/turf/open/floor/plating/dirt/jungleland/dying_forest,
/area/template_noop)
"d" = (
/obj/effect/decal/cleanable/blood/bubblegum,
/obj/structure/stone_tile/block/cracked{
	dir = 1
	},
/turf/open/floor/plating/dirt/jungleland/dying_forest,
/area/template_noop)
"g" = (
/obj/structure/stone_tile/block{
	dir = 1
	},
/turf/open/floor/plating/dirt/jungleland/dying_forest,
/area/template_noop)
"i" = (
/obj/effect/decal/cleanable/blood/bubblegum,
/obj/structure/stone_tile/surrounding/cracked,
/obj/structure/stone_tile/surrounding_tile,
/turf/open/floor/plating/dirt/jungleland/dying_forest,
/area/template_noop)
"k" = (
/obj/effect/decal/cleanable/blood/bubblegum,
/obj/structure/stone_tile/block{
	dir = 4
	},
/turf/open/floor/plating/dirt/jungleland/dying_forest,
/area/template_noop)
"m" = (
/obj/effect/decal/cleanable/blood/bubblegum,
/obj/effect/decal/cleanable/blood/bubblegum,
/obj/structure/stone_tile/surrounding/cracked{
	dir = 1;
	icon_state = "cracked_surrounding1"
	},
/obj/structure/stone_tile/surrounding/cracked,
/obj/structure/stone_tile/center/cracked,
/turf/open/floor/plating/dirt/jungleland/dying_forest,
/area/template_noop)
"p" = (
/obj/effect/decal/cleanable/blood/bubblegum,
/obj/structure/stone_tile/center/cracked,
/obj/structure/stone_tile/surrounding/cracked,
/turf/open/floor/plating/dirt/jungleland/dying_forest,
/area/template_noop)
"r" = (
/obj/effect/decal/cleanable/blood/bubblegum,
/obj/structure/stone_tile/cracked,
/obj/structure/stone_tile/cracked{
	dir = 8
	},
/obj/structure/stone_tile/cracked{
	dir = 4
	},
/obj/structure/stone_tile/cracked{
	dir = 1
	},
/turf/open/floor/plating/dirt/jungleland/dying_forest,
/area/template_noop)
"s" = (
/obj/effect/decal/cleanable/blood/bubblegum,
/turf/open/floor/plating/dirt/jungleland/dying_forest,
/area/template_noop)
"v" = (
/obj/effect/decal/cleanable/blood/bubblegum,
/obj/structure/stone_tile/block/cracked,
/obj/structure/stone_tile/cracked{
	dir = 4
	},
/turf/open/floor/plating/dirt/jungleland/dying_forest,
/area/template_noop)
"z" = (
/obj/effect/decal/cleanable/blood/bubblegum,
/obj/effect/decal/cleanable/blood/bubblegum,
/obj/structure/stone_tile/slab/cracked,
/turf/open/floor/plating/dirt/jungleland/dying_forest,
/area/template_noop)
"D" = (
/mob/living/simple_animal/hostile/megafauna/bubblegum,
/obj/effect/decal/cleanable/blood/bubblegum,
/obj/effect/decal/cleanable/blood/bubblegum,
/obj/structure/stone_tile/surrounding,
/turf/open/floor/plating/dirt/jungleland/dying_forest,
/area/template_noop)
"G" = (
/obj/structure/stone_tile/slab,
/turf/open/floor/plating/dirt/jungleland/dying_forest,
/area/template_noop)
"H" = (
/obj/effect/decal/cleanable/blood/bubblegum,
/obj/effect/decal/cleanable/blood/bubblegum,
/obj/structure/stone_tile/slab,
/turf/open/floor/plating/dirt/jungleland/dying_forest,
/area/template_noop)
"I" = (
/turf/open/floor/plating/dirt/jungleland/dying_forest,
/area/template_noop)
"L" = (
/obj/structure/stone_tile/surrounding_tile{
	dir = 1
	},
/turf/open/floor/plating/dirt/jungleland/dying_forest,
/area/template_noop)
"N" = (
/obj/structure/stone_tile/block/cracked{
	dir = 4
	},
/turf/open/floor/plating/dirt/jungleland/dying_forest,
/area/template_noop)
"Q" = (
/obj/structure/stone_tile/block/cracked{
	dir = 8
	},
/turf/open/floor/plating/dirt/jungleland/dying_forest,
/area/template_noop)
"R" = (
/obj/structure/stone_tile/block{
	dir = 4
	},
/turf/open/floor/plating/dirt/jungleland/dying_forest,
/area/template_noop)
"S" = (
/obj/effect/decal/cleanable/blood/bubblegum,
/obj/structure/stone_tile/slab/cracked,
/turf/open/floor/plating/dirt/jungleland/dying_forest,
/area/template_noop)
"T" = (
/obj/structure/stone_tile/surrounding_tile{
	dir = 4
	},
/turf/open/floor/plating/dirt/jungleland/dying_forest,
/area/template_noop)
"X" = (
/obj/structure/stone_tile/cracked{
	dir = 8
	},
/turf/open/floor/plating/dirt/jungleland/dying_forest,
/area/template_noop)
"Y" = (
/obj/effect/decal/cleanable/blood/bubblegum,
/obj/structure/stone_tile/slab,
/turf/open/floor/plating/dirt/jungleland/dying_forest,
/area/template_noop)

(1,1,1) = {"
a
T
Q
c
X
I
a
"}
(2,1,1) = {"
I
g
Y
z
i
I
I
"}
(3,1,1) = {"
I
g
p
H
S
I
I
"}
(4,1,1) = {"
d
z
s
D
m
v
s
"}
(5,1,1) = {"
L
R
G
r
z
Y
I
"}
(6,1,1) = {"
I
I
S
k
I
I
I
"}
(7,1,1) = {"
a
I
N
s
I
I
a
"}
