//MAP CONVERTED BY dmm2tgm.py THIS HEADER COMMENT PREVENTS RECONVERSION, DO NOT REMOVE
"c" = (
/obj/structure/flora/ausbushes/ppflowers,
/turf/open/floor/plating/dirt/jungleland/toxic_pit,
/area/template_noop)
"d" = (
/obj/item/stack/sheet/bone,
/turf/open/floor/plating/dirt/jungleland/toxic_pit,
/area/template_noop)
"f" = (
/obj/structure/flora/grass/jungle/b,
/turf/open/floor/plating/dirt/jungleland/toxic_pit,
/area/template_noop)
"h" = (
/obj/structure/flytrap,
/turf/open/floor/plating/dirt/jungleland/toxic_pit,
/area/template_noop)
"i" = (
/obj/structure/flora/grass/jungle/b,
/turf/open/floor/plating/dirt/jungleland/jungle,
/area/template_noop)
"k" = (
/mob/living/simple_animal/hostile/carp/jungle,
/turf/open/floor/plating/dirt/jungleland/jungle,
/area/template_noop)
"m" = (
/turf/open/floor/plating/dirt/jungleland/jungle,
/area/template_noop)
"n" = (
/obj/structure/flora/grass/jungle,
/turf/open/floor/plating/dirt/jungleland/jungle,
/area/template_noop)
"o" = (
/obj/structure/flora/junglebush,
/turf/open/floor/plating/dirt/jungleland/jungle,
/area/template_noop)
"p" = (
/obj/structure/flora/junglebush,
/turf/open/floor/plating/dirt/jungleland/toxic_pit,
/area/template_noop)
"q" = (
/obj/structure/flora/rock/pile,
/turf/open/water/toxic_pit,
/area/template_noop)
"r" = (
/obj/structure/flora/grass/jungle,
/turf/open/floor/plating/dirt/jungleland/toxic_pit,
/area/template_noop)
"s" = (
/mob/living/simple_animal/hostile/carp/jungle,
/turf/open/water/toxic_pit,
/area/template_noop)
"t" = (
/obj/structure/chair/sofa/bamboo/left,
/obj/item/grown/sunflower{
	desc = "Where did they go?"
	},
/turf/open/floor/plating/dirt/jungleland/jungle,
/area/template_noop)
"u" = (
/obj/structure/fluff/grave,
/obj/item/reagent_containers/food/snacks/grown/harebell{
	desc = "It's as purple as a carp..."
	},
/turf/open/floor/plating/dirt/jungleland/toxic_pit,
/area/template_noop)
"w" = (
/obj/item/stack/sheet/sinew,
/turf/open/floor/plating/dirt/jungleland/jungle,
/area/template_noop)
"z" = (
/obj/structure/chair/sofa/bamboo/right,
/mob/living/simple_animal/hostile/carp/ranged/chaos/jungle{
	desc = "It seems unwilling to leave.";
	name = "bound carp"
	},
/turf/open/floor/plating/dirt/jungleland/jungle,
/area/template_noop)
"B" = (
/turf/open/water/toxic_pit,
/area/template_noop)
"C" = (
/obj/item/stack/sheet/animalhide/carpdragon,
/turf/open/floor/plating/dirt/jungleland/toxic_pit,
/area/template_noop)
"D" = (
/obj/structure/flora/tree/jungle,
/turf/open/floor/plating/dirt/jungleland/toxic_pit,
/area/template_noop)
"E" = (
/obj/structure/flora/rock/jungle,
/turf/open/floor/plating/dirt/jungleland/toxic_pit,
/area/template_noop)
"G" = (
/obj/item/stack/sheet/animalhide/carpdragon,
/turf/open/floor/plating/dirt/jungleland/jungle,
/area/template_noop)
"H" = (
/obj/structure/flora/ausbushes/ywflowers,
/turf/open/floor/plating/dirt/jungleland/jungle,
/area/template_noop)
"I" = (
/obj/structure/flora/rock/jungle,
/turf/open/floor/plating/dirt/jungleland/jungle,
/area/template_noop)
"J" = (
/obj/structure/flora/junglebush/large,
/turf/open/floor/plating/dirt/jungleland/jungle,
/area/template_noop)
"K" = (
/obj/item/stack/sheet/sinew,
/turf/open/floor/plating/dirt/jungleland/toxic_pit,
/area/template_noop)
"L" = (
/turf/open/floor/wood/jungle,
/area/template_noop)
"N" = (
/obj/structure/flora/ausbushes/ppflowers,
/turf/open/floor/plating/dirt/jungleland/jungle,
/area/template_noop)
"O" = (
/obj/structure/flora/stump,
/turf/open/floor/plating/dirt/jungleland/toxic_pit,
/area/template_noop)
"P" = (
/mob/living/simple_animal/hostile/carp/jungle,
/turf/open/floor/plating/dirt/jungleland/toxic_pit,
/area/template_noop)
"Q" = (
/obj/structure/flora/tree/jungle/small,
/turf/open/floor/plating/dirt/jungleland/toxic_pit,
/area/template_noop)
"R" = (
/obj/item/toy/plush/carpplushie/dehy_carp,
/turf/open/floor/plating/dirt/jungleland/jungle,
/area/template_noop)
"S" = (
/obj/structure/flora/tree/jungle/small,
/turf/open/floor/plating/dirt/jungleland/jungle,
/area/template_noop)
"T" = (
/obj/structure/flora/ausbushes/ywflowers,
/turf/open/floor/plating/dirt/jungleland/toxic_pit,
/area/template_noop)
"U" = (
/obj/structure/flora/ausbushes/stalkybush,
/turf/open/water/toxic_pit,
/area/template_noop)
"V" = (
/obj/structure/flora/ausbushes/brflowers,
/turf/open/floor/plating/dirt/jungleland/jungle,
/area/template_noop)
"X" = (
/obj/structure/flytrap,
/turf/open/floor/plating/dirt/jungleland/jungle,
/area/template_noop)
"Y" = (
/turf/open/floor/plating/dirt/jungleland/toxic_pit,
/area/template_noop)
"Z" = (
/obj/structure/flora/ausbushes/brflowers,
/turf/open/floor/plating/dirt/jungleland/toxic_pit,
/area/template_noop)

(1,1,1) = {"
Y
Y
Y
Y
Y
Y
Y
Y
Y
Y
Y
Y
p
Y
Y
Y
Y
d
Y
Y
Y
Y
Y
Y
Y
Y
Y
Y
Y
Y
"}
(2,1,1) = {"
Y
Y
Y
Y
Y
Y
Y
Y
B
Y
Y
f
Y
Y
Y
B
Y
D
Y
Y
Y
Y
Y
Y
Y
Y
Y
Y
Y
Y
"}
(3,1,1) = {"
Y
Y
Y
Y
Y
Y
D
Y
B
B
Y
B
B
B
B
B
B
Y
Y
C
Y
r
Y
Y
Y
f
Y
Y
Y
Y
"}
(4,1,1) = {"
Y
Y
Y
Y
Y
d
B
B
B
B
B
B
B
U
B
B
B
B
B
Y
Y
Y
Y
Y
Y
Y
Y
Y
Y
Y
"}
(5,1,1) = {"
Y
Y
Y
Y
Y
Y
B
B
B
B
B
B
B
B
B
B
B
B
B
f
Y
B
B
Y
Y
Y
D
Y
Y
Y
"}
(6,1,1) = {"
Y
Y
Y
Y
Y
P
B
B
U
B
B
B
B
B
B
s
B
B
B
B
B
B
B
B
Y
d
Y
Y
Y
Y
"}
(7,1,1) = {"
Y
Y
E
Y
Y
B
B
B
B
B
B
B
B
B
B
B
B
B
B
B
B
B
B
B
Y
Y
Y
r
Y
Y
"}
(8,1,1) = {"
Y
Y
Y
T
Y
B
B
B
B
m
B
B
B
B
B
B
B
B
B
B
B
B
B
B
Y
Y
Y
Y
Y
Y
"}
(9,1,1) = {"
Y
Y
Y
Y
Y
B
m
B
B
m
B
w
m
m
B
B
B
Y
Y
B
B
U
B
B
B
Y
B
B
Y
Y
"}
(10,1,1) = {"
Y
d
Y
Q
Y
i
m
V
m
m
m
m
S
m
m
B
B
Y
E
Y
B
B
B
B
B
Y
B
B
Y
Y
"}
(11,1,1) = {"
Y
Y
Y
Y
m
H
m
m
n
H
m
m
m
H
m
L
L
Y
Y
Y
B
B
s
B
B
Y
Y
B
B
Y
"}
(12,1,1) = {"
Y
Y
Y
Y
Y
m
J
m
m
N
m
m
X
m
m
L
L
Z
Y
Y
B
B
B
B
B
Y
Y
B
B
Y
"}
(13,1,1) = {"
Y
Y
O
Y
c
B
B
X
m
z
G
H
m
i
k
B
B
Y
Y
Y
Y
B
B
C
Y
Y
Y
B
B
Y
"}
(14,1,1) = {"
Y
Y
Y
Y
Y
B
B
i
m
t
m
m
I
m
m
B
B
Y
T
Y
Y
Y
Y
Y
Y
Y
Y
B
B
Y
"}
(15,1,1) = {"
Y
Y
Y
Y
Y
B
R
m
H
m
m
o
m
V
m
B
B
Y
Y
Y
Y
Y
Y
Y
Y
O
Y
Y
Y
Y
"}
(16,1,1) = {"
Y
Y
Y
r
Y
B
B
B
m
m
m
m
B
B
B
B
B
B
B
Y
Y
Y
Y
Y
Y
Y
Y
Y
Y
Y
"}
(17,1,1) = {"
Y
Y
Y
Y
Y
B
B
B
m
B
B
B
B
B
B
B
B
B
B
B
Y
Y
Y
Y
Y
d
Y
Y
Y
Y
"}
(18,1,1) = {"
Y
Y
Y
Y
Y
r
B
B
B
B
B
s
B
B
B
B
B
B
B
B
B
Y
Y
Y
Y
Y
Y
Y
Y
Y
"}
(19,1,1) = {"
Y
Y
Y
Y
D
Y
Y
B
B
B
B
B
B
q
B
B
B
B
B
B
B
Y
B
Y
D
Y
Y
E
Y
Y
"}
(20,1,1) = {"
Y
Y
Y
d
Y
Y
B
B
B
B
U
B
B
B
B
B
B
B
B
B
B
B
B
Y
Y
Y
Y
Y
Y
Y
"}
(21,1,1) = {"
Y
Y
Y
Y
Y
Y
B
B
B
B
B
B
B
B
Y
B
B
B
U
B
B
B
B
Y
Y
Y
Y
B
Y
Y
"}
(22,1,1) = {"
Y
Y
Y
Y
Y
B
B
B
B
B
B
B
B
h
u
C
B
B
B
B
B
B
B
Y
Y
Y
B
B
B
Y
"}
(23,1,1) = {"
Y
Y
Y
Y
Y
s
B
B
B
q
B
B
B
B
B
B
B
B
B
B
B
B
Y
Y
Y
B
B
B
B
Y
"}
(24,1,1) = {"
Y
Y
D
Y
Y
Y
Y
B
B
B
B
B
B
B
B
B
B
B
B
B
B
r
P
Y
Y
B
B
B
B
Y
"}
(25,1,1) = {"
Y
Y
Y
Y
Y
Y
Y
Y
B
B
B
B
B
B
U
B
B
B
B
B
B
B
Y
Y
B
B
B
B
B
Y
"}
(26,1,1) = {"
Y
Y
Y
Y
Y
C
Y
Y
Y
B
B
B
B
B
B
B
B
B
B
B
B
Y
Y
Y
B
B
B
B
Y
Y
"}
(27,1,1) = {"
Y
Y
Y
p
Y
Y
Y
Y
r
Y
Y
B
B
B
B
B
B
B
B
B
Y
f
Y
Y
B
B
B
Y
Y
Y
"}
(28,1,1) = {"
Y
Y
Y
Y
Y
Y
Y
Y
Y
Y
Y
Y
Y
Y
K
Y
Y
Y
Y
Y
Y
Y
Y
Y
Y
Y
Y
Y
Y
Y
"}
(29,1,1) = {"
Y
Y
Y
Y
Y
Y
Y
Y
Y
D
Y
Y
Y
Y
Y
D
Y
Y
E
Y
Y
Y
Y
Y
Y
Y
Y
Y
Y
Y
"}
(30,1,1) = {"
Y
Y
Y
Y
Y
Y
Y
Y
Y
Y
Y
Y
Y
Y
Y
Y
Y
Y
Y
Y
Y
Y
Y
Y
Y
Y
Y
Y
Y
Y
"}
