//MAP CONVERTED BY dmm2tgm.py THIS HEADER COMMENT PREVENTS RECONVERSION, DO NOT REMOVE
"a" = (
/turf/template_noop,
/area/template_noop)
"g" = (
/obj/structure/spawner/nest/jungle,
/turf/template_noop,
/area/template_noop)

(1,1,1) = {"
a
a
a
"}
(2,1,1) = {"
a
g
a
"}
(3,1,1) = {"
a
a
a
"}
