//MAP CONVERTED BY dmm2tgm.py THIS HEADER COMMENT PREVENTS RECONVERSION, DO NOT REMOVE
"a" = (
/obj/item/weldingtool/experimental,
/turf/open/floor/plating/dirt/jungleland/jungle,
/area/ruin/unpowered/ivymen)
"b" = (
/obj/structure/table/wood,
/obj/item/storage/belt,
/turf/open/floor/plating/dirt/jungleland/jungle,
/area/ruin/unpowered/ivymen)
"c" = (
/obj/item/storage/toolbox/syndicate,
/turf/open/floor/plating/dirt/jungleland/jungle,
/area/ruin/unpowered/ivymen)
"d" = (
/obj/effect/mob_spawn/human/corpse/damaged,
/obj/effect/decal/cleanable/blood/old,
/turf/open/floor/plating/dirt/jungleland/jungle,
/area/template_noop)
"e" = (
/obj/item/storage/box/rxglasses,
/turf/open/floor/plating/dirt/jungleland/jungle,
/area/ruin/unpowered/ivymen)
"f" = (
/obj/structure/closet/crate/radiation,
/obj/item/flashlight/lantern,
/obj/item/flashlight/lantern,
/obj/item/flashlight/lantern,
/obj/item/flashlight/lantern,
/obj/item/flashlight/flare,
/obj/item/hand_labeler,
/obj/item/hand_labeler_refill,
/turf/open/floor/plating/dirt/jungleland/jungle,
/area/ruin/unpowered/ivymen)
"g" = (
/obj/structure/flora/grass/jungle/b,
/turf/open/floor/plating/dirt/jungleland/jungle,
/area/template_noop)
"h" = (
/obj/structure/barricade/wooden,
/turf/open/floor/plating/dirt/jungleland/jungle,
/area/template_noop)
"i" = (
/obj/item/flashlight/lantern{
	on = 1
	},
/turf/open/indestructible/grass,
/area/ruin/unpowered/ivymen)
"j" = (
/turf/closed/mineral/ash_rock,
/area/template_noop)
"k" = (
/obj/structure/table/wood,
/obj/item/flashlight/lantern,
/obj/item/flashlight/lantern,
/obj/item/flashlight/lantern,
/turf/open/floor/plating/dirt/jungleland/jungle,
/area/ruin/unpowered/ivymen)
"l" = (
/turf/closed/indestructible/rock/wood,
/area/ruin/unpowered/ivymen)
"m" = (
/obj/machinery/iv_drip,
/obj/item/reagent_containers/glass/beaker/waterbottle/large,
/turf/open/floor/plating/dirt/jungleland/jungle,
/area/ruin/unpowered/ivymen)
"n" = (
/obj/structure/flora/rock/pile/largejungle,
/turf/open/floor/plating/dirt/jungleland/jungle,
/area/template_noop)
"o" = (
/obj/effect/decal/cleanable/blood/old,
/turf/open/floor/plating/dirt/jungleland/jungle,
/area/template_noop)
"p" = (
/obj/structure/flora/rock/jungle,
/turf/open/floor/plating/dirt/jungleland/jungle,
/area/template_noop)
"q" = (
/obj/structure/necropolis_gate{
	name = "ancient gate"
	},
/obj/structure/fans/tiny/invisible,
/turf/open/indestructible/grass,
/area/ruin/unpowered/ivymen)
"s" = (
/obj/item/malf_upgrade,
/obj/item/stack/sheet/mineral/mythril{
	amount = 50
	},
/turf/open/floor/plating/dirt/jungleland/jungle,
/area/ruin/unpowered/ivymen)
"u" = (
/obj/item/storage/bag/plants/portaseeder,
/turf/open/floor/plating/dirt/jungleland/jungle,
/area/ruin/unpowered/ivymen)
"v" = (
/obj/structure/closet/crate/medical,
/obj/item/reagent_containers/blood/OMinus,
/obj/item/reagent_containers/blood/OMinus,
/obj/item/stack/sheet/cloth/ten,
/obj/item/healthanalyzer,
/obj/item/clothing/glasses/science,
/obj/item/reagent_containers/glass/bottle/synaptizine,
/obj/item/reagent_containers/glass/bottle/synaptizine,
/obj/item/reagent_containers/glass/bottle/synaptizine,
/turf/open/floor/plating/dirt/jungleland/jungle,
/area/ruin/unpowered/ivymen)
"w" = (
/obj/structure/yog_jungle/ivymen,
/turf/open/indestructible/grass,
/area/ruin/unpowered/ivymen)
"x" = (
/obj/item/seeds/bamboo,
/turf/open/floor/plating/dirt/jungleland/jungle,
/area/template_noop)
"y" = (
/turf/open/floor/plating/dirt/jungleland/jungle,
/area/template_noop)
"z" = (
/obj/item/flashlight/flare/torch,
/turf/open/floor/plating/dirt/jungleland/jungle,
/area/template_noop)
"A" = (
/obj/structure/table/wood,
/obj/item/twohanded/spear,
/obj/item/twohanded/spear,
/obj/item/twohanded/spear,
/obj/item/clothing/head/helmet/roman/legionnaire,
/turf/open/floor/plating/dirt/jungleland/jungle,
/area/ruin/unpowered/ivymen)
"B" = (
/turf/open/floor/plating/ashplanet/rocky/jungle,
/area/template_noop)
"C" = (
/obj/structure/sink/puddle,
/turf/open/floor/plating/dirt/jungleland/jungle,
/area/template_noop)
"D" = (
/obj/item/cultivator/rake,
/turf/open/floor/plating/dirt/jungleland/jungle,
/area/template_noop)
"E" = (
/obj/structure/bonfire/dense,
/turf/open/floor/plating/dirt/jungleland/jungle,
/area/template_noop)
"F" = (
/obj/item/hatchet/wooden,
/turf/open/floor/plating/dirt/jungleland/jungle,
/area/template_noop)
"G" = (
/turf/closed/wall/mineral/wood,
/area/ruin/unpowered/ivymen)
"H" = (
/obj/structure/flora/grass/jungle,
/turf/open/floor/plating/dirt/jungleland/jungle,
/area/template_noop)
"I" = (
/obj/structure/flora/junglebush/c,
/turf/open/floor/plating/dirt/jungleland/jungle,
/area/template_noop)
"K" = (
/obj/structure/flora/junglebush,
/turf/open/floor/plating/dirt/jungleland/jungle,
/area/template_noop)
"L" = (
/obj/item/stack/sheet/mineral/wood,
/obj/item/stack/sheet/mineral/wood,
/obj/item/stack/sheet/mineral/wood,
/obj/item/stack/sheet/mineral/wood,
/obj/item/seeds/tower,
/turf/open/floor/plating/dirt/jungleland/jungle,
/area/ruin/unpowered/ivymen)
"N" = (
/obj/structure/table/wood,
/obj/item/twohanded/spear,
/obj/item/twohanded/spear,
/obj/item/twohanded/spear,
/obj/item/scythe,
/turf/open/floor/plating/dirt/jungleland/jungle,
/area/ruin/unpowered/ivymen)
"O" = (
/obj/machinery/hydroponics/soil,
/turf/open/floor/plating/dirt/jungleland/jungle,
/area/template_noop)
"P" = (
/obj/item/reagent_containers/glass/bucket/wooden,
/turf/open/floor/plating/dirt/jungleland/jungle,
/area/template_noop)
"Q" = (
/obj/structure/table/optable,
/turf/open/floor/plating/dirt/jungleland/jungle,
/area/ruin/unpowered/ivymen)
"R" = (
/obj/structure/flora/rock,
/turf/open/floor/plating/dirt/jungleland/jungle,
/area/template_noop)
"S" = (
/obj/structure/sink/puddle,
/turf/open/floor/plating/dirt/jungleland/jungle,
/area/ruin/unpowered/ivymen)
"T" = (
/obj/item/shovel,
/turf/open/floor/plating/dirt/jungleland/jungle,
/area/template_noop)
"V" = (
/obj/item/construction/rcd/loaded,
/turf/open/floor/plating/dirt/jungleland/jungle,
/area/ruin/unpowered/ivymen)
"X" = (
/turf/open/floor/plating/dirt/jungleland/jungle,
/area/ruin/unpowered/ivymen)
"Y" = (
/turf/open/indestructible/grass,
/area/ruin/unpowered/ivymen)
"Z" = (
/obj/structure/flora/junglebush/large,
/turf/open/floor/plating/dirt/jungleland/jungle,
/area/template_noop)

(1,1,1) = {"
j
j
j
G
G
G
G
h
h
h
h
y
K
y
y
h
h
h
j
j
"}
(2,1,1) = {"
j
j
G
G
N
A
G
y
y
y
y
y
y
y
I
y
y
y
j
j
"}
(3,1,1) = {"
j
j
G
b
X
X
X
B
B
B
B
B
y
H
y
Z
y
y
R
j
"}
(4,1,1) = {"
j
j
G
k
X
X
G
o
g
y
I
B
y
y
g
y
O
y
y
y
"}
(5,1,1) = {"
j
j
G
G
G
G
G
y
Z
I
y
B
y
K
y
y
y
O
y
y
"}
(6,1,1) = {"
j
j
l
l
l
l
l
l
y
g
z
B
B
B
B
C
D
O
y
y
"}
(7,1,1) = {"
j
l
l
l
l
l
l
l
l
y
y
B
y
y
y
P
y
O
y
y
"}
(8,1,1) = {"
j
l
l
i
Y
Y
Y
l
l
y
I
B
y
y
d
H
O
y
H
y
"}
(9,1,1) = {"
j
l
l
X
X
X
Y
l
l
y
y
B
g
y
y
x
y
y
y
j
"}
(10,1,1) = {"
j
l
l
X
w
X
Y
Y
q
B
B
B
y
y
E
F
y
n
y
j
"}
(11,1,1) = {"
j
l
l
X
X
X
Y
l
l
y
y
B
y
y
y
y
H
y
y
j
"}
(12,1,1) = {"
j
l
l
i
Y
Y
Y
l
l
g
y
B
y
H
y
y
y
y
y
y
"}
(13,1,1) = {"
j
l
l
l
l
l
l
l
l
y
g
B
y
y
K
y
O
y
y
y
"}
(14,1,1) = {"
j
j
l
l
l
l
l
l
p
R
y
B
d
y
y
P
y
O
y
y
"}
(15,1,1) = {"
j
j
G
G
G
G
G
G
y
y
z
B
B
B
B
C
T
O
y
y
"}
(16,1,1) = {"
j
j
G
Q
X
u
L
G
g
y
y
B
y
Z
y
y
y
O
y
y
"}
(17,1,1) = {"
j
j
G
c
X
a
v
G
y
y
y
B
y
g
y
I
O
y
y
j
"}
(18,1,1) = {"
j
j
G
s
e
V
X
X
B
B
B
B
y
y
y
y
g
y
y
j
"}
(19,1,1) = {"
j
j
G
G
m
S
f
G
y
y
y
y
y
I
y
y
y
y
p
j
"}
(20,1,1) = {"
j
j
j
G
G
G
G
G
h
h
h
h
y
y
y
h
h
h
j
j
"}
