//MAP CONVERTED BY dmm2tgm.py THIS HEADER COMMENT PREVENTS RECONVERSION, DO NOT REMOVE
"a" = (
/obj/item/cultivator/rake,
/turf/open/indestructible/grass/jungle,
/area/template_noop)
"b" = (
/obj/structure/flora/junglebush,
/turf/open/indestructible/grass/jungle,
/area/template_noop)
"c" = (
/turf/open/floor/plating/dirt/jungleland/jungle,
/area/template_noop)
"e" = (
/turf/open/water/toxic_pit,
/area/template_noop)
"f" = (
/obj/structure/sink/puddle,
/turf/open/indestructible/grass/jungle,
/area/template_noop)
"j" = (
/turf/open/indestructible/grass/jungle,
/area/template_noop)
"l" = (
/obj/structure/flora/grass/jungle,
/turf/open/floor/plating/dirt/jungleland/jungle,
/area/template_noop)
"o" = (
/obj/structure/flora/rock/jungle,
/turf/open/indestructible/grass/jungle,
/area/template_noop)
"p" = (
/obj/structure/flora/grass/jungle/b,
/turf/open/indestructible/grass/jungle,
/area/template_noop)
"q" = (
/obj/structure/flora/tree/jungle,
/turf/open/floor/plating/dirt/jungleland/jungle,
/area/template_noop)
"s" = (
/obj/structure/flora/junglebush/b,
/turf/open/indestructible/grass/jungle,
/area/template_noop)
"u" = (
/mob/living/simple_animal/hostile/yog_jungle/dryad{
	desc = "An elderly spirit. It looks to have tended to this quaint garden for a very long time.";
	name = "The Gardener"
	},
/turf/open/floor/plating/dirt/jungleland/jungle,
/area/template_noop)
"w" = (
/obj/structure/mineral_door/paperframe,
/turf/open/floor/plating/dirt/jungleland/jungle,
/area/template_noop)
"x" = (
/obj/structure/flora/tree/jungle/small,
/turf/open/indestructible/grass/jungle,
/area/template_noop)
"z" = (
/obj/structure/table/wood,
/obj/item/reagent_containers/food/snacks/bait/wild,
/obj/item/reagent_containers/food/snacks/bait/wild,
/obj/item/reagent_containers/food/snacks/bait/wild,
/obj/item/reagent_containers/food/snacks/bait/wild,
/obj/item/reagent_containers/food/snacks/bait/wild,
/obj/item/reagent_containers/food/snacks/bait/wild,
/turf/open/indestructible/grass/jungle,
/area/template_noop)
"A" = (
/obj/structure/window/paperframe{
	can_atmos_pass = 0
	},
/turf/open/floor/wood/jungle,
/area/template_noop)
"B" = (
/obj/structure/flora/junglebush/c,
/turf/open/indestructible/grass/jungle,
/area/template_noop)
"F" = (
/obj/machinery/hydroponics/soil,
/turf/open/indestructible/grass/jungle,
/area/template_noop)
"H" = (
/obj/structure/chair/sofa/bamboo/left,
/turf/open/indestructible/grass/jungle,
/area/template_noop)
"I" = (
/turf/closed/wall/mineral/wood,
/area/template_noop)
"K" = (
/obj/structure/flora/grass/jungle,
/turf/open/indestructible/grass/jungle,
/area/template_noop)
"L" = (
/obj/item/twohanded/fishingrod,
/obj/item/clothing/head/fishing,
/obj/item/clothing/gloves/fishing,
/turf/open/indestructible/grass/jungle,
/area/template_noop)
"S" = (
/obj/structure/flytrap,
/turf/open/indestructible/grass/jungle,
/area/template_noop)
"T" = (
/obj/structure/chair/sofa/bamboo/right,
/turf/open/indestructible/grass/jungle,
/area/template_noop)
"V" = (
/obj/structure/mineral_door/paperframe,
/turf/open/floor/wood/jungle,
/area/template_noop)
"Y" = (
/obj/structure/flora/junglebush/large,
/turf/open/indestructible/grass/jungle,
/area/template_noop)

(1,1,1) = {"
c
c
c
c
c
c
c
c
c
c
c
c
c
c
c
c
c
c
c
c
"}
(2,1,1) = {"
c
I
A
A
A
A
A
A
A
A
A
A
A
A
A
A
A
A
I
c
"}
(3,1,1) = {"
c
A
j
c
j
j
j
j
j
j
j
j
j
c
j
j
j
S
A
c
"}
(4,1,1) = {"
c
A
j
q
j
j
j
j
Y
j
S
j
j
j
q
c
j
j
A
c
"}
(5,1,1) = {"
c
A
c
j
j
p
q
F
a
F
j
j
j
c
l
j
j
j
A
c
"}
(6,1,1) = {"
c
A
j
j
j
j
p
S
j
j
j
K
j
j
j
j
j
j
A
c
"}
(7,1,1) = {"
c
A
j
j
q
c
c
c
c
c
j
j
q
j
j
q
j
j
A
c
"}
(8,1,1) = {"
c
A
p
B
f
c
c
u
c
c
c
j
K
j
K
j
o
j
A
c
"}
(9,1,1) = {"
c
A
j
S
c
c
T
L
e
c
c
j
j
f
j
S
j
c
A
c
"}
(10,1,1) = {"
c
w
c
c
c
j
H
e
e
e
c
c
j
j
j
j
c
c
V
c
"}
(11,1,1) = {"
c
w
c
c
j
j
b
z
e
e
c
c
j
x
j
j
c
c
V
c
"}
(12,1,1) = {"
c
A
j
j
j
j
j
q
o
e
c
c
b
j
j
j
c
c
A
c
"}
(13,1,1) = {"
c
A
j
j
p
j
j
j
q
j
j
c
c
j
j
c
c
j
A
c
"}
(14,1,1) = {"
c
A
j
q
j
j
j
j
j
j
q
p
c
c
c
c
j
j
A
c
"}
(15,1,1) = {"
c
A
j
p
j
j
B
j
j
j
p
j
c
c
c
f
j
S
A
c
"}
(16,1,1) = {"
c
A
j
j
j
c
q
j
j
j
j
S
j
j
j
j
j
j
A
c
"}
(17,1,1) = {"
c
A
j
q
j
j
S
j
j
j
q
j
j
j
j
j
q
s
A
c
"}
(18,1,1) = {"
c
A
j
j
j
j
j
j
j
j
j
j
j
j
j
j
j
c
A
c
"}
(19,1,1) = {"
c
I
A
A
A
A
A
A
A
A
A
A
A
A
A
A
A
A
I
c
"}
(20,1,1) = {"
c
c
c
c
c
c
c
c
c
c
c
c
c
c
c
c
c
c
c
c
"}
