//MAP CONVERTED BY dmm2tgm.py THIS HEADER COMMENT PREVENTS RECONVERSION, DO NOT REMOVE
"ac" = (
/obj/structure/bonfire/prelit,
/turf/open/floor/plating/dirt/jungleland/barren_rocks,
/area/ruin/unpowered/tar_temple)
"ad" = (
/obj/structure/barricade/wooden,
/turf/open/floor/plating/dirt/jungleland/barren_rocks,
/area/ruin/unpowered/tar_temple)
"ag" = (
/obj/structure/table/wood,
/obj/item/clothing/head/helmet/gladiator,
/turf/open/floor/plating/dirt/jungleland/barren_rocks,
/area/ruin/unpowered/tar_temple)
"ah" = (
/obj/effect/decal/cleanable/blood/old,
/turf/open/floor/plating/dirt/jungleland/dying_forest,
/area/ruin/unpowered/tar_temple)
"ai" = (
/turf/open/floor/plating/dirt/jungleland/dying_forest,
/area/template_noop)
"aj" = (
/obj/structure/stone_tile/slab/cracked{
	dir = 5
	},
/turf/open/floor/plating/dirt/jungleland/dying_forest,
/area/ruin/unpowered/tar_temple)
"ak" = (
/obj/structure/stone_tile/block{
	dir = 8
	},
/turf/open/floor/plating/dirt/jungleland/dying_forest,
/area/ruin/unpowered/tar_temple)
"al" = (
/turf/template_noop,
/area/template_noop)
"am" = (
/obj/effect/decal/remains/human,
/turf/open/floor/plating/dirt/jungleland/dying_forest,
/area/ruin/unpowered/tar_temple)
"an" = (
/mob/living/simple_animal/hostile/tar/amalgamation,
/turf/open/floor/plating/dirt/jungleland/dying_forest,
/area/ruin/unpowered/tar_temple)
"aq" = (
/obj/structure/chair/wood{
	dir = 4
	},
/obj/structure/chair/wood{
	dir = 4
	},
/turf/open/floor/plating/dirt/jungleland/dying_forest,
/area/ruin/unpowered/tar_temple)
"as" = (
/obj/item/gun/ballistic/bow,
/turf/open/floor/plating/dirt/jungleland/dying_forest,
/area/ruin/unpowered/tar_temple)
"at" = (
/obj/item/ammo_casing/caseless/arrow/bone,
/turf/open/floor/plating/dirt/jungleland/dying_forest,
/area/ruin/unpowered/tar_temple)
"au" = (
/obj/structure/stone_tile/slab,
/turf/open/floor/plating/dirt/jungleland/dying_forest,
/area/ruin/unpowered/tar_temple)
"av" = (
/obj/structure/stone_tile/block{
	dir = 8
	},
/obj/structure/stone_tile/block{
	dir = 8
	},
/turf/open/floor/plating/dirt/jungleland/dying_forest,
/area/ruin/unpowered/tar_temple)
"aw" = (
/turf/closed/indestructible/riveted/boss,
/area/ruin/unpowered/tar_temple)
"ax" = (
/obj/structure/bonfire/prelit,
/turf/open/floor/plating/dirt/jungleland/dying_forest,
/area/ruin/unpowered/tar_temple)
"ay" = (
/obj/structure/stone_tile/block{
	dir = 4
	},
/obj/structure/stone_tile/block{
	dir = 4
	},
/turf/open/floor/plating/dirt/jungleland/dying_forest,
/area/ruin/unpowered/tar_temple)
"az" = (
/turf/open/water/tar_basin,
/area/ruin/unpowered/tar_temple)
"aF" = (
/obj/structure/chair/wood{
	dir = 8
	},
/turf/open/floor/plating/dirt/jungleland/dying_forest,
/area/ruin/unpowered/tar_temple)
"aH" = (
/obj/structure/chair/wood{
	dir = 4
	},
/turf/open/floor/plating/dirt/jungleland/dying_forest,
/area/ruin/unpowered/tar_temple)
"aI" = (
/obj/structure/stone_tile/block{
	dir = 4
	},
/turf/open/floor/plating/dirt/jungleland/dying_forest,
/area/ruin/unpowered/tar_temple)
"aL" = (
/mob/living/simple_animal/hostile/tar/dryad,
/turf/open/floor/plating/dirt/jungleland/dying_forest,
/area/ruin/unpowered/tar_temple)
"aM" = (
/obj/item/chair/wood,
/obj/structure/stone_tile/block{
	dir = 8
	},
/turf/open/floor/plating/dirt/jungleland/dying_forest,
/area/ruin/unpowered/tar_temple)
"aN" = (
/obj/structure/fluff/tarstatue,
/turf/open/floor/plating/dirt/jungleland/dying_forest,
/area/ruin/unpowered/tar_temple)
"aO" = (
/turf/open/floor/plating/dirt/jungleland/dying_forest,
/area/ruin/unpowered/tar_temple)
"aP" = (
/obj/structure/stone_tile/slab/cracked,
/turf/open/floor/plating/dirt/jungleland/dying_forest,
/area/ruin/unpowered/tar_temple)
"aS" = (
/obj/structure/necropolis_gate{
	name = "ancient gate"
	},
/turf/open/floor/plating/dirt/jungleland/barren_rocks,
/area/ruin/unpowered/tar_temple)
"aT" = (
/obj/structure/stone_tile/cracked,
/turf/open/floor/plating/dirt/jungleland/dying_forest,
/area/ruin/unpowered/tar_temple)
"aV" = (
/turf/open/floor/plating/jungle_baseturf/dying,
/area/template_noop)
"aX" = (
/obj/structure/bonfire/prelit,
/turf/open/floor/plating/dirt/jungleland/dying_forest,
/area/template_noop)
"aY" = (
/turf/open/floor/plating/dirt/jungleland/barren_rocks,
/area/ruin/unpowered/tar_temple)
"aZ" = (
/obj/effect/turf_decal/sand/plating,
/turf/open/floor/plating/jungle_baseturf/dying,
/area/template_noop)
"cB" = (
/obj/effect/decal/cleanable/blood/old,
/mob/living/simple_animal/hostile/tar/shade,
/turf/open/floor/plating/dirt/jungleland/dying_forest,
/area/ruin/unpowered/tar_temple)
"eT" = (
/obj/structure/stone_tile/block{
	dir = 8
	},
/turf/open/floor/plating/dirt/jungleland/obsidian,
/area/ruin/unpowered/tar_temple)
"fA" = (
/obj/effect/decal/remains/human,
/obj/item/storage/belt/quiver,
/obj/item/ammo_casing/reusable/arrow/bamboo,
/turf/open/floor/plating/dirt/jungleland/dying_forest,
/area/ruin/unpowered/tar_temple)
"hc" = (
/obj/structure/stone_tile{
	dir = 1
	},
/turf/open/floor/plating/dirt/jungleland/dying_forest,
/area/ruin/unpowered/tar_temple)
"kE" = (
/obj/structure/tar_altar,
/turf/open/floor/plating/dirt/jungleland/obsidian,
/area/ruin/unpowered/tar_temple)
"px" = (
/obj/structure/necropolis_gate{
	name = "ancient gate"
	},
/obj/structure/fans/tiny/invisible,
/turf/open/floor/plating/dirt/jungleland/barren_rocks,
/area/ruin/unpowered/tar_temple)
"pT" = (
/obj/effect/decal/remains/human,
/obj/item/clothing/head/helmet/shaman,
/obj/item/tar_crystal,
/obj/item/melee/spear/bamboospear,
/turf/open/floor/plating/dirt/jungleland/dying_forest,
/area/ruin/unpowered/tar_temple)
"sm" = (
/obj/structure/stone_tile/surrounding_tile{
	dir = 4
	},
/turf/open/floor/plating/dirt/jungleland/obsidian,
/area/ruin/unpowered/tar_temple)
"BY" = (
/obj/item/flashlight/lantern,
/turf/open/floor/plating/dirt/jungleland/dying_forest,
/area/ruin/unpowered/tar_temple)
"FS" = (
/obj/item/ammo_casing/reusable/arrow/bamboo,
/turf/open/floor/plating/dirt/jungleland/dying_forest,
/area/ruin/unpowered/tar_temple)
"GL" = (
/obj/structure/stone_tile/surrounding_tile{
	dir = 8
	},
/turf/open/floor/plating/dirt/jungleland/obsidian,
/area/ruin/unpowered/tar_temple)
"KL" = (
/obj/structure/stone_tile/block{
	dir = 4
	},
/turf/open/floor/plating/dirt/jungleland/obsidian,
/area/ruin/unpowered/tar_temple)
"LV" = (
/obj/structure/table/wood,
/obj/item/flashlight/lantern,
/turf/open/floor/plating/dirt/jungleland/barren_rocks,
/area/ruin/unpowered/tar_temple)
"LW" = (
/obj/structure/stone_tile/burnt{
	dir = 4
	},
/turf/open/floor/plating/dirt/jungleland/dying_forest,
/area/ruin/unpowered/tar_temple)
"OU" = (
/obj/structure/stone_tile{
	dir = 4
	},
/turf/open/floor/plating/dirt/jungleland/dying_forest,
/area/ruin/unpowered/tar_temple)
"Pi" = (
/obj/structure/stone_tile{
	dir = 8
	},
/turf/open/floor/plating/dirt/jungleland/dying_forest,
/area/ruin/unpowered/tar_temple)
"Rb" = (
/obj/structure/stone_tile/block{
	dir = 1
	},
/turf/open/floor/plating/dirt/jungleland/obsidian,
/area/ruin/unpowered/tar_temple)
"Uk" = (
/obj/structure/stone_tile/surrounding_tile,
/turf/open/floor/plating/dirt/jungleland/obsidian,
/area/ruin/unpowered/tar_temple)
"UM" = (
/obj/structure/stone_tile,
/turf/open/floor/plating/dirt/jungleland/dying_forest,
/area/ruin/unpowered/tar_temple)
"Vr" = (
/obj/structure/stone_tile/block,
/turf/open/floor/plating/dirt/jungleland/obsidian,
/area/ruin/unpowered/tar_temple)
"Xd" = (
/obj/structure/stone_tile/surrounding_tile{
	dir = 1
	},
/turf/open/floor/plating/dirt/jungleland/obsidian,
/area/ruin/unpowered/tar_temple)
"YE" = (
/obj/structure/table/wood,
/obj/item/melee/spear/bamboospear,
/turf/open/floor/plating/dirt/jungleland/barren_rocks,
/area/ruin/unpowered/tar_temple)

(1,1,1) = {"
al
al
al
al
al
ai
aw
aw
aw
aw
aw
aw
aw
aw
aw
aw
aw
aw
aw
aw
aw
aw
aw
aw
aw
aw
aw
ai
al
al
al
al
al
al
al
al
al
al
al
"}
(2,1,1) = {"
al
al
al
al
ai
aw
aw
aY
aY
aY
aY
aY
aY
aY
aY
aY
aY
aY
aY
aY
aY
aY
aY
aY
aY
aY
aw
aw
ai
al
al
al
al
al
al
al
al
al
al
"}
(3,1,1) = {"
al
al
al
ai
aw
aw
ac
aY
aY
aY
aY
aY
aY
aY
ad
ad
aY
aY
ad
aY
aY
aY
aY
aY
aY
aY
aY
aw
aw
ai
al
al
al
al
al
al
al
al
al
"}
(4,1,1) = {"
al
al
al
ai
aw
aY
aY
aY
aY
LV
aw
aw
aw
aw
aw
aw
aw
aw
aw
aw
aw
aw
aw
aw
aw
aY
aY
aY
aw
aw
ai
al
al
al
al
al
al
al
al
"}
(5,1,1) = {"
al
al
al
ai
aw
aY
aY
aY
ag
aw
aw
aO
aO
aO
aO
aO
aO
aO
aO
aO
aO
aO
aO
aO
aw
aw
aY
aY
aY
aw
aw
ai
al
al
al
al
al
al
al
"}
(6,1,1) = {"
al
al
al
ai
aw
aY
aY
YE
aw
aw
aO
aO
aq
aH
aH
aH
aH
aO
aH
aH
aH
aO
aO
aO
aO
aw
aw
aY
aY
aY
aw
aw
ai
al
al
al
al
al
al
"}
(7,1,1) = {"
al
al
al
ai
aw
aY
aY
aY
aw
az
aO
ak
av
ak
ak
ak
ak
aM
ak
ak
ak
ak
ak
ak
aO
aO
aw
aw
aY
aY
aY
aw
aw
ai
al
al
al
al
al
"}
(8,1,1) = {"
al
al
ai
aw
aw
aY
aY
aY
aw
az
ax
az
az
az
az
az
az
az
az
az
az
az
az
az
ax
az
az
aw
aw
aY
aY
aY
aw
aw
ai
al
al
al
al
"}
(9,1,1) = {"
al
ai
aw
aw
aY
aY
aY
aw
aw
az
az
az
az
az
az
az
az
az
az
az
az
az
az
az
az
az
au
az
aw
aw
aY
aY
aY
aw
ai
al
al
al
al
"}
(10,1,1) = {"
ai
aw
aw
aY
aY
aY
aw
aw
az
az
az
az
ay
aI
aI
aI
aI
aI
aI
aI
aI
aI
aI
aI
aI
au
aO
au
az
aw
aw
aY
aY
aw
ai
al
al
al
al
"}
(11,1,1) = {"
aw
aw
aY
aY
aY
aw
aw
az
az
az
aN
az
aO
aO
aO
aO
aO
aO
aO
aO
aO
aO
aO
aO
aO
aO
aO
au
az
az
aw
aY
aY
aw
aw
ai
al
al
al
"}
(12,1,1) = {"
aw
aY
aY
aY
aw
aw
az
au
az
az
az
az
aO
aO
aO
aO
aO
aO
aO
aO
aO
aO
aO
aO
aO
aO
aO
au
az
aN
aw
aY
aY
aY
aw
ai
ai
al
al
"}
(13,1,1) = {"
aw
aY
aY
aw
aw
az
aO
aO
aO
az
az
az
aO
aO
FS
aO
aO
aO
aO
aO
aO
aO
aO
aO
aO
aO
aO
au
az
az
aw
ac
aY
aY
aw
ai
ai
ai
al
"}
(14,1,1) = {"
aw
aY
aY
aw
az
aO
aO
aO
ah
aO
az
am
aO
LW
au
au
au
au
au
au
aP
au
Pi
aO
aO
aO
aO
au
az
az
aw
aw
aY
aY
aw
ai
ai
ai
ai
"}
(15,1,1) = {"
aw
aY
aY
aw
az
aO
aO
au
aO
aO
az
az
OU
au
BY
aO
aO
aO
an
aO
aO
BY
au
Pi
aO
ah
aO
au
au
az
az
aw
aY
aY
aw
ai
ai
aX
ai
"}
(16,1,1) = {"
aw
aY
ad
aw
az
BY
aO
at
au
aO
az
aO
au
aO
aO
aO
aO
aO
aO
aO
aO
aO
am
au
aO
at
aO
aO
aO
au
az
aw
aY
aY
aw
ai
ai
ai
ai
"}
(17,1,1) = {"
aw
aY
ad
aw
az
au
au
au
aO
aO
az
az
au
aO
aO
aO
aL
aO
aO
aO
aO
aO
aO
au
aO
aO
aO
aO
aO
au
az
aw
aY
aY
aw
ai
ai
ai
ai
"}
(18,1,1) = {"
aw
ad
ad
aw
au
az
az
au
aO
aO
aO
az
au
aO
aO
aO
sm
eT
GL
an
aO
aO
aO
aO
au
aO
aO
aO
aO
aO
au
aw
aY
aY
aw
aw
ai
ai
ai
"}
(19,1,1) = {"
aw
aY
ad
aw
az
pT
az
az
au
aj
au
au
aO
aO
aO
cB
Rb
kE
Vr
aO
aO
aO
aO
aO
aO
au
au
au
au
au
au
px
aY
aY
aY
aS
aV
aZ
aZ
"}
(20,1,1) = {"
aw
aY
ad
aw
au
az
az
au
aO
aO
aO
az
au
aO
aO
aO
Xd
KL
Uk
an
aO
aO
aO
aO
au
aO
aO
aO
aO
aO
au
aw
aY
aY
aw
aw
ai
ai
ai
"}
(21,1,1) = {"
aw
aY
aY
aw
az
au
au
au
aO
aO
az
az
au
aO
aO
aO
aL
aO
aO
aO
aO
aO
aO
au
aO
aO
aO
aO
aO
au
az
aw
aY
aY
aw
ai
ai
ai
ai
"}
(22,1,1) = {"
aw
aY
aY
aw
az
BY
aO
aO
au
aO
az
aO
au
aO
aO
aO
aO
FS
aO
aO
aO
aO
aO
au
aO
aO
aO
aO
aO
au
az
aw
aY
aY
aw
ai
ai
ai
ai
"}
(23,1,1) = {"
aw
aY
aY
aw
az
aO
aO
au
aO
aO
az
az
hc
au
BY
aO
aO
aO
an
aO
aO
BY
au
UM
aO
aO
aO
au
au
az
az
aw
aY
aY
aw
ai
ai
aX
ai
"}
(24,1,1) = {"
aw
aY
aY
aw
az
aO
aO
aO
at
aO
az
aO
aO
hc
au
au
au
au
au
au
au
au
aT
aO
aO
aO
aO
au
az
az
aw
aw
aY
aY
aw
ai
ai
ai
ai
"}
(25,1,1) = {"
aw
aY
aY
aw
aw
az
aO
aO
aO
az
az
az
aO
aO
aO
aO
aO
aO
aO
aO
aO
aO
aO
aO
aO
fA
aO
au
az
az
aw
ac
aY
aY
aw
ai
ai
ai
al
"}
(26,1,1) = {"
aw
aY
aY
aY
aw
aw
az
au
az
az
az
az
aO
aO
aO
aO
aO
aO
aO
aO
at
aO
aO
aO
aO
aO
as
au
az
aN
aw
aY
aY
aY
aw
ai
ai
al
al
"}
(27,1,1) = {"
aw
aw
aY
aY
aY
aw
aw
az
az
az
aN
az
ah
aO
aO
aO
aO
aO
aO
aO
aO
aO
aO
aO
aO
aO
FS
au
az
az
aw
aY
aY
aw
aw
ai
al
al
al
"}
(28,1,1) = {"
ai
aw
aw
aY
aY
aY
aw
aw
az
az
az
az
av
ak
ak
ak
ak
ak
ak
ak
ak
ak
ak
ak
ak
au
aO
au
az
aw
aw
aY
aY
aw
ai
al
al
al
al
"}
(29,1,1) = {"
al
ai
aw
aw
aY
aY
aY
aw
aw
az
az
az
az
az
az
az
az
az
az
az
az
az
az
az
az
az
au
az
aw
aw
aY
aY
aY
aw
ai
al
al
al
al
"}
(30,1,1) = {"
al
al
ai
aw
aw
aY
aY
aY
aw
az
ax
az
az
az
az
az
az
az
az
az
az
az
az
az
ax
az
az
aw
aw
aY
aY
aY
aw
aw
ai
al
al
al
al
"}
(31,1,1) = {"
al
al
al
ai
aw
aY
aY
aY
aw
az
aO
aI
ay
aI
aI
aI
aI
aI
aI
aI
aI
aI
aI
aI
aO
aO
aw
aw
aY
aY
aY
aw
aw
ai
al
al
al
al
al
"}
(32,1,1) = {"
al
al
al
ai
aw
aY
aY
LV
aw
aw
aO
aO
aF
aF
aF
aF
aF
aO
aF
aF
aF
aF
aF
aO
aO
aw
aw
aY
aY
aY
aw
aw
ai
al
al
al
al
al
al
"}
(33,1,1) = {"
al
al
al
ai
aw
aY
aY
aY
ag
aw
aw
aO
aO
aO
aO
aO
aO
aO
aO
aO
aO
aO
aO
aO
aw
aw
aY
aY
aY
aw
aw
ai
al
al
al
al
al
al
al
"}
(34,1,1) = {"
al
al
al
ai
aw
aY
aY
aY
aY
YE
aw
aw
aw
aw
aw
aw
aw
aw
aw
aw
aw
aw
aw
aw
aw
aY
aY
aY
aw
aw
ai
al
al
al
al
al
al
al
al
"}
(35,1,1) = {"
al
al
al
ai
aw
aw
ac
aY
aY
aY
aY
aY
ad
ad
ad
ad
ad
aY
aY
aY
aY
aY
aY
aY
aY
aY
aY
aw
aw
ai
al
al
al
al
al
al
al
al
al
"}
(36,1,1) = {"
al
al
al
al
ai
aw
aw
aY
aY
aY
aY
aY
aY
aY
aY
aY
aY
aY
aY
aY
aY
aY
aY
aY
aY
aY
aw
aw
ai
al
al
al
al
al
al
al
al
al
al
"}
(37,1,1) = {"
al
al
al
al
al
ai
aw
aw
aw
aw
aw
aw
aw
aw
aw
aw
aw
aw
aw
aw
aw
aw
aw
aw
aw
aw
aw
ai
al
al
al
al
al
al
al
al
al
al
al
"}
