//MAP CONVERTED BY dmm2tgm.py THIS HEADER COMMENT PREVENTS RECONVERSION, DO NOT REMOVE
"a" = (
/obj/structure/stone_tile/surrounding_tile{
	dir = 8
	},
/turf/open/floor/plating/dirt/jungleland/obsidian,
/area/ruin/unpowered/tar_temple)
"c" = (
/obj/structure/bonfire/prelit,
/turf/open/floor/plating/dirt/jungleland/barren_rocks,
/area/ruin/unpowered/tar_temple)
"d" = (
/obj/structure/barricade/wooden,
/turf/open/floor/plating/dirt/jungleland/barren_rocks,
/area/ruin/unpowered/tar_temple)
"e" = (
/obj/structure/stone_tile/surrounding_tile,
/turf/open/floor/plating/dirt/jungleland/obsidian,
/area/ruin/unpowered/tar_temple)
"f" = (
/obj/structure/stone_tile/block{
	dir = 4
	},
/turf/open/floor/plating/dirt/jungleland/obsidian,
/area/ruin/unpowered/tar_temple)
"g" = (
/obj/structure/table/wood,
/obj/item/clothing/head/helmet/gladiator,
/turf/open/floor/plating/dirt/jungleland/barren_rocks,
/area/ruin/unpowered/tar_temple)
"h" = (
/obj/effect/decal/cleanable/blood/old,
/turf/open/floor/plating/dirt/jungleland/dying_forest,
/area/ruin/unpowered/tar_temple)
"i" = (
/turf/open/floor/plating/dirt/jungleland/dying_forest,
/area/template_noop)
"j" = (
/obj/structure/stone_tile/slab/cracked{
	dir = 5
	},
/turf/open/floor/plating/dirt/jungleland/dying_forest,
/area/ruin/unpowered/tar_temple)
"k" = (
/obj/structure/stone_tile/block{
	dir = 8
	},
/turf/open/floor/plating/dirt/jungleland/dying_forest,
/area/ruin/unpowered/tar_temple)
"l" = (
/turf/template_noop,
/area/template_noop)
"m" = (
/obj/effect/decal/remains/human,
/turf/open/floor/plating/dirt/jungleland/dying_forest,
/area/ruin/unpowered/tar_temple)
"n" = (
/mob/living/simple_animal/hostile/tar/amalgamation,
/turf/open/floor/plating/dirt/jungleland/dying_forest,
/area/ruin/unpowered/tar_temple)
"o" = (
/obj/item/ammo_casing/reusable/arrow/bamboo,
/turf/open/floor/plating/dirt/jungleland/dying_forest,
/area/ruin/unpowered/tar_temple)
"q" = (
/obj/structure/chair/wood{
	dir = 4
	},
/obj/structure/chair/wood{
	dir = 4
	},
/turf/open/floor/plating/dirt/jungleland/dying_forest,
/area/ruin/unpowered/tar_temple)
"r" = (
/obj/structure/stone_tile/surrounding_tile{
	dir = 1
	},
/turf/open/floor/plating/dirt/jungleland/obsidian,
/area/ruin/unpowered/tar_temple)
"s" = (
/obj/item/gun/ballistic/bow,
/turf/open/floor/plating/dirt/jungleland/dying_forest,
/area/ruin/unpowered/tar_temple)
"t" = (
/obj/item/ammo_casing/caseless/arrow/bone,
/turf/open/floor/plating/dirt/jungleland/dying_forest,
/area/ruin/unpowered/tar_temple)
"u" = (
/obj/structure/stone_tile/slab,
/turf/open/floor/plating/dirt/jungleland/dying_forest,
/area/ruin/unpowered/tar_temple)
"v" = (
/obj/structure/stone_tile/block{
	dir = 8
	},
/obj/structure/stone_tile/block{
	dir = 8
	},
/turf/open/floor/plating/dirt/jungleland/dying_forest,
/area/ruin/unpowered/tar_temple)
"w" = (
/turf/closed/indestructible/riveted/boss,
/area/ruin/unpowered/tar_temple)
"x" = (
/obj/structure/bonfire/prelit,
/turf/open/floor/plating/dirt/jungleland/dying_forest,
/area/ruin/unpowered/tar_temple)
"y" = (
/obj/structure/stone_tile/block{
	dir = 4
	},
/obj/structure/stone_tile/block{
	dir = 4
	},
/turf/open/floor/plating/dirt/jungleland/dying_forest,
/area/ruin/unpowered/tar_temple)
"z" = (
/turf/open/water/tar_basin,
/area/ruin/unpowered/tar_temple)
"A" = (
/obj/effect/decal/remains/human,
/obj/item/clothing/head/helmet/shaman,
/obj/item/tar_crystal,
/obj/item/melee/spear/bamboospear,
/turf/open/floor/plating/dirt/jungleland/dying_forest,
/area/ruin/unpowered/tar_temple)
"B" = (
/obj/effect/decal/cleanable/blood/old,
/mob/living/simple_animal/hostile/tar/shade,
/turf/open/floor/plating/dirt/jungleland/dying_forest,
/area/ruin/unpowered/tar_temple)
"C" = (
/obj/structure/necropolis_gate{
	name = "ancient gate"
	},
/obj/structure/fans/tiny/invisible,
/turf/open/floor/plating/dirt/jungleland/barren_rocks,
/area/ruin/unpowered/tar_temple)
"D" = (
/obj/structure/stone_tile/surrounding_tile{
	dir = 4
	},
/turf/open/floor/plating/dirt/jungleland/obsidian,
/area/ruin/unpowered/tar_temple)
"F" = (
/obj/structure/chair/wood{
	dir = 8
	},
/turf/open/floor/plating/dirt/jungleland/dying_forest,
/area/ruin/unpowered/tar_temple)
"H" = (
/obj/structure/chair/wood{
	dir = 4
	},
/turf/open/floor/plating/dirt/jungleland/dying_forest,
/area/ruin/unpowered/tar_temple)
"I" = (
/obj/structure/stone_tile/block{
	dir = 4
	},
/turf/open/floor/plating/dirt/jungleland/dying_forest,
/area/ruin/unpowered/tar_temple)
"J" = (
/obj/effect/decal/remains/human,
/obj/item/storage/belt/quiver,
/obj/item/ammo_casing/reusable/arrow/bamboo,
/turf/open/floor/plating/dirt/jungleland/dying_forest,
/area/ruin/unpowered/tar_temple)
"K" = (
/obj/structure/stone_tile/block{
	dir = 8
	},
/turf/open/floor/plating/dirt/jungleland/obsidian,
/area/ruin/unpowered/tar_temple)
"L" = (
/mob/living/simple_animal/hostile/tar/dryad,
/turf/open/floor/plating/dirt/jungleland/dying_forest,
/area/ruin/unpowered/tar_temple)
"M" = (
/obj/item/chair/wood,
/obj/structure/stone_tile/block{
	dir = 8
	},
/turf/open/floor/plating/dirt/jungleland/dying_forest,
/area/ruin/unpowered/tar_temple)
"N" = (
/obj/structure/fluff/tarstatue,
/turf/open/floor/plating/dirt/jungleland/dying_forest,
/area/ruin/unpowered/tar_temple)
"O" = (
/turf/open/floor/plating/dirt/jungleland/dying_forest,
/area/ruin/unpowered/tar_temple)
"P" = (
/obj/structure/tar_altar,
/turf/open/floor/plating/dirt/jungleland/obsidian,
/area/ruin/unpowered/tar_temple)
"Q" = (
/obj/structure/stone_tile/block{
	dir = 1
	},
/turf/open/floor/plating/dirt/jungleland/obsidian,
/area/ruin/unpowered/tar_temple)
"R" = (
/obj/structure/table/wood,
/obj/item/flashlight/lantern,
/turf/open/floor/plating/dirt/jungleland/barren_rocks,
/area/ruin/unpowered/tar_temple)
"S" = (
/obj/structure/necropolis_gate{
	name = "ancient gate"
	},
/turf/open/floor/plating/dirt/jungleland/barren_rocks,
/area/ruin/unpowered/tar_temple)
"T" = (
/obj/structure/stone_tile/block,
/turf/open/floor/plating/dirt/jungleland/obsidian,
/area/ruin/unpowered/tar_temple)
"U" = (
/obj/structure/table/wood,
/obj/item/melee/spear/bamboospear,
/turf/open/floor/plating/dirt/jungleland/barren_rocks,
/area/ruin/unpowered/tar_temple)
"V" = (
/turf/open/floor/plating/jungle_baseturf/dying,
/area/template_noop)
"W" = (
/obj/item/flashlight/lantern,
/turf/open/floor/plating/dirt/jungleland/dying_forest,
/area/ruin/unpowered/tar_temple)
"X" = (
/obj/structure/bonfire/prelit,
/turf/open/floor/plating/dirt/jungleland/dying_forest,
/area/template_noop)
"Y" = (
/turf/open/floor/plating/dirt/jungleland/barren_rocks,
/area/ruin/unpowered/tar_temple)
"Z" = (
/obj/effect/turf_decal/sand/plating,
/turf/open/floor/plating/jungle_baseturf/dying,
/area/template_noop)

(1,1,1) = {"
l
l
l
l
l
i
w
w
w
w
w
w
w
w
w
w
w
w
w
w
w
w
w
w
w
w
w
i
l
l
l
l
l
l
l
l
l
l
l
"}
(2,1,1) = {"
l
l
l
l
i
w
w
Y
Y
Y
Y
Y
Y
Y
Y
Y
Y
Y
Y
Y
Y
Y
Y
Y
Y
Y
w
w
i
l
l
l
l
l
l
l
l
l
l
"}
(3,1,1) = {"
l
l
l
i
w
w
c
Y
Y
Y
Y
Y
Y
Y
d
d
Y
Y
d
Y
Y
Y
Y
Y
Y
Y
Y
w
w
i
l
l
l
l
l
l
l
l
l
"}
(4,1,1) = {"
l
l
l
i
w
Y
Y
Y
Y
R
w
w
w
w
w
w
w
w
w
w
w
w
w
w
w
Y
Y
Y
w
w
i
l
l
l
l
l
l
l
l
"}
(5,1,1) = {"
l
l
l
i
w
Y
Y
Y
g
w
w
O
O
O
O
O
O
O
O
O
O
O
O
O
w
w
Y
Y
Y
w
w
i
l
l
l
l
l
l
l
"}
(6,1,1) = {"
l
l
l
i
w
Y
Y
U
w
w
O
O
q
H
H
H
H
O
H
H
H
O
O
O
O
w
w
Y
Y
Y
w
w
i
l
l
l
l
l
l
"}
(7,1,1) = {"
l
l
l
i
w
Y
Y
Y
w
z
O
k
v
k
k
k
k
M
k
k
k
k
k
k
O
O
w
w
Y
Y
Y
w
w
i
l
l
l
l
l
"}
(8,1,1) = {"
l
l
i
w
w
Y
Y
Y
w
z
x
z
z
z
z
z
z
z
z
z
z
z
z
z
x
z
z
w
w
Y
Y
Y
w
w
i
l
l
l
l
"}
(9,1,1) = {"
l
i
w
w
Y
Y
Y
w
w
z
z
z
z
z
z
z
z
z
z
z
z
z
z
z
z
z
u
z
w
w
Y
Y
Y
w
i
l
l
l
l
"}
(10,1,1) = {"
i
w
w
Y
Y
Y
w
w
z
z
z
z
y
I
I
I
I
I
I
I
I
I
I
I
I
u
O
u
z
w
w
Y
Y
w
i
l
l
l
l
"}
(11,1,1) = {"
w
w
Y
Y
Y
w
w
z
z
z
N
z
O
O
O
O
O
O
O
O
O
O
O
O
O
O
O
u
z
z
w
Y
Y
w
w
i
l
l
l
"}
(12,1,1) = {"
w
Y
Y
Y
w
w
z
u
z
z
z
z
O
O
O
O
O
O
O
O
O
O
O
O
O
O
O
u
z
N
w
Y
Y
Y
w
i
i
l
l
"}
(13,1,1) = {"
w
Y
Y
w
w
z
O
O
O
z
z
z
O
O
o
O
O
O
O
O
O
O
O
O
O
O
O
u
z
z
w
c
Y
Y
w
i
i
i
l
"}
(14,1,1) = {"
w
Y
Y
w
z
O
O
O
h
O
z
m
O
O
u
u
u
u
u
u
u
u
O
O
O
O
O
u
z
z
w
w
Y
Y
w
i
i
i
i
"}
(15,1,1) = {"
w
Y
Y
w
z
O
O
u
O
O
z
z
O
u
W
O
O
O
n
O
O
W
u
O
O
h
O
u
u
z
z
w
Y
Y
w
i
i
X
i
"}
(16,1,1) = {"
w
Y
d
w
z
W
O
t
u
O
z
O
u
O
O
O
O
O
O
O
O
O
m
u
O
t
O
O
O
u
z
w
Y
Y
w
i
i
i
i
"}
(17,1,1) = {"
w
Y
d
w
z
u
u
u
O
O
z
z
u
O
O
O
L
O
O
O
O
O
O
u
O
O
O
O
O
u
z
w
Y
Y
w
i
i
i
i
"}
(18,1,1) = {"
w
d
d
w
u
z
z
u
O
O
O
z
u
O
O
O
D
K
a
n
O
O
O
O
u
O
O
O
O
O
u
w
Y
Y
w
w
i
i
i
"}
(19,1,1) = {"
w
Y
d
w
z
A
z
z
u
j
u
u
O
O
O
B
Q
P
T
O
O
O
O
O
O
u
u
u
u
u
u
C
Y
Y
Y
S
V
Z
Z
"}
(20,1,1) = {"
w
Y
d
w
u
z
z
u
O
O
O
z
u
O
O
O
r
f
e
n
O
O
O
O
u
O
O
O
O
O
u
w
Y
Y
w
w
i
i
i
"}
(21,1,1) = {"
w
Y
Y
w
z
u
u
u
O
O
z
z
u
O
O
O
L
O
O
O
O
O
O
u
O
O
O
O
O
u
z
w
Y
Y
w
i
i
i
i
"}
(22,1,1) = {"
w
Y
Y
w
z
W
O
O
u
O
z
O
u
O
O
O
O
o
O
O
O
O
O
u
O
O
O
O
O
u
z
w
Y
Y
w
i
i
i
i
"}
(23,1,1) = {"
w
Y
Y
w
z
O
O
u
O
O
z
z
O
u
W
O
O
O
n
O
O
W
u
O
O
O
O
u
u
z
z
w
Y
Y
w
i
i
X
i
"}
(24,1,1) = {"
w
Y
Y
w
z
O
O
O
t
O
z
O
O
O
u
u
u
u
u
u
u
u
O
O
O
O
O
u
z
z
w
w
Y
Y
w
i
i
i
i
"}
(25,1,1) = {"
w
Y
Y
w
w
z
O
O
O
z
z
z
O
O
O
O
O
O
O
O
O
O
O
O
O
J
O
u
z
z
w
c
Y
Y
w
i
i
i
l
"}
(26,1,1) = {"
w
Y
Y
Y
w
w
z
u
z
z
z
z
O
O
O
O
O
O
O
O
t
O
O
O
O
O
s
u
z
N
w
Y
Y
Y
w
i
i
l
l
"}
(27,1,1) = {"
w
w
Y
Y
Y
w
w
z
z
z
N
z
h
O
O
O
O
O
O
O
O
O
O
O
O
O
o
u
z
z
w
Y
Y
w
w
i
l
l
l
"}
(28,1,1) = {"
i
w
w
Y
Y
Y
w
w
z
z
z
z
v
k
k
k
k
k
k
k
k
k
k
k
k
u
O
u
z
w
w
Y
Y
w
i
l
l
l
l
"}
(29,1,1) = {"
l
i
w
w
Y
Y
Y
w
w
z
z
z
z
z
z
z
z
z
z
z
z
z
z
z
z
z
u
z
w
w
Y
Y
Y
w
i
l
l
l
l
"}
(30,1,1) = {"
l
l
i
w
w
Y
Y
Y
w
z
x
z
z
z
z
z
z
z
z
z
z
z
z
z
x
z
z
w
w
Y
Y
Y
w
w
i
l
l
l
l
"}
(31,1,1) = {"
l
l
l
i
w
Y
Y
Y
w
z
O
I
y
I
I
I
I
I
I
I
I
I
I
I
O
O
w
w
Y
Y
Y
w
w
i
l
l
l
l
l
"}
(32,1,1) = {"
l
l
l
i
w
Y
Y
R
w
w
O
O
F
F
F
F
F
O
F
F
F
F
F
O
O
w
w
Y
Y
Y
w
w
i
l
l
l
l
l
l
"}
(33,1,1) = {"
l
l
l
i
w
Y
Y
Y
g
w
w
O
O
O
O
O
O
O
O
O
O
O
O
O
w
w
Y
Y
Y
w
w
i
l
l
l
l
l
l
l
"}
(34,1,1) = {"
l
l
l
i
w
Y
Y
Y
Y
U
w
w
w
w
w
w
w
w
w
w
w
w
w
w
w
Y
Y
Y
w
w
i
l
l
l
l
l
l
l
l
"}
(35,1,1) = {"
l
l
l
i
w
w
c
Y
Y
Y
Y
Y
d
d
d
d
d
Y
Y
Y
Y
Y
Y
Y
Y
Y
Y
w
w
i
l
l
l
l
l
l
l
l
l
"}
(36,1,1) = {"
l
l
l
l
i
w
w
Y
Y
Y
Y
Y
Y
Y
Y
Y
Y
Y
Y
Y
Y
Y
Y
Y
Y
Y
w
w
i
l
l
l
l
l
l
l
l
l
l
"}
(37,1,1) = {"
l
l
l
l
l
i
w
w
w
w
w
w
w
w
w
w
w
w
w
w
w
w
w
w
w
w
w
i
l
l
l
l
l
l
l
l
l
l
l
"}
