//MAP CONVERTED BY dmm2tgm.py THIS HEADER COMMENT PREVENTS RECONVERSION, DO NOT REMOVE
"b" = (
/obj/structure/flora/rock/jungle,
/turf/open/floor/plating/dirt/jungleland/jungle,
/area/template_noop)
"c" = (
/turf/open/floor/plating/dirt/jungleland/barren_rocks,
/area/ruin/unpowered/tar_temple)
"d" = (
/obj/effect/decal/remains/human,
/obj/structure/punji_sticks,
/turf/open/floor/plating/dirt/jungleland/barren_rocks,
/area/ruin/unpowered/tar_temple)
"e" = (
/turf/template_noop,
/area/template_noop)
"f" = (
/obj/structure/stone_tile/slab/cracked,
/turf/open/floor/plating/dirt/jungleland/barren_rocks,
/area/ruin/unpowered/tar_temple)
"g" = (
/obj/structure/punji_sticks,
/turf/open/floor/plating/dirt/jungleland/barren_rocks,
/area/ruin/unpowered/tar_temple)
"h" = (
/obj/structure/stone_tile/slab,
/mob/living/simple_animal/hostile/tar/amalgamation,
/turf/open/floor/plating/dirt/jungleland/barren_rocks,
/area/ruin/unpowered/tar_temple)
"i" = (
/obj/structure/mineral_door/wood,
/obj/structure/barricade/wooden/crude,
/turf/open/floor/plating/dirt/jungleland/barren_rocks,
/area/ruin/unpowered/tar_temple)
"j" = (
/obj/structure/stone_tile/slab,
/turf/open/floor/plating/dirt/jungleland/barren_rocks,
/area/ruin/unpowered/tar_temple)
"k" = (
/obj/structure/necropolis_gate{
	name = "ancient gate"
	},
/obj/structure/stone_tile/slab,
/turf/open/floor/plating/dirt/jungleland/jungle,
/area/ruin/unpowered/tar_temple)
"m" = (
/obj/structure/stone_tile/surrounding_tile{
	dir = 1
	},
/turf/open/floor/plating/dirt/jungleland/barren_rocks,
/area/ruin/unpowered/tar_temple)
"n" = (
/obj/structure/stone_tile/slab,
/mob/living/simple_animal/hostile/tar/dryad,
/turf/open/floor/plating/dirt/jungleland/barren_rocks,
/area/ruin/unpowered/tar_temple)
"o" = (
/obj/structure/stone_tile/surrounding,
/obj/structure/stone_tile/center/burnt,
/mob/living/simple_animal/hostile/asteroid/hivelord/tar,
/turf/open/floor/plating/dirt/jungleland/barren_rocks,
/area/ruin/unpowered/tar_temple)
"p" = (
/obj/structure/stone_tile/block{
	dir = 4
	},
/turf/open/floor/plating/dirt/jungleland/barren_rocks,
/area/ruin/unpowered/tar_temple)
"q" = (
/obj/structure/flora/junglebush/large,
/turf/open/floor/plating/dirt/jungleland/jungle,
/area/template_noop)
"r" = (
/obj/structure/fluff/tarstatue,
/turf/open/floor/plating/dirt/jungleland/jungle,
/area/ruin/unpowered/tar_temple)
"s" = (
/obj/structure/table/wood,
/obj/item/clothing/gloves/bracer,
/turf/open/floor/plating/dirt/jungleland/barren_rocks,
/area/ruin/unpowered/tar_temple)
"t" = (
/obj/structure/stone_tile/slab,
/obj/item/flashlight/lantern{
	light_on = 1
	},
/turf/open/floor/plating/dirt/jungleland/barren_rocks,
/area/ruin/unpowered/tar_temple)
"v" = (
/obj/structure/flora/grass/jungle,
/turf/open/floor/plating/dirt/jungleland/jungle,
/area/template_noop)
"w" = (
/obj/structure/stone_tile/surrounding/burnt,
/obj/structure/bonfire/prelit,
/turf/open/floor/plating/dirt/jungleland/barren_rocks,
/area/ruin/unpowered/tar_temple)
"x" = (
/obj/effect/decal/remains/human,
/turf/open/floor/plating/dirt/jungleland/barren_rocks,
/area/ruin/unpowered/tar_temple)
"y" = (
/obj/structure/bonfire/prelit,
/turf/open/floor/plating/dirt/jungleland/barren_rocks,
/area/ruin/unpowered/tar_temple)
"z" = (
/turf/closed/indestructible/riveted/boss,
/area/ruin/unpowered/tar_temple)
"A" = (
/turf/open/floor/plating/dirt/jungleland/jungle,
/area/template_noop)
"D" = (
/obj/structure/table/wood,
/obj/item/clothing/head/helmet/skull,
/turf/open/floor/plating/dirt/jungleland/barren_rocks,
/area/ruin/unpowered/tar_temple)
"E" = (
/obj/item/stack/sheet/mineral/gold,
/turf/open/floor/plating/dirt/jungleland/barren_rocks,
/area/ruin/unpowered/tar_temple)
"G" = (
/obj/structure/flora/junglebush/b,
/turf/open/floor/plating/dirt/jungleland/jungle,
/area/template_noop)
"I" = (
/obj/structure/stone_tile/block{
	dir = 8
	},
/turf/open/floor/plating/dirt/jungleland/barren_rocks,
/area/ruin/unpowered/tar_temple)
"J" = (
/obj/structure/table/wood,
/obj/item/stack/medical/poultice,
/turf/open/floor/plating/dirt/jungleland/barren_rocks,
/area/ruin/unpowered/tar_temple)
"K" = (
/turf/open/water/tar_basin,
/area/ruin/unpowered/tar_temple)
"L" = (
/obj/structure/stone_tile/surrounding_tile,
/turf/open/floor/plating/dirt/jungleland/barren_rocks,
/area/ruin/unpowered/tar_temple)
"M" = (
/mob/living/simple_animal/hostile/tar/amalgamation,
/turf/open/floor/plating/dirt/jungleland/barren_rocks,
/area/ruin/unpowered/tar_temple)
"N" = (
/obj/effect/decal/cleanable/blood/old,
/turf/open/floor/plating/dirt/jungleland/barren_rocks,
/area/ruin/unpowered/tar_temple)
"P" = (
/obj/structure/flora/tree/jungle,
/turf/open/floor/plating/dirt/jungleland/jungle,
/area/template_noop)
"Q" = (
/obj/structure/stone_tile/surrounding_tile{
	dir = 4
	},
/turf/open/floor/plating/dirt/jungleland/barren_rocks,
/area/ruin/unpowered/tar_temple)
"R" = (
/obj/structure/stone_tile/slab/cracked{
	dir = 6
	},
/turf/open/floor/plating/dirt/jungleland/barren_rocks,
/area/ruin/unpowered/tar_temple)
"T" = (
/obj/structure/stone_tile/surrounding_tile{
	dir = 8
	},
/turf/open/floor/plating/dirt/jungleland/barren_rocks,
/area/ruin/unpowered/tar_temple)
"V" = (
/obj/structure/table/wood,
/obj/item/stack/ore/gold,
/obj/item/stack/ore/gold,
/turf/open/floor/plating/dirt/jungleland/barren_rocks,
/area/ruin/unpowered/tar_temple)
"W" = (
/obj/structure/stone_tile/slab,
/mob/living/simple_animal/hostile/tar/shade,
/turf/open/floor/plating/dirt/jungleland/barren_rocks,
/area/ruin/unpowered/tar_temple)
"X" = (
/obj/structure/fluff/divine/convertaltar,
/obj/structure/stone_tile/surrounding,
/obj/item/tar_crystal,
/turf/open/floor/plating/dirt/jungleland/barren_rocks,
/area/ruin/unpowered/tar_temple)
"Z" = (
/obj/structure/stone_tile/slab,
/turf/open/floor/plating/dirt/jungleland/jungle,
/area/ruin/unpowered/tar_temple)

(1,1,1) = {"
e
e
e
e
e
e
e
e
e
e
e
e
e
e
e
e
e
e
A
A
A
A
A
A
A
A
A
A
A
A
"}
(2,1,1) = {"
e
e
e
e
e
e
e
e
e
e
z
z
z
z
z
z
z
z
z
z
z
z
z
A
G
P
b
A
A
A
"}
(3,1,1) = {"
e
e
e
e
e
e
e
e
e
e
z
p
p
p
p
p
p
p
p
p
p
p
z
A
A
A
A
A
v
A
"}
(4,1,1) = {"
e
e
e
e
e
e
e
e
e
e
z
c
c
c
c
c
c
c
c
z
z
c
z
z
A
v
A
G
A
b
"}
(5,1,1) = {"
e
e
e
e
e
e
e
e
e
e
z
c
c
z
z
z
z
z
z
z
N
c
c
z
A
A
A
A
A
A
"}
(6,1,1) = {"
e
e
e
e
e
e
e
e
e
e
z
c
c
z
D
c
c
c
c
c
c
c
V
z
A
A
v
A
A
A
"}
(7,1,1) = {"
e
e
e
e
e
e
e
e
e
e
z
c
c
z
J
c
c
M
c
z
c
c
c
z
A
A
q
v
A
A
"}
(8,1,1) = {"
e
e
e
e
e
e
e
e
e
e
z
c
c
z
z
z
z
c
c
z
z
z
z
z
A
v
A
A
b
A
"}
(9,1,1) = {"
e
e
e
e
e
e
e
e
e
e
z
c
c
c
c
w
z
y
c
z
A
A
A
A
A
A
A
P
A
A
"}
(10,1,1) = {"
e
e
e
e
e
e
e
e
e
z
z
j
c
c
c
w
z
c
c
z
A
G
A
A
A
A
G
A
A
A
"}
(11,1,1) = {"
e
e
e
z
z
z
z
z
z
z
c
c
j
c
z
z
z
z
i
z
z
z
A
G
A
A
A
A
A
v
"}
(12,1,1) = {"
e
e
e
z
c
c
c
j
c
c
c
c
c
z
z
c
c
c
c
c
c
z
A
A
A
v
A
A
A
A
"}
(13,1,1) = {"
z
z
z
z
c
c
f
j
c
c
c
j
x
z
K
c
x
K
K
g
c
z
z
A
z
A
P
A
q
A
"}
(14,1,1) = {"
z
K
K
K
E
j
c
x
c
j
c
c
j
z
K
K
K
K
K
K
c
g
z
A
z
A
A
A
A
v
"}
(15,1,1) = {"
z
K
j
K
Q
n
T
c
c
c
j
N
j
z
K
K
K
y
K
K
c
x
z
z
z
A
A
A
A
A
"}
(16,1,1) = {"
z
t
X
K
W
o
j
j
h
j
y
c
j
z
K
K
K
r
c
K
c
c
Z
Z
k
A
v
A
A
A
"}
(17,1,1) = {"
z
K
j
K
m
n
L
c
c
c
R
c
j
z
K
K
K
y
K
K
c
c
z
z
z
A
A
A
v
P
"}
(18,1,1) = {"
z
K
K
K
x
j
c
c
E
j
c
x
j
z
K
K
K
K
K
K
c
g
z
A
z
A
A
v
A
A
"}
(19,1,1) = {"
z
z
z
z
c
c
j
j
c
c
c
j
c
z
K
c
c
K
K
d
c
z
z
A
z
A
A
A
A
v
"}
(20,1,1) = {"
e
e
e
z
c
c
c
j
c
c
c
c
c
z
z
c
c
c
c
c
c
z
A
G
A
v
A
G
A
P
"}
(21,1,1) = {"
e
e
e
z
z
z
z
z
z
z
c
c
j
c
z
z
z
z
i
z
z
z
A
A
A
A
A
A
A
A
"}
(22,1,1) = {"
e
e
e
e
e
e
e
e
e
z
z
j
c
c
c
w
z
c
c
z
A
b
A
A
A
G
v
A
A
v
"}
(23,1,1) = {"
e
e
e
e
e
e
e
e
e
e
z
c
c
c
c
w
z
y
c
z
G
A
A
A
v
A
A
A
v
A
"}
(24,1,1) = {"
e
e
e
e
e
e
e
e
e
e
z
c
c
z
z
z
z
c
c
z
z
z
z
z
A
A
A
A
A
A
"}
(25,1,1) = {"
e
e
e
e
e
e
e
e
e
e
z
c
c
z
s
c
c
c
M
z
c
c
c
z
A
q
A
v
A
A
"}
(26,1,1) = {"
e
e
e
e
e
e
e
e
e
e
z
c
c
z
J
c
c
c
c
c
c
c
V
z
A
P
A
A
A
A
"}
(27,1,1) = {"
e
e
e
e
e
e
e
e
e
e
z
c
c
z
z
z
z
z
z
z
c
c
c
z
A
A
A
v
A
A
"}
(28,1,1) = {"
e
e
e
e
e
e
e
e
e
e
z
c
c
c
c
c
c
c
c
z
z
c
z
z
A
v
A
q
A
v
"}
(29,1,1) = {"
e
e
e
e
e
e
e
e
e
e
z
I
I
I
I
I
I
I
I
I
I
I
z
A
G
A
A
A
A
A
"}
(30,1,1) = {"
e
e
e
e
e
e
e
e
e
e
z
z
z
z
z
z
z
z
z
z
z
z
z
b
A
A
A
A
P
A
"}
(31,1,1) = {"
e
e
e
e
e
e
e
e
e
e
e
e
e
e
e
e
e
e
A
A
A
A
A
A
A
A
G
A
A
A
"}
