//MAP CONVERTED BY dmm2tgm.py THIS HEADER COMMENT PREVENTS RECONVERSION, DO NOT REMOVE
"a" = (
/turf/open/floor/plating/dirt/jungleland/toxic_pit,
/area/ruin/unpowered)
"d" = (
/obj/structure/closet/crate/coffin{
	opened = 1
	},
/turf/open/water/toxic_pit,
/area/ruin/unpowered)
"g" = (
/turf/open/water/toxic_pit,
/area/ruin/unpowered)
"h" = (
/turf/open/water/toxic_pit,
/area/template_noop)
"j" = (
/obj/structure/table/wood,
/obj/item/candle/infinite{
	lit = 1
	},
/turf/open/floor/plating/dirt/jungleland/toxic_pit,
/area/ruin/unpowered)
"k" = (
/obj/item/pickaxe/mini,
/turf/open/floor/plating/dirt/jungleland/toxic_pit,
/area/template_noop)
"m" = (
/obj/structure/closet/crate/coffin/blackcoffin,
/obj/item/wisp_lantern,
/turf/open/floor/plating/ashplanet/rocky,
/area/ruin/unpowered)
"n" = (
/obj/item/candle/infinite{
	lit = 1
	},
/turf/open/floor/plating/ashplanet/rocky,
/area/ruin/unpowered)
"o" = (
/obj/machinery/hydroponics/soil,
/turf/open/floor/plating/dirt/jungleland/toxic_pit,
/area/ruin/unpowered)
"v" = (
/mob/living/simple_animal/hostile/skeleton,
/turf/open/floor/plating/dirt/jungleland/toxic_pit,
/area/ruin/unpowered)
"x" = (
/turf/open/floor/plating/ashplanet/rocky,
/area/ruin/unpowered)
"y" = (
/obj/structure/table/wood,
/turf/open/floor/plating/dirt/jungleland/toxic_pit,
/area/ruin/unpowered)
"z" = (
/turf/open/floor/plating/dirt/jungleland/toxic_pit,
/area/template_noop)
"B" = (
/turf/closed/mineral/ash_rock,
/area/ruin/unpowered)
"E" = (
/mob/living/simple_animal/hostile/skeleton,
/turf/open/water/toxic_pit,
/area/ruin/unpowered)
"J" = (
/mob/living/simple_animal/hostile/skeleton,
/turf/open/floor/plating/ashplanet/rocky,
/area/ruin/unpowered)
"M" = (
/obj/structure/closet/crate/coffin{
	opened = 1
	},
/turf/open/floor/plating/dirt/jungleland/toxic_pit,
/area/ruin/unpowered)
"T" = (
/mob/living/simple_animal/hostile/skeleton/templar,
/turf/open/floor/plating/ashplanet/rocky,
/area/ruin/unpowered)

(1,1,1) = {"
z
h
h
h
h
h
h
h
h
h
h
z
h
h
z
z
z
z
z
z
z
"}
(2,1,1) = {"
h
h
h
h
h
h
h
h
h
h
h
h
h
h
h
h
h
h
z
z
z
"}
(3,1,1) = {"
h
h
B
B
B
B
B
B
B
B
B
B
B
B
B
h
h
h
z
z
z
"}
(4,1,1) = {"
h
B
B
g
a
a
a
a
a
a
o
x
x
o
B
B
h
h
h
z
z
"}
(5,1,1) = {"
h
B
a
g
g
g
g
y
j
a
a
x
x
a
g
B
h
h
z
z
z
"}
(6,1,1) = {"
h
B
a
g
g
g
g
g
g
a
M
J
x
o
g
B
h
h
h
h
z
"}
(7,1,1) = {"
h
B
g
g
a
d
g
d
g
a
a
x
x
a
g
B
B
B
h
h
z
"}
(8,1,1) = {"
h
B
g
a
a
E
g
g
E
g
o
x
x
o
g
g
g
g
B
h
z
"}
(9,1,1) = {"
h
B
g
a
a
g
g
g
g
g
a
x
x
a
a
a
g
g
B
h
z
"}
(10,1,1) = {"
h
B
g
a
o
n
x
n
g
g
o
x
x
o
a
o
a
g
B
z
k
"}
(11,1,1) = {"
h
B
g
x
x
x
m
T
x
x
x
x
x
x
x
x
x
x
B
z
z
"}
(12,1,1) = {"
h
B
a
a
M
n
x
n
o
a
o
x
x
o
a
o
a
o
B
z
z
"}
(13,1,1) = {"
h
B
a
a
v
a
a
a
a
a
a
x
x
a
a
a
a
a
B
h
z
"}
(14,1,1) = {"
h
B
a
a
a
a
a
a
a
a
o
x
x
M
v
a
a
a
B
h
h
"}
(15,1,1) = {"
h
B
a
a
a
o
a
o
a
a
a
J
x
a
a
B
B
B
h
h
h
"}
(16,1,1) = {"
h
B
a
a
a
a
a
a
a
a
M
x
x
o
a
B
h
h
h
h
z
"}
(17,1,1) = {"
h
B
a
a
j
y
j
y
j
a
a
x
x
a
a
B
h
h
h
h
z
"}
(18,1,1) = {"
h
B
B
a
a
a
g
g
g
a
o
x
x
o
B
B
h
h
h
z
z
"}
(19,1,1) = {"
h
h
B
B
B
B
B
B
B
B
B
B
B
B
B
h
h
h
h
z
z
"}
(20,1,1) = {"
h
h
h
h
h
h
h
h
h
h
h
h
h
h
h
h
h
h
h
z
z
"}
(21,1,1) = {"
z
z
z
h
h
h
z
z
h
h
h
h
z
z
h
h
h
h
z
z
z
"}
