//MAP CONVERTED BY dmm2tgm.py THIS HEADER COMMENT PREVENTS RECONVERSION, DO NOT REMOVE
"a" = (
/turf/open/floor/wood,
/area/template_noop)
"f" = (
/obj/machinery/modular_computer/console{
	dir = 4
	},
/obj/structure/window/reinforced/tinted/frosted{
	dir = 8
	},
/obj/structure/window/reinforced/tinted/frosted,
/turf/open/floor/wood,
/area/template_noop)
"h" = (
/obj/structure/table/wood,
/obj/item/paper_bin{
	pixel_x = 1;
	pixel_y = 9
	},
/obj/item/pen,
/obj/item/folder/white,
/obj/structure/window/reinforced/tinted/frosted{
	dir = 1
	},
/turf/open/floor/wood{
	icon_state = "wood-broken4"
	},
/area/template_noop)
"m" = (
/obj/structure/window/reinforced/tinted/frosted{
	dir = 1
	},
/obj/structure/window/reinforced/tinted/frosted{
	dir = 4
	},
/obj/machinery/modular_computer/console,
/turf/open/floor/wood,
/area/template_noop)
"n" = (
/turf/open/floor/wood{
	icon_state = "wood-broken4"
	},
/area/template_noop)
"o" = (
/obj/structure/reagent_dispensers/water_cooler,
/obj/item/paper/crumpled/bloody/fluff{
	info = "NOTICE: Please limit your social interactions at the water cooler to 15 words or less, to insure maximum productivity. -Management"
	},
/turf/open/floor/carpet,
/area/template_noop)
"p" = (
/obj/structure/chair/office/dark{
	dir = 1
	},
/obj/structure/window/reinforced/tinted/frosted{
	dir = 4
	},
/turf/open/floor/wood{
	icon_state = "wood-broken4"
	},
/area/template_noop)
"r" = (
/obj/structure/window/reinforced/tinted/frosted{
	dir = 8
	},
/obj/structure/chair/office/dark,
/turf/open/floor/wood,
/area/template_noop)
"w" = (
/obj/structure/chair/office/dark{
	dir = 4
	},
/obj/structure/window/reinforced/tinted/frosted,
/turf/open/floor/wood,
/area/template_noop)
"z" = (
/obj/structure/filingcabinet/chestdrawer/wheeled,
/turf/open/floor/carpet,
/area/template_noop)
"A" = (
/obj/structure/table/wood,
/obj/item/flashlight/lamp{
	pixel_y = 2
	},
/obj/structure/window/reinforced/tinted/frosted{
	dir = 4
	},
/obj/structure/window/reinforced/tinted/frosted,
/turf/open/floor/wood,
/area/template_noop)
"B" = (
/obj/item/rack_parts,
/obj/item/storage/box/cups,
/turf/open/floor/carpet,
/area/template_noop)
"C" = (
/obj/structure/window/reinforced/tinted/frosted{
	dir = 4
	},
/obj/item/ammo_casing/a357,
/obj/effect/decal/cleanable/blood/old,
/obj/structure/chair/office/dark{
	dir = 1
	},
/turf/open/floor/wood,
/area/template_noop)
"F" = (
/obj/structure/table/wood,
/obj/item/paper_bin{
	pixel_x = 1;
	pixel_y = 9
	},
/obj/item/pen,
/obj/item/folder/white,
/obj/structure/window/reinforced/tinted/frosted{
	dir = 4
	},
/turf/open/floor/wood,
/area/template_noop)
"H" = (
/obj/machinery/modular_computer/console{
	dir = 8
	},
/obj/structure/window/reinforced/tinted/frosted{
	dir = 4
	},
/obj/structure/window/reinforced/tinted/frosted,
/turf/open/floor/wood,
/area/template_noop)
"I" = (
/obj/structure/table/wood,
/obj/item/flashlight/lamp{
	pixel_x = 3;
	pixel_y = -4
	},
/obj/structure/window/reinforced/tinted/frosted{
	dir = 1
	},
/obj/structure/window/reinforced/tinted/frosted{
	dir = 8
	},
/turf/open/floor/wood,
/area/template_noop)
"J" = (
/obj/structure/table/wood,
/obj/structure/window/reinforced/tinted/frosted{
	dir = 4
	},
/obj/structure/window/reinforced/tinted/frosted,
/obj/item/flashlight/lamp{
	pixel_y = 2
	},
/turf/open/floor/wood,
/area/template_noop)
"K" = (
/obj/machinery/photocopier,
/turf/open/floor/carpet,
/area/template_noop)
"L" = (
/obj/machinery/modular_computer/console{
	dir = 1
	},
/obj/structure/window/reinforced/tinted/frosted{
	dir = 8
	},
/obj/structure/window/reinforced/tinted/frosted,
/turf/open/floor/wood,
/area/template_noop)
"M" = (
/obj/structure/table/wood,
/obj/item/flashlight/lamp{
	pixel_x = -2;
	pixel_y = -3
	},
/obj/structure/window/reinforced/tinted/frosted{
	dir = 1
	},
/obj/structure/window/reinforced/tinted/frosted{
	dir = 4
	},
/turf/open/floor/wood,
/area/template_noop)
"N" = (
/obj/structure/chair/office/dark{
	dir = 8
	},
/obj/structure/window/reinforced/tinted/frosted,
/turf/open/floor/wood,
/area/template_noop)
"R" = (
/turf/open/floor/plating{
	icon_state = "platingdmg3"
	},
/area/template_noop)
"T" = (
/obj/structure/table/wood,
/obj/item/paper_bin{
	pixel_x = 1;
	pixel_y = 9
	},
/obj/item/pen,
/obj/item/folder/white,
/obj/structure/window/reinforced/tinted/frosted{
	dir = 8
	},
/turf/open/floor/wood,
/area/template_noop)
"U" = (
/obj/structure/table/wood,
/obj/item/flashlight/lamp{
	pixel_x = 2;
	pixel_y = -2
	},
/obj/structure/window/reinforced/tinted/frosted{
	dir = 8
	},
/obj/structure/window/reinforced/tinted/frosted{
	dir = 1
	},
/turf/open/floor/wood,
/area/template_noop)
"Z" = (
/obj/structure/chair/office/dark{
	dir = 1
	},
/obj/structure/window/reinforced/tinted/frosted{
	dir = 4
	},
/turf/open/floor/wood,
/area/template_noop)

(1,1,1) = {"
a
a
a
a
a
a
a
a
a
a
"}
(2,1,1) = {"
a
U
T
a
h
w
a
r
L
a
"}
(3,1,1) = {"
a
m
p
a
M
H
a
F
A
a
"}
(4,1,1) = {"
a
U
T
a
a
n
a
r
L
a
"}
(5,1,1) = {"
a
m
Z
a
K
o
a
F
J
a
"}
(6,1,1) = {"
a
U
T
a
z
B
a
r
L
a
"}
(7,1,1) = {"
a
m
Z
a
a
a
R
F
J
a
"}
(8,1,1) = {"
a
U
T
a
I
f
a
r
L
n
"}
(9,1,1) = {"
n
m
C
a
h
N
n
F
J
a
"}
(10,1,1) = {"
a
a
a
a
a
a
a
a
a
a
"}
