//MAP CONVERTED BY dmm2tgm.py THIS HEADER COMMENT PREVENTS RECONVERSION, DO NOT REMOVE
"b" = (
/obj/structure/lattice,
/turf/open/floor/plating/asteroid/snow/icemoon,
/area/icemoon/surface/outdoors)
"c" = (
/obj/structure/window/reinforced/spawner/east,
/obj/structure/table,
/obj/item/storage/toolbox/mechanical,
/turf/open/floor/plating,
/area/template_noop)
"h" = (
/obj/machinery/door/window/southright,
/obj/machinery/door/window/northright,
/obj/machinery/door/firedoor/border_only{
	dir = 1
	},
/obj/machinery/door/firedoor/border_only,
/turf/open/floor/plating,
/area/template_noop)
"j" = (
/obj/structure/closet/crate/science,
/obj/effect/spawner/lootdrop/techstorage/engineering,
/turf/open/floor/plating,
/area/template_noop)
"m" = (
/obj/structure/window/reinforced/spawner/north,
/turf/open/floor/plating,
/area/template_noop)
"n" = (
/obj/structure/window/reinforced/spawner/east,
/obj/structure/table,
/obj/effect/spawner/lootdrop/maintenance/five,
/turf/open/floor/plating,
/area/template_noop)
"r" = (
/turf/open/floor/plating/asteroid/snow/icemoon,
/area/icemoon/surface/outdoors)
"t" = (
/obj/structure/window/reinforced/spawner/west,
/obj/machinery/portable_atmospherics/canister/air,
/turf/open/floor/plating,
/area/template_noop)
"x" = (
/obj/structure/window/reinforced/spawner/west,
/obj/structure/table,
/obj/effect/spawner/lootdrop/maintenance/eight,
/turf/open/floor/plating,
/area/template_noop)
"y" = (
/obj/machinery/portable_atmospherics/canister/oxygen,
/turf/open/floor/plating,
/area/template_noop)
"z" = (
/obj/machinery/door/firedoor/border_only{
	dir = 1
	},
/obj/machinery/door/firedoor/border_only,
/obj/machinery/door/window/southleft,
/obj/machinery/door/window/northleft,
/turf/open/floor/plating,
/area/template_noop)
"A" = (
/obj/structure/window/reinforced/spawner/west,
/obj/machinery/portable_atmospherics/canister/nitrogen,
/turf/open/floor/plating,
/area/template_noop)
"B" = (
/obj/structure/window/reinforced/spawner/east,
/obj/structure/table,
/obj/item/pipe_dispenser,
/turf/open/floor/plating,
/area/template_noop)
"C" = (
/obj/machinery/light,
/turf/open/floor/plating,
/area/template_noop)
"D" = (
/obj/structure/window/reinforced/spawner/west,
/obj/structure/table,
/obj/item/electronics/airlock,
/obj/item/electronics/airlock,
/obj/item/electronics/airlock,
/obj/item/airlock_painter,
/turf/open/floor/plating,
/area/template_noop)
"F" = (
/obj/structure/window/reinforced/spawner/east,
/obj/structure/table,
/obj/effect/spawner/lootdrop/maintenance/seven,
/turf/open/floor/plating,
/area/template_noop)
"G" = (
/obj/structure/window/reinforced/spawner/west,
/obj/structure/table,
/obj/effect/spawner/lootdrop/maintenance/two,
/obj/item/holosign_creator/atmos,
/turf/open/floor/plating,
/area/template_noop)
"H" = (
/obj/structure/window/reinforced/spawner/east,
/obj/machinery/portable_atmospherics/scrubber,
/turf/open/floor/plating,
/area/template_noop)
"I" = (
/obj/machinery/light{
	dir = 1
	},
/turf/open/floor/plating,
/area/template_noop)
"J" = (
/obj/structure/window/reinforced/spawner,
/obj/structure/rack,
/obj/item/stack/sheet/glass/fifty,
/turf/open/floor/plating,
/area/template_noop)
"K" = (
/obj/structure/window/reinforced/spawner,
/obj/structure/window/reinforced/spawner/west,
/obj/structure/rack,
/obj/item/stack/cable_coil/random,
/obj/item/stack/cable_coil/random,
/obj/item/storage/toolbox/electrical,
/turf/open/floor/plating,
/area/template_noop)
"M" = (
/obj/structure/window/reinforced/spawner/east,
/obj/structure/closet/secure_closet/engineering_welding,
/turf/open/floor/plating,
/area/template_noop)
"N" = (
/obj/machinery/light{
	dir = 4
	},
/turf/open/floor/plating,
/area/template_noop)
"O" = (
/obj/machinery/light{
	dir = 8
	},
/turf/open/floor/plating,
/area/template_noop)
"S" = (
/obj/structure/window/reinforced/spawner,
/obj/structure/rack,
/obj/item/stack/rods/fifty,
/turf/open/floor/plating,
/area/template_noop)
"X" = (
/obj/structure/window/reinforced/spawner,
/obj/structure/rack,
/obj/item/stack/sheet/metal/fifty,
/obj/structure/window/reinforced/spawner/west{
	dir = 4
	},
/turf/open/floor/plating,
/area/template_noop)
"Y" = (
/obj/structure/window/reinforced/spawner/west,
/obj/structure/table,
/obj/effect/spawner/lootdrop/maintenance,
/turf/open/floor/plating,
/area/template_noop)
"Z" = (
/turf/open/floor/plating,
/area/template_noop)

(1,1,1) = {"
Z
Z
Z
O
Z
Z
O
Z
Z
Z
"}
(2,1,1) = {"
Z
j
M
n
B
c
F
H
Z
Z
"}
(3,1,1) = {"
Z
J
r
b
r
r
b
r
m
Z
"}
(4,1,1) = {"
I
X
b
b
b
b
b
b
m
C
"}
(5,1,1) = {"
Z
z
r
b
r
r
b
r
m
Z
"}
(6,1,1) = {"
Z
h
r
b
r
r
b
r
m
Z
"}
(7,1,1) = {"
I
K
b
b
b
b
b
b
m
C
"}
(8,1,1) = {"
Z
S
r
b
r
r
b
r
m
Z
"}
(9,1,1) = {"
Z
y
t
x
G
D
Y
A
Z
Z
"}
(10,1,1) = {"
Z
Z
Z
N
Z
Z
N
Z
Z
Z
"}
