//MAP CONVERTED BY dmm2tgm.py THIS HEADER COMMENT PREVENTS RECONVERSION, DO NOT REMOVE
"D" = (
/turf/open/space/basic,
/area/space)

(1,1,1) = {"
D
D
D
D
D
D
D
D
D
D
D
D
D
D
"}
(2,1,1) = {"
D
D
D
D
D
D
D
D
D
D
D
D
D
D
"}
(3,1,1) = {"
D
D
D
D
D
D
D
D
D
D
D
D
D
D
"}
(4,1,1) = {"
D
D
D
D
D
D
D
D
D
D
D
D
D
D
"}
(5,1,1) = {"
D
D
D
D
D
D
D
D
D
D
D
D
D
D
"}
(6,1,1) = {"
D
D
D
D
D
D
D
D
D
D
D
D
D
D
"}
(7,1,1) = {"
D
D
D
D
D
D
D
D
D
D
D
D
D
D
"}
(8,1,1) = {"
D
D
D
D
D
D
D
D
D
D
D
D
D
D
"}
(9,1,1) = {"
D
D
D
D
D
D
D
D
D
D
D
D
D
D
"}
(10,1,1) = {"
D
D
D
D
D
D
D
D
D
D
D
D
D
D
"}
(11,1,1) = {"
D
D
D
D
D
D
D
D
D
D
D
D
D
D
"}
(12,1,1) = {"
D
D
D
D
D
D
D
D
D
D
D
D
D
D
"}
(13,1,1) = {"
D
D
D
D
D
D
D
D
D
D
D
D
D
D
"}
(14,1,1) = {"
D
D
D
D
D
D
D
D
D
D
D
D
D
D
"}
(15,1,1) = {"
D
D
D
D
D
D
D
D
D
D
D
D
D
D
"}
(16,1,1) = {"
D
D
D
D
D
D
D
D
D
D
D
D
D
D
"}
