"aa" = (/turf/template_noop,/area/template_noop)
"ab" = (/turf/closed/wall/r_wall,/area/hallway/secondary/entry)
"ac" = (/turf/wall_marker/wall,/area/hallway/secondary/entry)
"ad" = (/turf/wall_marker/rwindow_wall_floor,/area/hallway/secondary/entry)
"ae" = (/turf/closed/wall,/area/hallway/secondary/entry)
"af" = (/obj/structure/closet/emcloset,/turf/open/floor/plating,/area/hallway/secondary/entry)
"ag" = (/obj/structure/sign/warning/pods,/turf/wall_marker/wall,/area/hallway/secondary/entry)
"ah" = (/obj/machinery/light{dir = 1},/obj/effect/turf_decal/tile/blue{dir = 4},/turf/open/floor/plasteel/white/corner{dir = 1},/area/hallway/secondary/entry)
"ai" = (/obj/effect/turf_decal/tile/blue{dir = 4},/turf/open/floor/plasteel/white/corner{dir = 1},/area/hallway/secondary/entry)
"aj" = (/obj/effect/turf_decal/tile/blue{dir = 4},/obj/machinery/atmospherics/components/unary/vent_pump/on/layer1{icon_state = "vent_map_on-1"; dir = 4},/turf/open/floor/plasteel/white/corner{dir = 1},/area/hallway/secondary/entry)
"ak" = (/obj/effect/turf_decal/tile/blue{dir = 4},/turf/open/floor/plasteel/cafeteria,/area/hallway/secondary/entry)
"al" = (/obj/docking_port/stationary/random{dir = 8; id = "pod_lavaland2"; name = "lavaland"},/turf/open/space,/area/space/nearstation)
"am" = (/obj/docking_port/stationary{dir = 8; dwidth = 1; height = 4; name = "escape pod loader"; roundstart_template = /datum/map_template/shuttle/escape_pod/default; width = 3},/turf/template_noop,/area/template_noop)
"an" = (/obj/machinery/door/airlock/external{name = "Escape Pod One"},/obj/effect/mapping_helpers/airlock/cyclelink_helper{dir = 4},/turf/open/floor/plating,/area/hallway/secondary/entry)
"ao" = (/turf/open/floor/plating,/area/hallway/secondary/entry)
"ap" = (/obj/machinery/door/airlock/external{name = "Escape Pod One"},/obj/effect/mapping_helpers/airlock/cyclelink_helper{dir = 8},/turf/open/floor/plating,/area/hallway/secondary/entry)
"aq" = (/obj/effect/turf_decal/stripes/line,/turf/open/floor/plasteel,/area/hallway/secondary/entry)
"ar" = (/turf/open/floor/plasteel,/area/hallway/secondary/entry)
"as" = (/obj/effect/turf_decal/stripes/corner{dir = 8},/turf/open/floor/plasteel,/area/hallway/secondary/entry)
"at" = (/obj/effect/procedural_marker/scrubber,/turf/open/floor/plasteel,/area/hallway/secondary/entry)
"au" = (/obj/effect/turf_decal/stripes/corner,/turf/open/floor/plasteel,/area/hallway/secondary/entry)
"av" = (/obj/structure/extinguisher_cabinet{pixel_x = 27},/obj/effect/turf_decal/tile/blue{dir = 4},/turf/open/floor/plasteel/white/corner,/area/hallway/secondary/entry)
"aw" = (/obj/machinery/camera{c_tag = "Arrivals Escape Pod 2"; dir = 8},/obj/machinery/light/small,/turf/open/floor/plating,/area/hallway/secondary/entry)
"ax" = (/turf/wall_marker/rwindow_rwall,/area/hallway/secondary/entry)
"ay" = (/obj/effect/mapping_helpers/airlock/cyclelink_helper,/obj/machinery/door/airlock/external{name = "Port Docking Bay 1"},/turf/open/floor/plating,/area/hallway/secondary/entry)
"az" = (/obj/effect/turf_decal/stripes/line{dir = 8},/turf/open/floor/plasteel,/area/hallway/secondary/entry)
"aA" = (/obj/effect/turf_decal/stripes/line{dir = 4},/turf/open/floor/plasteel,/area/hallway/secondary/entry)
"aB" = (/obj/effect/turf_decal/stripes/line{dir = 10},/turf/open/floor/plasteel,/area/hallway/secondary/entry)
"aC" = (/obj/item/radio/intercom{name = "Station Intercom (General)"; pixel_y = -29},/obj/effect/turf_decal/stripes/line,/turf/open/floor/plasteel,/area/hallway/secondary/entry)
"aD" = (/obj/effect/turf_decal/tile/blue{dir = 4},/turf/open/floor/plasteel/white/corner,/area/hallway/secondary/entry)
"aE" = (/obj/structure/sign/warning/docking,/turf/closed/wall/r_wall,/area/hallway/secondary/entry)
"aF" = (/obj/structure/sign/warning/vacuum/external{pixel_y = 32},/turf/wall_marker/rwindow_rwall,/area/hallway/secondary/entry)
"aG" = (/obj/structure/closet/emcloset,/obj/effect/turf_decal/stripes/line{dir = 10},/turf/open/floor/plasteel,/area/hallway/secondary/entry)
"aH" = (/obj/structure/closet/emcloset,/obj/effect/turf_decal/stripes/line,/turf/open/floor/plasteel,/area/hallway/secondary/entry)
"aI" = (/obj/machinery/camera{c_tag = "Arrivals Bay 1 North"; dir = 1},/obj/effect/turf_decal/stripes/line,/obj/item/twohanded/required/kirbyplants/random,/turf/open/floor/plasteel,/area/hallway/secondary/entry)
"aJ" = (/obj/machinery/vending/coffee,/obj/effect/turf_decal/stripes/line{dir = 6},/turf/open/floor/plasteel,/area/hallway/secondary/entry)
"aK" = (/obj/machinery/door/firedoor,/obj/effect/turf_decal/stripes/line{dir = 8},/turf/open/floor/plasteel,/area/hallway/secondary/entry)
"aL" = (/obj/machinery/door/firedoor,/obj/effect/turf_decal/tile/blue{dir = 4},/turf/open/floor/plasteel/white/corner,/area/hallway/secondary/entry)
"aM" = (/obj/effect/mapping_helpers/airlock/cyclelink_helper{dir = 1},/obj/machinery/door/airlock/external{name = "Port Docking Bay 1"},/turf/open/floor/plating,/area/hallway/secondary/entry)
"aN" = (/obj/machinery/light{dir = 8},/obj/effect/turf_decal/stripes/line{dir = 8},/turf/open/floor/plasteel,/area/hallway/secondary/entry)
"aO" = (/turf/wall_marker/wall,/area/security/checkpoint/auxiliary)
"aP" = (/turf/wall_marker/rwindow_wall_floor,/area/security/checkpoint/auxiliary)
"aQ" = (/obj/machinery/door/firedoor,/obj/effect/procedural_marker/anchor{dir = 8},/turf/open/floor/plasteel,/area/hallway/secondary/entry)
"aR" = (/obj/machinery/camera{c_tag = "Arrivals North"; dir = 8},/obj/effect/turf_decal/tile/blue{dir = 4},/turf/open/floor/plasteel/white/corner,/area/hallway/secondary/entry)
"aS" = (/obj/structure/closet/secure_closet/security,/obj/effect/turf_decal/tile/red{dir = 1},/obj/effect/turf_decal/tile/red{dir = 4},/obj/effect/turf_decal/tile/red{dir = 8},/turf/open/floor/plasteel,/area/security/checkpoint/auxiliary)
"aT" = (/obj/effect/turf_decal/tile/red{dir = 1},/obj/effect/turf_decal/tile/red{dir = 4},/obj/machinery/vending/wardrobe/sec_wardrobe,/turf/open/floor/plasteel,/area/security/checkpoint/auxiliary)
"aU" = (/obj/machinery/computer/security,/obj/structure/reagent_dispensers/peppertank{pixel_y = 30},/obj/effect/turf_decal/tile/red{dir = 1},/obj/effect/turf_decal/tile/red{dir = 4},/turf/open/floor/plasteel,/area/security/checkpoint/auxiliary)
"aV" = (/obj/machinery/computer/card,/obj/machinery/light{dir = 1},/obj/item/radio/intercom{broadcasting = 0; name = "Station Intercom (General)"; pixel_y = 20},/obj/effect/turf_decal/tile/red{dir = 1},/obj/effect/turf_decal/tile/red{dir = 4},/turf/open/floor/plasteel,/area/security/checkpoint/auxiliary)
"aW" = (/obj/machinery/computer/secure_data,/obj/machinery/requests_console{department = "Security"; departmentType = 5; pixel_y = 30},/obj/effect/turf_decal/tile/red{dir = 1},/obj/effect/turf_decal/tile/red{dir = 4},/turf/open/floor/plasteel,/area/security/checkpoint/auxiliary)
"aX" = (/obj/effect/turf_decal/tile/red{dir = 1},/obj/effect/turf_decal/tile/red,/obj/effect/turf_decal/tile/red{dir = 4},/turf/open/floor/plasteel,/area/security/checkpoint/auxiliary)
"aY" = (/obj/machinery/power/apc{dir = 4; name = "Entry Hall APC"; areastring = "/area/hallway/secondary/entry"; pixel_x = 24},/obj/effect/turf_decal/tile/blue{dir = 4},/turf/open/floor/plasteel/white/corner,/area/hallway/secondary/entry)
"aZ" = (/obj/effect/turf_decal/tile/red{dir = 1},/obj/effect/turf_decal/tile/red{dir = 8},/turf/open/floor/plasteel,/area/security/checkpoint/auxiliary)
"ba" = (/turf/open/floor/plasteel,/area/security/checkpoint/auxiliary)
"bb" = (/obj/machinery/atmospherics/components/unary/vent_pump/on/layer1{icon_state = "vent_map_on-1"; dir = 4},/turf/open/floor/plasteel,/area/security/checkpoint/auxiliary)
"bc" = (/obj/effect/procedural_marker/scrubber,/turf/open/floor/plasteel,/area/security/checkpoint/auxiliary)
"bd" = (/obj/effect/turf_decal/tile/red,/obj/effect/turf_decal/tile/red{dir = 4},/turf/open/floor/plasteel,/area/security/checkpoint/auxiliary)
"be" = (/obj/machinery/camera{c_tag = "Security Checkpoint"; dir = 1; network = list("ss13","chpt")},/obj/machinery/airalarm{dir = 4; pixel_x = -22},/obj/machinery/light_switch{pixel_x = 6; pixel_y = -25},/obj/effect/turf_decal/tile/red{dir = 1},/obj/effect/turf_decal/tile/red,/obj/effect/turf_decal/tile/red{dir = 8},/turf/open/floor/plasteel,/area/security/checkpoint/auxiliary)
"bf" = (/obj/effect/turf_decal/tile/red,/obj/effect/turf_decal/tile/red{dir = 8},/turf/open/floor/plasteel,/area/security/checkpoint/auxiliary)
"bg" = (/obj/item/paper_bin{pixel_x = 1; pixel_y = 9},/obj/item/pen,/obj/structure/table,/obj/effect/turf_decal/tile/red,/obj/effect/turf_decal/tile/red{dir = 8},/turf/open/floor/plasteel,/area/security/checkpoint/auxiliary)
"bh" = (/obj/structure/chair/office/dark,/obj/effect/landmark/event_spawn,/obj/effect/turf_decal/tile/red,/obj/effect/turf_decal/tile/red{dir = 8},/mob/living/simple_animal/crab/kreb{desc = "Here to lay down the hard claws of the law!"; health = 50; name = "Officer Kreb"; real_name = "Officer Kreb"},/turf/open/floor/plasteel,/area/security/checkpoint/auxiliary)
"bi" = (/obj/machinery/recharger{pixel_y = 4},/obj/structure/table,/obj/effect/turf_decal/tile/red,/obj/effect/turf_decal/tile/red{dir = 8},/turf/open/floor/plasteel,/area/security/checkpoint/auxiliary)
"bj" = (/obj/item/radio/off,/obj/item/crowbar,/obj/item/assembly/flash/handheld,/obj/structure/table,/obj/effect/turf_decal/tile/red,/obj/effect/turf_decal/tile/red{dir = 4},/obj/effect/turf_decal/tile/red{dir = 8},/turf/open/floor/plasteel,/area/security/checkpoint/auxiliary)
"bk" = (/obj/docking_port/stationary{dir = 8; dwidth = 3; height = 15; id = "arrivals_stationary"; name = "arrivals"; roundstart_template = /datum/map_template/shuttle/arrival/box; width = 7},/turf/template_noop,/area/template_noop)
"bl" = (/obj/machinery/status_display/evac{pixel_x = 32},/turf/open/floor/plasteel/white/corner{dir = 4},/area/hallway/secondary/entry)
"bm" = (/obj/machinery/door/airlock/security{name = "Security Checkpoint"; req_access_txt = "1"},/turf/open/floor/plasteel,/area/security/checkpoint/auxiliary)
"bn" = (/turf/wall_marker/rwindow_wall,/area/security/checkpoint/auxiliary)
"bo" = (/obj/machinery/door/firedoor,/obj/structure/table/reinforced,/obj/item/paper,/obj/machinery/door/window/westright{dir = 1; name = "Security Checkpoint"; req_access_txt = "1"},/obj/effect/turf_decal/delivery,/turf/open/floor/plasteel,/area/hallway/secondary/entry)
"bp" = (/turf/closed/wall,/area/security/checkpoint/auxiliary)
"bq" = (/obj/machinery/door/firedoor,/turf/open/floor/plasteel,/area/hallway/secondary/entry)
"br" = (/obj/effect/turf_decal/bot,/turf/open/floor/plasteel,/area/hallway/secondary/entry)
"bs" = (/obj/machinery/camera{c_tag = "Arrivals Lounge"; dir = 2},/obj/machinery/light{dir = 1},/obj/structure/sign/departments/minsky/security/security{pixel_y = 32},/turf/open/floor/plasteel,/area/hallway/secondary/entry)
"bt" = (/obj/structure/extinguisher_cabinet{pixel_x = -5; pixel_y = 30},/turf/open/floor/plasteel,/area/hallway/secondary/entry)
"bu" = (/obj/machinery/door/firedoor,/obj/effect/turf_decal/tile/neutral{dir = 2},/turf/open/floor/plasteel,/area/hallway/secondary/entry)
"bv" = (/obj/effect/turf_decal/tile/neutral,/obj/effect/turf_decal/tile/neutral{dir = 8},/turf/open/floor/plasteel,/area/hallway/secondary/entry)
"bw" = (/obj/effect/turf_decal/tile/neutral{dir = 8},/turf/open/floor/plasteel,/area/hallway/secondary/entry)
"bx" = (/obj/effect/turf_decal/stripes/line{dir = 8},/obj/machinery/firealarm{dir = 4; pixel_x = -26},/turf/open/floor/plasteel,/area/hallway/secondary/entry)
"by" = (/obj/effect/spawner/structure/window,/turf/open/floor/plating,/area/hallway/secondary/entry)
"bz" = (/obj/structure/chair/comfy/beige,/obj/effect/landmark/start/assistant,/turf/open/floor/plasteel/grimy,/area/hallway/secondary/entry)
"bA" = (/obj/structure/chair/comfy/beige,/obj/machinery/atmospherics/components/unary/vent_pump/on/layer1,/turf/open/floor/plasteel/grimy,/area/hallway/secondary/entry)
"bB" = (/turf/open/floor/plasteel/grimy,/area/hallway/secondary/entry)
"bC" = (/obj/structure/chair/comfy/beige,/turf/open/floor/plasteel/grimy,/area/hallway/secondary/entry)
"bD" = (/obj/structure/table/wood,/obj/item/flashlight/lamp/green{pixel_x = 1; pixel_y = 5},/turf/open/floor/plasteel/grimy,/area/hallway/secondary/entry)
"bE" = (/obj/machinery/vending/cigarette,/turf/open/floor/plasteel/dark,/area/hallway/secondary/entry)
"bF" = (/obj/effect/turf_decal/tile/neutral{dir = 1},/obj/effect/turf_decal/tile/neutral{dir = 8},/turf/open/floor/plasteel,/area/hallway/secondary/entry)
"bG" = (/obj/machinery/door/firedoor,/obj/machinery/newscaster{pixel_y = 32},/obj/machinery/light{dir = 1},/turf/open/floor/plasteel,/area/hallway/secondary/entry)
"bH" = (/obj/effect/procedural_marker/turf_check,/turf/open/floor/plasteel,/area/hallway/primary)
"bI" = (/obj/machinery/holopad,/turf/open/floor/plasteel,/area/hallway/secondary/entry)
"bJ" = (/obj/structure/table/wood,/turf/open/floor/plasteel/grimy,/area/hallway/secondary/entry)
"bK" = (/obj/structure/table/wood,/obj/item/reagent_containers/food/snacks/chips,/obj/item/reagent_containers/food/drinks/soda_cans/cola,/turf/open/floor/carpet,/area/hallway/secondary/entry)
"bL" = (/turf/open/floor/carpet,/area/hallway/secondary/entry)
"bM" = (/obj/structure/chair/comfy/beige{dir = 8},/turf/open/floor/plasteel/grimy,/area/hallway/secondary/entry)
"bN" = (/obj/machinery/vending/coffee,/turf/open/floor/plasteel/dark,/area/hallway/secondary/entry)
"bO" = (/turf/open/floor/goonplaque,/area/hallway/secondary/entry)
"bP" = (/turf/wall_marker/rwall,/area/hallway/secondary/entry)
"bQ" = (/obj/structure/sign/warning/docking,/turf/wall_marker/rwall,/area/hallway/secondary/entry)
"bR" = (/obj/machinery/vending/snack/random,/obj/effect/turf_decal/stripes/line{dir = 9},/turf/open/floor/plasteel,/area/hallway/secondary/entry)
"bS" = (/obj/machinery/camera{c_tag = "Arrivals Bay 1 South"},/obj/effect/turf_decal/stripes/line{dir = 1},/obj/item/twohanded/required/kirbyplants/random,/turf/open/floor/plasteel,/area/hallway/secondary/entry)
"bT" = (/obj/structure/closet/emcloset,/obj/effect/turf_decal/stripes/line{dir = 1},/turf/open/floor/plasteel,/area/hallway/secondary/entry)
"bU" = (/obj/structure/closet/emcloset,/obj/effect/turf_decal/stripes/line{dir = 5},/turf/open/floor/plasteel,/area/hallway/secondary/entry)
"bV" = (/obj/structure/table/wood,/obj/item/storage/fancy/cigarettes{pixel_y = 2},/obj/item/lighter/greyscale{pixel_x = 4; pixel_y = 2},/turf/open/floor/plasteel/grimy,/area/hallway/secondary/entry)
"bW" = (/obj/structure/table/wood,/turf/open/floor/carpet,/area/hallway/secondary/entry)
"bX" = (/obj/machinery/vending/cola/random,/turf/open/floor/plasteel/dark,/area/hallway/secondary/entry)
"bY" = (/obj/effect/turf_decal/stripes/line{dir = 4},/obj/item/beacon,/turf/open/floor/plasteel,/area/hallway/secondary/entry)
"bZ" = (/obj/effect/turf_decal/stripes/line{dir = 9},/turf/open/floor/plasteel,/area/hallway/secondary/entry)
"ca" = (/obj/item/radio/intercom{broadcasting = 0; name = "Station Intercom (General)"; pixel_y = 20},/obj/effect/turf_decal/stripes/line{dir = 1},/turf/open/floor/plasteel,/area/hallway/secondary/entry)
"cb" = (/obj/effect/turf_decal/stripes/corner{dir = 1},/turf/open/floor/plasteel,/area/hallway/secondary/entry)
"cc" = (/obj/structure/chair/comfy/beige{dir = 1; icon_state = "comfychair"},/turf/open/floor/plasteel/grimy,/area/hallway/secondary/entry)
"cd" = (/obj/structure/chair/comfy/beige{dir = 1; icon_state = "comfychair"},/obj/effect/landmark/start/assistant,/obj/effect/procedural_marker/scrubber,/turf/open/floor/plasteel/grimy,/area/hallway/secondary/entry)
"ce" = (/obj/machinery/vending/snack/random,/turf/open/floor/plasteel/dark,/area/hallway/secondary/entry)
"cf" = (/obj/docking_port/stationary/random{dir = 8; id = "pod_lavaland1"; name = "lavaland"},/turf/open/space,/area/space/nearstation)
"cg" = (/obj/structure/sign/warning/vacuum/external{pixel_y = 32},/obj/effect/turf_decal/stripes/line{dir = 1},/turf/open/floor/plasteel,/area/hallway/secondary/entry)
"ch" = (/obj/effect/turf_decal/stripes/line{dir = 1},/turf/open/floor/plasteel,/area/hallway/secondary/entry)
"ci" = (/obj/effect/turf_decal/stripes/corner{dir = 4},/turf/open/floor/plasteel,/area/hallway/secondary/entry)
"cj" = (/obj/machinery/door/firedoor,/obj/effect/turf_decal/tile/neutral{dir = 4},/turf/open/floor/plasteel,/area/hallway/secondary/entry)
"ck" = (/obj/effect/turf_decal/tile/neutral{dir = 1},/obj/effect/turf_decal/tile/neutral{dir = 4},/turf/open/floor/plasteel,/area/hallway/secondary/entry)
"cl" = (/obj/effect/turf_decal/tile/neutral{dir = 1},/turf/open/floor/plasteel,/area/hallway/secondary/entry)
"cm" = (/obj/machinery/camera{c_tag = "Arrivals Escape Pod 1"; dir = 8},/obj/machinery/light/small,/turf/open/floor/plating,/area/hallway/secondary/entry)
"cn" = (/obj/machinery/light,/obj/effect/turf_decal/tile/blue{dir = 8},/turf/open/floor/plasteel/white/corner,/area/hallway/secondary/entry)
"co" = (/obj/effect/turf_decal/tile/blue{dir = 8},/turf/open/floor/plasteel/white/corner,/area/hallway/secondary/entry)
"cp" = (/turf/open/floor/plasteel/white/corner{dir = 8},/area/hallway/secondary/entry)
"cq" = (/obj/machinery/airalarm{dir = 1; pixel_y = -22},/turf/open/floor/plasteel,/area/hallway/secondary/entry)
"cr" = (/obj/machinery/firealarm{dir = 1; pixel_y = -26},/turf/open/floor/plasteel,/area/hallway/secondary/entry)
"cs" = (/obj/machinery/light,/turf/open/floor/plasteel,/area/hallway/secondary/entry)
"ct" = (/obj/machinery/camera{c_tag = "Arrivals Hallway"; dir = 8},/turf/open/floor/plasteel,/area/hallway/secondary/entry)
"cu" = (/obj/machinery/door/firedoor,/obj/machinery/status_display/evac{pixel_x = 32},/turf/open/floor/plasteel,/area/hallway/secondary/entry)
"cv" = (/obj/machinery/camera{c_tag = "Arrivals Bay 2"; dir = 8},/turf/open/floor/plasteel,/area/hallway/secondary/entry)
"cw" = (/obj/structure/sign/warning/vacuum/external,/turf/wall_marker/rwindow_rwall,/area/hallway/secondary/entry)
"cx" = (/obj/effect/turf_decal/stripes/line{dir = 8},/obj/machinery/atmospherics/components/unary/vent_pump/on/layer1,/turf/open/floor/plasteel,/area/hallway/secondary/entry)
"cy" = (/obj/docking_port/stationary{dir = 8; dwidth = 2; height = 13; id = "ferry_home"; name = "port bay 2"; width = 5},/turf/template_noop,/area/template_noop)
"cz" = (/obj/effect/mapping_helpers/airlock/cyclelink_helper{dir = 4},/obj/machinery/door/airlock/external{name = "Port Docking Bay 2"},/turf/open/floor/plating,/area/hallway/secondary/entry)
"cA" = (/obj/effect/mapping_helpers/airlock/cyclelink_helper{dir = 8},/obj/machinery/door/airlock/external{name = "Port Docking Bay 2"},/turf/open/floor/plating,/area/hallway/secondary/entry)
"cB" = (/obj/effect/turf_decal/stripes/line{dir = 8},/obj/effect/procedural_marker/scrubber,/turf/open/floor/plasteel,/area/hallway/secondary/entry)
"cC" = (/obj/machinery/door/airlock/maintenance{req_access_txt = "12"},/turf/wall_marker/rwindow_wall_floor,/area/hallway/secondary/entry)
"cD" = (/obj/structure/closet/emcloset,/obj/effect/turf_decal/stripes/line{dir = 9},/turf/open/floor/plasteel,/area/hallway/secondary/entry)
"cE" = (/obj/structure/extinguisher_cabinet{pixel_x = 27},/obj/machinery/light{dir = 4},/turf/open/floor/plasteel,/area/hallway/secondary/entry)
"cF" = (/obj/structure/lattice,/turf/open/space,/area/space/nearstation)
"cG" = (/obj/effect/turf_decal/tile/blue{dir = 1},/turf/open/floor/plasteel,/area/hallway/secondary/entry)
"cH" = (/obj/effect/mapping_helpers/airlock/cyclelink_helper,/obj/machinery/door/airlock/external{name = "Port Docking Bay 4"},/turf/open/floor/plating,/area/hallway/secondary/entry)
"cI" = (/obj/effect/mapping_helpers/airlock/cyclelink_helper,/obj/machinery/door/airlock/external{name = "Port Docking Bay 3"},/turf/open/floor/plating,/area/hallway/secondary/entry)
"cJ" = (/obj/item/radio/intercom{name = "Station Intercom (General)"; pixel_y = -29},/obj/structure/chair{dir = 1},/obj/effect/turf_decal/stripes/line,/turf/open/floor/plasteel,/area/hallway/secondary/entry)
"cK" = (/obj/structure/chair{dir = 1},/obj/effect/turf_decal/stripes/line,/turf/open/floor/plasteel,/area/hallway/secondary/entry)
"cL" = (/obj/machinery/camera{c_tag = "Arrivals Bay 3 & 4"; dir = 1},/obj/effect/turf_decal/stripes/line,/obj/item/twohanded/required/kirbyplants/random,/turf/open/floor/plasteel,/area/hallway/secondary/entry)
"cM" = (/obj/machinery/vending/cigarette,/obj/effect/turf_decal/stripes/line{dir = 6},/turf/open/floor/plasteel,/area/hallway/secondary/entry)
"cN" = (/obj/effect/mapping_helpers/airlock/cyclelink_helper{dir = 1},/obj/machinery/door/airlock/external{name = "Port Docking Bay 4"},/turf/open/floor/plating,/area/hallway/secondary/entry)
"cO" = (/obj/effect/mapping_helpers/airlock/cyclelink_helper{dir = 1},/obj/machinery/door/airlock/external{name = "Port Docking Bay 3"},/turf/open/floor/plating,/area/hallway/secondary/entry)
"cP" = (/obj/docking_port/stationary{dir = 2; dwidth = 11; height = 22; id = "whiteship_home"; name = "SS13: Auxiliary Dock, Station-Port"; width = 35},/turf/template_noop,/area/template_noop)
"cQ" = (/obj/machinery/door/airlock/maintenance{name = "Security Maintenance"; req_access_txt = "1"},/turf/wall_marker/rwindow_wall_floor,/area/security/checkpoint/auxiliary)

(1,1,1) = {"
aaaaaaaaaaabacacaccCadadacadadcCacadadadadcCacaaaaaaaaaaaaaaaaaaaaaa
aaaaaaaaaaacafagahaiaiaiaiaiajaiahaiaiaiaiakcCaaaaaaaaaaaaaaaaaaaaaa
alaaaaaaamanaoapaqaraqasatarauaqaraqasararavacaaaaaaaaaaaaaaaaaaaaaa
aaaaaaaaaaacawacaxayaxazararaAaxayaxaBaCasaDadaaaaaaaaaaaaaaaaaaaaaa
aaaaaaaaaaabaEabaFaoaxaGaHaIaJaxaoaFaxabaKaLacaaaaaaaaaaaaaaaaaaaaaa
aaaaaaaaaaaaaaaaaxaMaxaxaxaxaxaxaMaxaaabaNaDaOaPaPaOaOaOcQaPaaaaaaaa
aaaaaaaaaaaaaaaaaaaaaaaaaaaaaaaaaaaaaaabazaRaOaSaTaUaVaWaXaPaaaaaaaa
aaaaaaaaaaaaaaaaaaaaaaaaaaaaaaaaaaaaaaaxazaYaOaZbabbbabcbdcQaaaaaaaa
aaaaaaaaaaaaaaaaaaaaaaaaaaaaaaaaaaaaaaaxazaDaObebfbgbhbibjaOaaaaaaaa
aaaaaaaaaaaaaaaaaaaaaaaaaaaaaaaaaaaabkaxazblaOaObmbnbobnbpaOacacacaa
aaaaaaaaaaaaaaaaaaaaaaaaaaaaaaaaaaaaaaaxazarbqbrbrbrbrarbsbtararacaa
aaaaaaaaaaaaaaaaaaaaaaaaaaaaaaaaaaaaaaaxazarbubvbvbvbvbvbvbvbwaracaa
aaaaaaaaaaaaaaaaaaaaaaaaaaaaaaaaaaaaaaabbxarbybzbAbBbCbDaebEbFarbGbH
aaaaaaaaaaaaaaaaaxayaxaxaxaxaxaxayaxaaabaNbIbybJbKbLbLbMaebNbFbOaQbH
aaaaaaaaaabPbQbPaxaoaxbRbSbTbUaxaoaxaxabazarbybVbWbLbLbMaebXbFarbqbH
aaaaaaaaaaacafacaxaMaxazararbYaxaMaxbZcacbarbycccdbBccbDaecebFaracaa
cfaaaaaaamanaoapcgarchcbararcicharcgcbarararcjckckckckckckckclaracaa
aaaaaaaaaaaccmagcncococococococococncocpararbqararcqarcrararcsctacaa
aaaaaaaaaabPbPbPbPaxaxaxaxaxaxaxaxbPbPacbqcuacadadaccCacadadaccCacaa
aaaaaaaaaaaaaaaaaaaaaaaaaaaaaaaaaaaaaxaGascvacaaaaaaaaaaaaaaaaaaaaaa
aaaaaaaaaaaaaaaaaaaaaaaaaaaaaaaaaacwaxaxcxarcCaaaaaaaaaaaaaaaaaaaaaa
aaaaaaaaaaaaaaaaaaaaaaaaaaaaaaaacyczaocAararadaaaaaaaaaaaaaaaaaaaaaa
aaaaaaaaaaaaaaaaaaaaaaaaaaaaaaaaaaaxaxaxcBaradaaaaaaaaaaaaaaaaaaaaaa
aaaaaaaaaaaaaaaaaaaaaaaaaaaaaaaaaaaaaxcDcbcEacaaaaaaaaaaaaaaaaaaaaaa
aaaaaacFcFcFcFbPbPaxaxaxaxaxaxaxaxbPbPacararadaaaaaaaaaaaaaaaaaaaaaa
aaaaaaaaaaaaaaaxahaiaiaiaiaiaiaiaiahaicGararadaaaaaaaaaaaaaaaaaaaaaa
aaaaaaaaaaaacFaxaqaraqasararauaqaraqasarararcCaaaaaaaaaaaaaaaaaaaaaa
aaaaaaaaaaaaaaacaxcHaxazararaAaxcIaxaBcJcKcKaeaaaaaaaaaaaaaaaaaaaaaa
aaaaaaaaaacFbQbPaFaoaxaGaHcLcMaxaoaFaxbPbQacacaaaaaaaaaaaaaaaaaaaaaa
aaaaaaaacFcFcFcFaxcNaxaxaxaxaxaxcOaxcFcFcFaaaaaaaaaaaaaaaaaaaaaaaaaa
aaaaaaaaaaaaaaaaaacPaaaaaaaaaaaaaaaaaaaaaaaaaaaaaaaaaaaaaaaaaaaaaaaa
"}
