//MAP CONVERTED BY dmm2tgm.py THIS HEADER COMMENT PREVENTS RECONVERSION, DO NOT REMOVE
"f" = (
/turf/template_noop,
/area/template_noop)
"r" = (
/turf/closed/mineral/volcanic/lava_land_surface/hard,
/area/template_noop)
"x" = (
/turf/open/chasm/lavaland,
/area/template_noop)
"D" = (
/turf/closed/mineral/volcanic/lava_land_surface/hard/harder,
/area/template_noop)
"J" = (
/obj/structure/closet/crate/necropolis,
/turf/open/floor/plating/asteroid/basalt/lava_land_surface,
/area/template_noop)
"T" = (
/turf/open/space/basic,
/area/template_noop)
"W" = (
/turf/open/floor/plating/asteroid/basalt/lava_land_surface,
/area/template_noop)

(1,1,1) = {"
f
f
f
f
r
r
r
r
f
f
f
r
r
r
r
f
f
f
f
r
r
r
r
r
D
D
r
r
f
"}
(2,1,1) = {"
f
D
D
D
D
D
D
r
D
D
D
D
D
D
r
r
D
D
D
D
D
D
D
D
D
D
D
D
f
"}
(3,1,1) = {"
f
D
x
x
x
x
x
x
x
x
x
x
x
x
x
x
x
x
x
x
x
x
x
x
x
D
D
D
f
"}
(4,1,1) = {"
r
r
x
W
W
W
W
W
W
W
W
W
W
x
W
W
W
W
W
W
W
W
x
x
x
x
x
D
f
"}
(5,1,1) = {"
r
r
x
W
x
x
x
x
x
x
x
x
x
x
W
x
x
x
x
x
x
W
x
x
x
x
x
D
r
"}
(6,1,1) = {"
r
D
x
W
x
x
W
W
W
W
W
W
W
x
W
x
W
W
W
W
W
W
W
W
x
x
x
D
r
"}
(7,1,1) = {"
r
D
x
W
x
x
W
x
x
x
x
x
W
x
W
x
W
x
x
x
x
W
x
x
x
x
x
D
r
"}
(8,1,1) = {"
r
D
x
W
W
x
W
x
W
x
W
W
W
x
W
x
W
x
x
W
W
W
x
x
x
x
x
D
r
"}
(9,1,1) = {"
f
D
x
x
W
x
W
x
W
x
W
x
x
x
x
x
W
x
x
W
x
x
x
x
x
x
x
D
r
"}
(10,1,1) = {"
f
D
x
x
W
x
W
x
W
x
W
W
W
W
W
W
W
x
x
W
x
x
x
x
x
x
x
r
r
"}
(11,1,1) = {"
f
D
x
x
W
x
W
x
W
x
x
x
x
x
x
x
x
x
x
W
x
x
x
x
x
x
x
r
f
"}
(12,1,1) = {"
r
D
x
x
W
x
W
x
W
W
W
x
x
W
W
W
W
W
W
W
x
x
x
x
x
x
x
r
W
"}
(13,1,1) = {"
r
D
x
x
W
x
W
x
x
W
x
x
x
W
x
x
x
x
x
x
x
x
x
x
x
x
x
W
W
"}
(14,1,1) = {"
r
r
x
W
W
W
W
x
x
W
x
x
W
W
W
x
x
x
x
x
x
x
x
x
x
W
W
W
W
"}
(15,1,1) = {"
r
r
x
W
x
x
W
x
x
W
x
x
W
J
W
x
x
x
x
x
x
W
W
W
W
W
W
W
W
"}
(16,1,1) = {"
r
r
x
W
x
x
W
x
x
W
x
x
W
W
W
x
x
x
x
x
x
W
x
x
x
W
W
W
W
"}
(17,1,1) = {"
r
r
x
W
x
x
W
x
x
W
x
x
x
x
x
x
x
x
x
x
x
W
x
x
x
x
x
W
W
"}
(18,1,1) = {"
r
D
x
W
x
x
W
x
x
W
x
W
x
x
W
W
W
W
x
x
x
W
x
x
x
x
x
W
W
"}
(19,1,1) = {"
f
D
x
W
x
x
W
W
W
W
x
W
x
x
W
x
x
W
x
W
W
W
W
W
x
x
x
r
W
"}
(20,1,1) = {"
f
D
x
W
x
x
W
x
x
x
x
W
W
W
W
x
x
W
x
W
x
x
x
W
x
x
x
r
T
"}
(21,1,1) = {"
f
D
x
W
x
x
W
x
x
x
x
x
x
x
x
x
x
W
x
W
x
x
x
W
x
x
x
D
T
"}
(22,1,1) = {"
f
D
x
W
x
x
W
W
W
W
W
W
W
W
x
x
x
W
x
W
x
W
W
W
x
x
x
D
r
"}
(23,1,1) = {"
r
D
x
W
x
x
x
x
x
x
x
x
x
W
W
W
W
W
W
W
x
W
x
x
x
x
x
D
r
"}
(24,1,1) = {"
r
r
x
W
x
x
x
x
x
x
x
x
x
x
x
x
x
x
x
x
x
W
x
x
x
x
x
D
r
"}
(25,1,1) = {"
r
D
x
W
W
W
W
W
W
W
W
W
x
x
x
x
W
x
W
W
W
W
W
W
W
x
x
D
r
"}
(26,1,1) = {"
r
D
x
x
x
x
x
x
x
x
x
W
W
W
W
W
W
x
W
x
x
x
x
x
x
x
x
r
r
"}
(27,1,1) = {"
f
D
r
r
x
x
x
x
x
x
x
x
x
x
x
x
x
x
x
x
x
x
x
x
x
x
r
r
r
"}
(28,1,1) = {"
f
D
r
D
D
r
r
r
D
D
D
D
D
D
D
D
r
r
r
r
D
D
D
D
D
r
r
r
f
"}
(29,1,1) = {"
f
f
f
r
r
r
r
r
f
f
f
f
f
r
r
r
r
r
f
f
f
f
r
r
r
r
r
f
f
"}
