// This map has been converted using maphash
"aGe" = (/obj/structure/lattice,/turf/open/floor/plating/asteroid/basalt/lava_land_surface,/area/lavaland/surface/outdoors/explored)
"aOW" = (/obj/item/shard,/turf/open/floor/mineral/plastitanium/red,/area/lavaland/surface/outdoors/explored)
"bgS" = (/obj/effect/decal/cleanable/blood,/obj/item/flashlight/seclite,/turf/open/floor/plating/asteroid/basalt/lava_land_surface,/area/lavaland/surface/outdoors)
"bKC" = (/obj/machinery/light/floor,/turf/open/floor/mineral/plastitanium/red,/area/ruin/powered)
"cbd" = (/obj/effect/mob_spawn/human/nanotrasensoldier,/obj/effect/decal/cleanable/blood,/obj/item/kitchen/knife/combat/survival,/turf/open/floor/plating/asteroid/basalt/lava_land_surface,/area/lavaland/surface/outdoors)
"cSt" = (/turf/closed/indestructible/opshuttle,/area/lavaland/surface/outdoors/explored)
"ebw" = (/turf/closed/mineral/volcanic/lava_land_surface,/area/lavaland/surface/outdoors/explored)
"eAz" = (/turf/closed/indestructible/opshuttle,/area/ruin/powered)
"eCT" = (/obj/structure/shuttle/engine/propulsion{dir = 4; icon_state = "propulsion"},/turf/open/floor/plating/asteroid/basalt/lava_land_surface,/area/ruin/powered)
"eJe" = (/obj/effect/decal/cleanable/blood,/turf/open/floor/plating/asteroid/basalt/lava_land_surface,/area/lavaland/surface/outdoors/explored)
"fHc" = (/obj/effect/mob_spawn/human/nanotrasensoldier,/obj/effect/decal/cleanable/blood,/obj/item/flashlight/seclite,/obj/effect/light_emitter,/turf/open/floor/mineral/plastitanium/red,/area/ruin/powered)
"gNs" = (/turf/closed/indestructible/opshuttle,/area/ruin/unpowered)
"gUl" = (/obj/structure/closet/crate/internals{desc = "An emergency supply crate with the NT logo attached to it, it has a small reading below which seems to signify that you probably shouldn't open this incase of an emergency. It also says only for security personell"},/obj/item/storage/toolbox/mechanical,/obj/item/tank/internals/emergency_oxygen,/obj/item/tank/internals/emergency_oxygen,/obj/item/flashlight,/obj/item/flashlight,/obj/item/flashlight,/obj/item/flashlight,/obj/item/flashlight,/obj/item/tank/internals/emergency_oxygen,/obj/item/stack/medical/bruise_pack,/obj/item/stack/medical/gauze,/obj/item/stack/medical/ointment,/obj/item/tank/internals/emergency_oxygen,/obj/item/tank/internals/emergency_oxygen,/obj/item/tank/internals/emergency_oxygen,/obj/item/tank/internals/emergency_oxygen,/obj/item/tank/internals/emergency_oxygen,/turf/open/floor/mineral/plastitanium/red,/area/ruin/powered)
"htK" = (/obj/effect/mob_spawn/human/nanotrasensoldier,/obj/item/gun/ballistic/automatic/pistol/m1911{desc = "A classic .45 handgun with a small magazine capacity, this one has a name engraved on it that reads 'Samantha'"; name = "Samantha"},/obj/effect/decal/cleanable/blood,/turf/open/floor/mineral/plastitanium/red,/area/ruin/unpowered)
"ikU" = (/turf/closed/mineral/volcanic/lava_land_surface,/area/lavaland/surface/outdoors)
"iJx" = (/obj/item/shard{icon_state = "medium"},/turf/open/floor/plating/asteroid/basalt/lava_land_surface,/area/lavaland/surface/outdoors)
"iYc" = (/obj/item/gun/ballistic/automatic/pistol/m1911,/turf/open/floor/plating/asteroid/basalt/lava_land_surface,/area/lavaland/surface/outdoors/explored)
"kxL" = (/turf/open/floor/mineral/plastitanium/red,/area/ruin/powered)
"lzg" = (/obj/effect/mob_spawn/human/prisoner_transport,/turf/open/floor/mineral/plastitanium/red,/area/ruin/powered)
"nBj" = (/obj/item/shard,/turf/open/floor/plating/asteroid/basalt/lava_land_surface,/area/lavaland/surface/outdoors)
"plt" = (/obj/item/gun/ballistic/automatic/pistol/m1911,/turf/open/floor/mineral/plastitanium/red,/area/ruin/powered)
"pXG" = (/obj/effect/decal/cleanable/blood,/turf/open/floor/plating/asteroid/basalt/lava_land_surface,/area/lavaland/surface/outdoors)
"qbw" = (/obj/machinery/door/airlock/shuttle,/turf/open/floor/mineral/plastitanium/red,/area/ruin/unpowered)
"tfw" = (/turf/open/floor/mineral/plastitanium/red,/area/lavaland/surface/outdoors/explored)
"tQi" = (/obj/item/pickaxe,/obj/item/pickaxe,/obj/item/pickaxe,/obj/item/pickaxe,/obj/item/flashlight/lantern,/obj/structure/closet/crate/engineering{name = "Mining Supplies"},/obj/item/flashlight/lantern,/obj/item/flashlight/lantern,/obj/item/flashlight/lantern,/obj/item/flashlight/lantern,/obj/item/flashlight/lantern,/obj/item/flashlight/lantern,/obj/item/flashlight/lantern,/obj/item/pickaxe,/obj/item/pickaxe,/obj/item/pickaxe,/obj/item/pickaxe,/turf/open/floor/mineral/plastitanium/red,/area/ruin/powered)
"uQf" = (/obj/item/shard,/turf/open/floor/plating/asteroid/basalt/lava_land_surface,/area/lavaland/surface/outdoors/explored)
"vqP" = (/obj/item/shard{icon_state = "small"},/turf/open/floor/plating/asteroid/basalt/lava_land_surface,/area/lavaland/surface/outdoors/explored)
"vyd" = (/obj/structure/closet/wardrobe/red{desc = "The Pilot won't be needing any of this...."; name = "Pilots Belongings"},/obj/item/ammo_box/c45,/obj/item/tank/internals/emergency_oxygen/double,/obj/item/toy/figure/secofficer,/obj/item/tank/internals/oxygen/red,/turf/open/floor/mineral/plastitanium/red,/area/ruin/unpowered)
"vRm" = (/turf/open/floor/plating/asteroid/basalt/lava_land_surface,/area/lavaland/surface/outdoors/explored)
"vWy" = (/obj/structure/shuttle/engine/propulsion{dir = 4; icon_state = "propulsion"},/turf/open/floor/plating/asteroid/basalt/lava_land_surface,/area/lavaland/surface/outdoors/explored)
"wyB" = (/obj/machinery/door/airlock/shuttle,/obj/structure/fans/tiny,/turf/open/floor/mineral/plastitanium/red,/area/ruin/powered)
"wyK" = (/turf/open/floor/mineral/plastitanium/red,/area/ruin/unpowered)
"wUl" = (/turf/open/floor/plating/asteroid/basalt/lava_land_surface,/area/lavaland/surface/outdoors)

(1,1,1) = {"
ikU
ikU
wUl
wUl
wUl
wUl
wUl
wUl
wUl
wUl
wUl
wUl
wUl
wUl
wUl
wUl
wUl
wUl
wUl
wUl
"}
(2,1,1) = {"
wUl
ikU
wUl
wUl
wUl
ikU
ikU
wUl
wUl
wUl
wUl
wUl
wUl
wUl
wUl
wUl
wUl
wUl
ikU
wUl
"}
(3,1,1) = {"
wUl
wUl
nBj
wUl
wUl
ikU
ikU
wUl
wUl
wUl
wUl
wUl
wUl
wUl
wUl
wUl
wUl
wUl
wUl
ikU
"}
(4,1,1) = {"
wUl
wUl
wUl
wUl
wUl
wUl
ikU
wUl
wUl
eCT
eAz
eCT
eAz
eCT
wUl
wUl
wUl
vqP
wUl
wUl
"}
(5,1,1) = {"
wUl
wUl
ikU
ikU
ikU
wUl
wUl
vRm
vRm
eAz
eAz
eAz
eAz
eAz
vRm
vRm
vRm
iYc
wUl
wUl
"}
(6,1,1) = {"
wUl
wUl
ikU
ikU
ikU
wUl
wUl
cSt
vWy
eAz
tQi
fHc
gUl
eAz
vWy
cSt
vRm
wUl
cbd
wUl
"}
(7,1,1) = {"
wUl
wUl
wUl
wUl
wUl
wUl
wUl
vRm
cSt
eAz
lzg
plt
lzg
eAz
cSt
vRm
vRm
pXG
bgS
wUl
"}
(8,1,1) = {"
ikU
wUl
wUl
wUl
wUl
wUl
wUl
ebw
ebw
eAz
lzg
bKC
lzg
eAz
vRm
vRm
eJe
pXG
wUl
wUl
"}
(9,1,1) = {"
wUl
wUl
wUl
iJx
wUl
wUl
wUl
ebw
ebw
eAz
lzg
kxL
lzg
eAz
vRm
vRm
eJe
pXG
wUl
wUl
"}
(10,1,1) = {"
wUl
wUl
wUl
wUl
wUl
wUl
wUl
ebw
ebw
eAz
lzg
kxL
lzg
eAz
vRm
vRm
vRm
wUl
ikU
ikU
"}
(11,1,1) = {"
ikU
wUl
wUl
wUl
wUl
wUl
wUl
ebw
ebw
eAz
eAz
wyB
eAz
eAz
vRm
vRm
vRm
wUl
ikU
ikU
"}
(12,1,1) = {"
ikU
wUl
wUl
wUl
wUl
wUl
wUl
vRm
vRm
cSt
tfw
tfw
tfw
aGe
vRm
vRm
vRm
wUl
ikU
ikU
"}
(13,1,1) = {"
wUl
wUl
wUl
ikU
wUl
wUl
wUl
ebw
vRm
tfw
tfw
aOW
tfw
aGe
vRm
vRm
vRm
uQf
ikU
ikU
"}
(14,1,1) = {"
wUl
ikU
ikU
wUl
wUl
ikU
ikU
ebw
ebw
tfw
tfw
tfw
tfw
tfw
vRm
vRm
vRm
wUl
ikU
ikU
"}
(15,1,1) = {"
wUl
wUl
wUl
ikU
ikU
ikU
ikU
ikU
ikU
gNs
gNs
qbw
cSt
cSt
vRm
vRm
vRm
wUl
ikU
ikU
"}
(16,1,1) = {"
wUl
wUl
wUl
ikU
ikU
ikU
ikU
ikU
ikU
gNs
wyK
htK
ebw
cSt
vRm
wUl
wUl
wUl
ikU
ikU
"}
(17,1,1) = {"
wUl
wUl
wUl
ikU
ikU
ikU
ikU
ikU
ikU
gNs
vyd
wyK
ebw
cSt
wUl
wUl
wUl
wUl
ikU
ikU
"}
(18,1,1) = {"
wUl
wUl
wUl
wUl
wUl
ikU
ikU
ikU
ikU
ikU
ikU
ikU
cSt
ikU
ikU
wUl
ikU
ikU
ikU
ikU
"}
(19,1,1) = {"
wUl
wUl
wUl
wUl
wUl
ikU
ikU
ikU
ikU
ikU
ikU
ikU
ikU
wUl
wUl
wUl
ikU
ikU
ikU
ikU
"}
(20,1,1) = {"
wUl
wUl
wUl
wUl
wUl
ikU
ikU
ikU
ikU
ikU
ikU
ikU
ikU
wUl
wUl
wUl
wUl
wUl
ikU
ikU
"}
