// This map has been converted using maphash
"atR" = (/obj/effect/mob_spawn/human/corpse/russian/ranged/trooper,/obj/effect/turf_decal/sand,/obj/item/gun/ballistic/rifle/boltaction,/turf/open/floor/plasteel,/area/ruin/unpowered)
"aGK" = (/obj/effect/mob_spawn/human/skeleton,/obj/item/kitchen/knife/combat/bone,/obj/structure/spider,/obj/structure/spider{icon_state = "stickyweb2"},/turf/open/floor/plating/asteroid/basalt/lava_land_surface,/area/ruin/unpowered)
"aXR" = (/obj/effect/turf_decal/sand,/turf/open/floor/plasteel,/area/ruin/unpowered)
"bRt" = (/obj/effect/mob_spawn/human/skeleton,/obj/item/twohanded/bonespear,/obj/structure/spider{icon_state = "stickyweb2"},/obj/structure/spider,/turf/open/floor/plating/asteroid/basalt/lava_land_surface,/area/ruin/unpowered)
"clA" = (/obj/item/storage/firstaid/regular,/obj/effect/turf_decal/sand,/turf/open/floor/plasteel,/area/ruin/unpowered)
"dln" = (/obj/effect/mob_spawn/human/skeleton,/obj/item/clothing/suit/armor/bone,/obj/item/twohanded/fireaxe/boneaxe,/obj/structure/spider{icon_state = "stickyweb2"},/obj/structure/spider,/turf/open/floor/plating/asteroid/basalt/lava_land_surface,/area/ruin/unpowered)
"dQK" = (/obj/effect/mob_spawn/human/clown,/obj/effect/turf_decal/sand,/turf/open/floor/plasteel,/area/ruin/unpowered)
"dYd" = (/obj/item/kitchen/knife/combat/bone,/turf/open/floor/plating/asteroid/basalt/lava_land_surface,/area/ruin/unpowered)
"eep" = (/obj/effect/mob_spawn/human/corpse/nanotrasensoldier,/obj/item/melee/classic_baton,/obj/item/gun/ballistic/shotgun/doublebarrel,/turf/open/floor/plating/asteroid/basalt/lava_land_surface,/area/ruin/unpowered)
"evP" = (/obj/structure/spider{icon_state = "stickyweb2"},/obj/structure/spider{icon_state = "stickyweb2"},/obj/effect/turf_decal/sand,/turf/open/floor/plasteel,/area/ruin/unpowered)
"eHO" = (/obj/item/tank/internals/emergency_oxygen/double,/turf/open/floor/plating/asteroid/basalt/lava_land_surface,/area/ruin/unpowered)
"eHT" = (/obj/effect/mob_spawn/human/corpse/nanotrasensoldier,/obj/effect/turf_decal/sand,/turf/open/floor/plasteel,/area/ruin/unpowered)
"eND" = (/obj/effect/mob_spawn/human/skeleton,/obj/structure/spider{icon_state = "stickyweb2"},/turf/open/floor/plating/asteroid/basalt/lava_land_surface,/area/ruin/unpowered)
"eNH" = (/obj/structure/spider{icon_state = "stickyweb2"},/obj/effect/turf_decal/sand,/turf/open/floor/plasteel,/area/ruin/unpowered)
"eTc" = (/obj/item/reagent_containers/spray/spraytan,/obj/effect/turf_decal/sand,/turf/open/floor/plasteel,/area/ruin/unpowered)
"fvq" = (/obj/effect/mob_spawn/human/corpse/russian/ranged/trooper,/obj/effect/turf_decal/sand,/turf/open/floor/plasteel,/area/ruin/unpowered)
"fZq" = (/obj/structure/spider,/obj/structure/spider{icon_state = "stickyweb2"},/turf/open/floor/plating/asteroid/basalt/lava_land_surface,/area/ruin/unpowered)
"gdk" = (/obj/effect/mob_spawn/human/corpse/russian/ranged,/obj/item/storage/firstaid,/obj/effect/turf_decal/sand,/turf/open/floor/plasteel,/area/ruin/unpowered)
"gps" = (/turf/open/floor/plating/asteroid/basalt/lava_land_surface,/area/ruin/unpowered)
"hmI" = (/turf/open/lava/smooth/lava_land_surface,/area/lavaland/surface/outdoors)
"hud" = (/obj/effect/mob_spawn/human/skeleton,/obj/structure/spider{icon_state = "stickyweb2"},/obj/structure/spider,/turf/open/floor/plating/asteroid/basalt/lava_land_surface,/area/ruin/unpowered)
"ikU" = (/turf/closed/mineral/volcanic/lava_land_surface,/area/lavaland/surface/outdoors)
"iCf" = (/obj/item/reagent_containers/food/snacks/spidereggs,/obj/item/reagent_containers/food/snacks/spiderleg,/turf/open/floor/plating/asteroid/basalt/lava_land_surface,/area/ruin/unpowered)
"iNB" = (/obj/effect/mob_spawn/human/skeleton,/obj/structure/spider{icon_state = "stickyweb2"},/obj/structure/spider,/obj/structure/spider{icon_state = "stickyweb2"},/obj/effect/turf_decal/sand,/turf/open/floor/plasteel,/area/ruin/unpowered)
"jcn" = (/obj/structure/table,/obj/item/twohanded/spear,/obj/effect/turf_decal/sand,/turf/open/floor/plasteel,/area/ruin/unpowered)
"lcH" = (/obj/structure/spider{icon_state = "stickyweb2"},/turf/open/floor/plating/asteroid/basalt/lava_land_surface,/area/ruin/unpowered)
"leP" = (/obj/structure/table,/obj/item/stack/sheet/animalhide/weaver_chitin,/obj/effect/turf_decal/sand,/turf/open/floor/plasteel,/area/ruin/unpowered)
"lmz" = (/obj/structure/spider,/obj/item/gun/energy/kinetic_accelerator,/obj/structure/spider{icon_state = "stickyweb2"},/obj/structure/spider{icon_state = "stickyweb2"},/obj/effect/turf_decal/sand,/obj/item/borg/upgrade/modkit/trigger_guard,/obj/item/borg/upgrade/modkit/chassis_mod/orange,/turf/open/floor/plasteel,/area/ruin/unpowered)
"lyA" = (/obj/effect/mob_spawn/human/corpse/damaged{gloves = /obj/item/clothing/gloves/yogs/chitinhands; shoes = /obj/item/clothing/shoes/yogs/chitintreads; suit = /obj/item/clothing/suit/yogs/armor/chitinplate},/obj/item/pickaxe/drill/diamonddrill,/obj/effect/turf_decal/sand,/turf/open/floor/plasteel,/area/ruin/unpowered)
"mgs" = (/obj/structure/spider{icon_state = "stickyweb2"},/obj/structure/spider,/obj/effect/turf_decal/sand,/turf/open/floor/plasteel,/area/ruin/unpowered)
"nnb" = (/obj/item/reagent_containers/food/snacks/spiderleg,/obj/effect/turf_decal/sand,/turf/open/floor/plasteel,/area/ruin/unpowered)
"ocl" = (/obj/item/reagent_containers/food/snacks/spidereggs,/turf/open/floor/plating/asteroid/basalt/lava_land_surface,/area/ruin/unpowered)
"olR" = (/turf/closed/wall/mineral/sandstone,/area/ruin/unpowered)
"pgK" = (/obj/item/reagent_containers/food/snacks/spidereggs,/obj/effect/turf_decal/sand,/turf/open/floor/plasteel,/area/ruin/unpowered)
"rje" = (/obj/structure/spider{icon_state = "stickyweb2"},/obj/structure/spider,/turf/open/floor/plating/asteroid/basalt/lava_land_surface,/area/ruin/unpowered)
"rNl" = (/obj/structure/bed,/obj/effect/mob_spawn/human/skeleton,/obj/effect/turf_decal/sand,/turf/open/floor/plasteel,/area/ruin/unpowered)
"rNL" = (/turf/closed/mineral/volcanic/lava_land_surface,/area/ruin/unpowered)
"tlD" = (/obj/structure/mineral_door/sandstone,/turf/open/floor/plasteel,/area/ruin/unpowered)
"tqc" = (/obj/effect/turf_decal/sand,/mob/living/simple_animal/hostile/asteroid/marrowweaver,/turf/open/floor/plasteel,/area/ruin/unpowered)
"vbe" = (/obj/effect/mob_spawn/human/skeleton,/obj/structure/spider{icon_state = "stickyweb2"},/obj/structure/spider,/obj/effect/turf_decal/sand,/turf/open/floor/plasteel,/area/ruin/unpowered)
"vxS" = (/obj/item/storage/firstaid/toxin,/turf/open/floor/plating/asteroid/basalt/lava_land_surface,/area/ruin/unpowered)
"vzb" = (/obj/structure/spider,/turf/open/floor/plating/asteroid/basalt/lava_land_surface,/area/ruin/unpowered)
"vzv" = (/obj/effect/mob_spawn/human/corpse/syndicatesoldier,/obj/effect/turf_decal/sand,/turf/open/floor/plasteel,/area/ruin/unpowered)
"wBI" = (/obj/item/reagent_containers/food/snacks/spiderleg,/turf/open/floor/plating/asteroid/basalt/lava_land_surface,/area/ruin/unpowered)
"wLm" = (/obj/effect/mob_spawn/human/skeleton,/obj/structure/spider{icon_state = "stickyweb2"},/obj/structure/spider,/obj/structure/spider,/obj/effect/turf_decal/sand,/turf/open/floor/plasteel,/area/ruin/unpowered)
"wUl" = (/turf/open/floor/plating/asteroid/basalt/lava_land_surface,/area/lavaland/surface/outdoors)
"wZr" = (/obj/effect/mob_spawn/human/skeleton,/obj/structure/spider,/obj/structure/spider{icon_state = "stickyweb2"},/turf/open/floor/plating/asteroid/basalt/lava_land_surface,/area/ruin/unpowered)
"xFy" = (/mob/living/simple_animal/hostile/asteroid/marrowweaver,/turf/open/floor/plating/asteroid/basalt/lava_land_surface,/area/ruin/unpowered)
"xIk" = (/obj/effect/mob_spawn/human/corpse/pirate,/obj/item/melee/transforming/energy/sword/pirate,/obj/effect/turf_decal/sand,/turf/open/floor/plasteel,/area/ruin/unpowered)
"xMk" = (/obj/item/pickaxe/silver,/turf/open/floor/plating/asteroid/basalt/lava_land_surface,/area/ruin/unpowered)
"xRE" = (/obj/item/tank/internals/air,/turf/open/floor/plating/asteroid/basalt/lava_land_surface,/area/ruin/unpowered)
"xVS" = (/obj/structure/spider,/obj/effect/turf_decal/sand,/turf/open/floor/plasteel,/area/ruin/unpowered)
"ygm" = (/obj/structure/spider,/obj/structure/spider{icon_state = "stickyweb2"},/obj/effect/turf_decal/sand,/turf/open/floor/plasteel,/area/ruin/unpowered)

(1,1,1) = {"
hmI
hmI
hmI
hmI
hmI
ikU
hmI
hmI
hmI
hmI
ikU
hmI
wUl
wUl
wUl
wUl
wUl
hmI
hmI
hmI
hmI
hmI
hmI
hmI
ikU
wUl
hmI
hmI
hmI
hmI
hmI
hmI
hmI
hmI
hmI
"}
(2,1,1) = {"
hmI
hmI
hmI
ikU
hmI
hmI
hmI
hmI
hmI
hmI
hmI
hmI
hmI
hmI
wUl
wUl
wUl
olR
hmI
hmI
hmI
hmI
hmI
hmI
hmI
hmI
hmI
ikU
ikU
hmI
hmI
hmI
hmI
hmI
hmI
"}
(3,1,1) = {"
hmI
ikU
hmI
hmI
hmI
wUl
wUl
ikU
ikU
hmI
ikU
hmI
hmI
hmI
hmI
rNL
eNH
xVS
rNL
hmI
hmI
rNL
hmI
hmI
ikU
hmI
hmI
hmI
wUl
hmI
ikU
ikU
hmI
hmI
hmI
"}
(4,1,1) = {"
hmI
ikU
hmI
hmI
hmI
wUl
wUl
hmI
hmI
hmI
wUl
hmI
hmI
rNL
hmI
olR
eNH
ygm
ygm
rNL
hmI
rNL
wUl
wUl
hmI
rNL
hmI
hmI
hmI
hmI
hmI
hmI
hmI
hmI
ikU
"}
(5,1,1) = {"
hmI
hmI
hmI
hmI
rNL
wUl
hmI
hmI
rNL
rNL
rNL
wUl
wUl
rNL
rNL
rNL
rNL
eNH
xVS
olR
rNL
rNL
wUl
rNL
hmI
rNL
wUl
wUl
rNL
hmI
hmI
hmI
hmI
hmI
hmI
"}
(6,1,1) = {"
hmI
hmI
hmI
hmI
rNL
rNL
rNL
rNL
rNL
rNL
rNL
rNL
hmI
rNL
gps
lcH
rNL
aXR
aXR
rNL
rNL
rNL
rNL
rNL
rNL
rNL
rNL
rNL
rNL
rNL
wUl
wUl
ikU
hmI
hmI
"}
(7,1,1) = {"
hmI
hmI
hmI
hmI
rNL
rNL
olR
olR
olR
olR
olR
olR
rNL
rNL
lcH
rNL
rNL
rNL
aXR
rNL
rNL
rNL
rNL
rNL
eep
rNL
rNL
rNL
rNL
rNL
hmI
hmI
hmI
ikU
ikU
"}
(8,1,1) = {"
ikU
hmI
hmI
wUl
rNL
olR
vzv
xIk
olR
eHT
gdk
olR
rNL
lcH
gps
gps
gps
rNL
gps
vzb
rNL
rNL
vzb
vzb
rje
vzb
rNL
rNL
rNL
rNL
rNL
rNL
olR
olR
hmI
"}
(9,1,1) = {"
hmI
hmI
hmI
hmI
wUl
olR
mgs
mgs
ygm
mgs
mgs
atR
olR
rNL
rNL
gps
gps
fZq
gps
bRt
gps
gps
gps
rNL
pgK
rNL
rNL
rNL
rNL
rNL
olR
jcn
leP
olR
hmI
"}
(10,1,1) = {"
hmI
hmI
hmI
rNL
rNL
olR
aXR
aXR
aXR
tqc
ygm
olR
rNL
rNL
rNL
rNL
fZq
xFy
vzb
fZq
rNL
rNL
gps
rNL
gps
rNL
rNL
rNL
rNL
rNL
olR
aXR
aXR
olR
hmI
"}
(11,1,1) = {"
hmI
ikU
hmI
wUl
wUl
olR
aXR
dQK
tqc
eTc
ygm
olR
olR
ocl
lcH
aXR
xVS
gps
gps
xMk
rNL
pgK
gps
rNL
lcH
vzb
rNL
rNL
rNL
rNL
olR
rNl
aXR
olR
hmI
"}
(12,1,1) = {"
hmI
hmI
hmI
hmI
rNL
olR
aXR
aXR
aXR
ygm
mgs
fvq
olR
gps
vzb
gps
fZq
gps
gps
gps
gps
gps
rNL
rNL
gps
rNL
rNL
rNL
rNL
rNL
rNL
olR
tlD
olR
hmI
"}
(13,1,1) = {"
hmI
hmI
hmI
hmI
hmI
olR
rNL
aXR
aXR
rNL
lyA
olR
rNL
rNL
lcH
gps
rNL
rNL
rNL
eND
rNL
rNL
rNL
dln
fZq
rNL
rNL
rNL
rNL
rNL
wUl
wUl
wUl
wUl
wUl
"}
(14,1,1) = {"
hmI
hmI
hmI
hmI
rNL
rNL
olR
rNL
lcH
olR
olR
rNL
rNL
rNL
gps
xFy
rNL
rNL
rNL
vxS
aXR
xFy
fZq
vzb
fZq
rNL
rNL
olR
olR
gps
wUl
wUl
wUl
wUl
wUl
"}
(15,1,1) = {"
hmI
ikU
hmI
rNL
rNL
rNL
gps
rNL
aXR
xFy
rNL
rNL
rNL
lcH
fZq
aXR
aXR
wBI
dYd
aXR
nnb
rNL
rNL
rNL
gps
eNH
fZq
aXR
eNH
gps
gps
wUl
wUl
wUl
wUl
"}
(16,1,1) = {"
hmI
hmI
hmI
hmI
rNL
rNL
gps
gps
gps
gps
rNL
ocl
rNL
gps
eND
rNL
lcH
rNL
ocl
fZq
fZq
rNL
rNL
rNL
vzb
rNL
rNL
olR
rNL
rNL
rNL
wUl
wUl
wUl
hmI
"}
(17,1,1) = {"
hmI
hmI
hmI
hmI
hmI
rNL
gps
rNL
lcH
rNL
rNL
aXR
aXR
gps
gps
lcH
gps
rNL
rNL
fZq
gps
gps
rNL
gps
aXR
rNL
rNL
rNL
rNL
rNL
wUl
wUl
hmI
hmI
hmI
"}
(18,1,1) = {"
hmI
hmI
hmI
rNL
rNL
rNL
gps
rNL
eNH
rNL
rNL
gps
rNL
rNL
lcH
lcH
gps
vzb
xRE
gps
aXR
gps
vzb
aXR
gps
rNL
rNL
rNL
rNL
rNL
rNL
rNL
hmI
hmI
hmI
"}
(19,1,1) = {"
hmI
ikU
hmI
rNL
rNL
rNL
olR
rNL
aXR
gps
olR
aXR
rNL
lcH
xFy
rNL
gps
rNL
rNL
gps
rNL
rNL
rNL
lcH
rNL
rNL
rNL
rNL
rNL
rNL
rNL
wUl
hmI
hmI
hmI
"}
(20,1,1) = {"
hmI
ikU
hmI
hmI
hmI
olR
rNL
gps
aXR
rNL
rNL
rNL
rNL
rNL
fZq
vzb
gps
rNL
vzb
vzb
rNL
gps
vzb
gps
rNL
lcH
ocl
rNL
hmI
hmI
hmI
hmI
hmI
hmI
hmI
"}
(21,1,1) = {"
hmI
hmI
hmI
hmI
rNL
olR
lmz
fZq
gps
xVS
aXR
rNL
rNL
wZr
aXR
aXR
tqc
lcH
gps
aXR
gps
iCf
rNL
gps
lcH
gps
rNL
rNL
rNL
hmI
hmI
hmI
hmI
hmI
hmI
"}
(22,1,1) = {"
ikU
hmI
hmI
rNL
rNL
olR
evP
iNB
gps
vbe
aXR
fZq
gps
fZq
nnb
clA
gps
rNL
rNL
rNL
rNL
rNL
rNL
rNL
gps
rNL
rNL
rNL
rNL
hmI
ikU
ikU
ikU
ikU
hmI
"}
(23,1,1) = {"
hmI
hmI
hmI
hmI
rNL
rNL
gps
aXR
xFy
aXR
gps
fZq
rNL
rNL
rNL
wZr
lcH
rNL
rNL
rNL
rNL
ygm
gps
vzb
vzb
rNL
rNL
rNL
rNL
hmI
hmI
wUl
ikU
ikU
hmI
"}
(24,1,1) = {"
hmI
hmI
hmI
hmI
hmI
olR
rNL
gps
dYd
xFy
gps
rNL
rNL
rNL
rNL
gps
gps
vzb
rNL
fZq
gps
aXR
rNL
rNL
gps
vzb
rNL
rNL
hmI
hmI
hmI
ikU
wUl
hmI
hmI
"}
(25,1,1) = {"
hmI
ikU
hmI
rNL
rNL
rNL
xVS
hud
gps
dYd
aXR
aXR
olR
rNL
rNL
rNL
vzb
gps
rNL
gps
aXR
aXR
rNL
vzb
gps
aXR
gps
rNL
rNL
hmI
hmI
hmI
hmI
hmI
hmI
"}
(26,1,1) = {"
hmI
hmI
wUl
wUl
rNL
rNL
rNL
xVS
gps
wLm
vzb
xVS
rNL
ocl
lcH
gps
lcH
gps
lcH
xFy
rNL
aXR
gps
gps
rNL
gps
lcH
olR
rNL
hmI
hmI
hmI
hmI
hmI
hmI
"}
(27,1,1) = {"
hmI
hmI
wUl
wUl
wUl
rNL
rNL
gps
tqc
gps
gps
rNL
rNL
lcH
rNL
ocl
rNL
gps
lcH
rNL
rNL
aGK
aXR
gps
rNL
rNL
lcH
rNL
rNL
rNL
rNL
rNL
hmI
ikU
hmI
"}
(28,1,1) = {"
hmI
ikU
hmI
hmI
hmI
olR
aXR
aXR
gps
gps
aXR
aXR
rNL
rNL
rNL
rNL
rNL
rNL
rNL
rNL
rNL
rNL
ygm
rNL
rNL
rNL
gps
vzb
eHO
rNL
rNL
hmI
hmI
hmI
hmI
"}
(29,1,1) = {"
hmI
ikU
hmI
hmI
rNL
rNL
rNL
rNL
olR
olR
rNL
rNL
rNL
rNL
rNL
rNL
rNL
rNL
rNL
rNL
rNL
rNL
aXR
rNL
rNL
rNL
rNL
rNL
rNL
rNL
hmI
ikU
hmI
hmI
hmI
"}
(30,1,1) = {"
hmI
hmI
hmI
ikU
hmI
hmI
hmI
rNL
hmI
hmI
wUl
rNL
hmI
hmI
hmI
hmI
wUl
hmI
rNL
rNL
rNL
rNL
aXR
rNL
rNL
rNL
rNL
rNL
hmI
hmI
hmI
wUl
hmI
hmI
hmI
"}
(31,1,1) = {"
ikU
hmI
hmI
hmI
ikU
wUl
wUl
hmI
hmI
hmI
hmI
wUl
hmI
hmI
hmI
ikU
ikU
ikU
wUl
rNL
gps
gps
gps
gps
rNL
rNL
rNL
rNL
hmI
wUl
hmI
hmI
ikU
hmI
hmI
"}
(32,1,1) = {"
hmI
hmI
hmI
hmI
hmI
hmI
hmI
hmI
hmI
hmI
hmI
hmI
ikU
hmI
hmI
hmI
hmI
hmI
hmI
hmI
hmI
wUl
wUl
wUl
wUl
wUl
rNL
hmI
hmI
hmI
ikU
hmI
ikU
hmI
hmI
"}
(33,1,1) = {"
hmI
ikU
hmI
hmI
ikU
hmI
hmI
hmI
hmI
ikU
hmI
hmI
ikU
hmI
hmI
hmI
hmI
hmI
hmI
hmI
hmI
wUl
wUl
wUl
hmI
hmI
hmI
wUl
wUl
hmI
hmI
hmI
ikU
hmI
hmI
"}
(34,1,1) = {"
hmI
hmI
hmI
hmI
ikU
hmI
hmI
hmI
hmI
hmI
hmI
hmI
hmI
hmI
ikU
hmI
hmI
hmI
hmI
hmI
hmI
wUl
wUl
wUl
hmI
hmI
hmI
ikU
hmI
ikU
hmI
hmI
hmI
hmI
hmI
"}
(35,1,1) = {"
hmI
hmI
hmI
hmI
ikU
hmI
hmI
hmI
ikU
hmI
hmI
hmI
hmI
hmI
hmI
hmI
hmI
hmI
hmI
hmI
wUl
wUl
wUl
hmI
hmI
hmI
hmI
hmI
hmI
hmI
hmI
hmI
hmI
hmI
hmI
"}
