// This map has been converted using maphash
"arG" = (/turf/template_noop,/area/template_noop)
"aXK" = (/obj/item/clockwork/alloy_shards/clockgolem_remains,/turf/open/floor/plating/asteroid/basalt/lava_land_surface,/area/lavaland/surface/outdoors/unexplored)
"bwe" = (/obj/item/clockwork/component/geis_capacitor/fallen_armor,/turf/open/floor/clockwork{initial_gas_mix = "o2=14;n2=23;TEMP=300"},/area/lavaland/surface/outdoors/unexplored)
"cGc" = (/turf/closed/mineral/volcanic/lava_land_surface,/area/lavaland/surface/outdoors/unexplored)
"dfw" = (/obj/item/clockwork/component/belligerent_eye/blind_eye,/turf/open/floor/plating/asteroid/basalt/lava_land_surface,/area/lavaland/surface/outdoors/unexplored)
"dyW" = (/obj/structure/destructible/clockwork/wall_gear,/turf/open/floor/clockwork{initial_gas_mix = "o2=14;n2=23;TEMP=300"},/area/lavaland/surface/outdoors/unexplored)
"dIk" = (/obj/item/clockwork/alloy_shards/medium/gear_bit,/turf/open/floor/plating/asteroid/basalt/lava_land_surface,/area/lavaland/surface/outdoors/unexplored)
"dXs" = (/obj/item/stack/tile/brass/fifty,/turf/open/floor/plating/asteroid/basalt/lava_land_surface,/area/lavaland/surface/outdoors/unexplored)
"fsm" = (/obj/item/clockwork/alloy_shards/clockgolem_remains,/turf/open/floor/clockwork{initial_gas_mix = "o2=14;n2=23;TEMP=300"},/area/lavaland/surface/outdoors/unexplored)
"gzZ" = (/turf/open/floor/plating/asteroid/basalt/lava_land_surface,/area/lavaland/surface/outdoors/unexplored)
"hlo" = (/obj/item/clockwork/alloy_shards/medium,/turf/open/floor/plating/asteroid/basalt/lava_land_surface,/area/lavaland/surface/outdoors/unexplored)
"iEA" = (/obj/structure/grille/ratvar,/turf/open/floor/clockwork{initial_gas_mix = "o2=14;n2=23;TEMP=300"},/area/lavaland/surface/outdoors/unexplored)
"kFe" = (/obj/structure/dead_ratvar,/turf/open/floor/clockwork{initial_gas_mix = "o2=14;n2=23;TEMP=300"},/area/lavaland/surface/outdoors/unexplored)
"kQR" = (/obj/structure/destructible/clockwork/wall_gear,/obj/item/stack/tile/brass,/turf/open/floor/clockwork{initial_gas_mix = "o2=14;n2=23;TEMP=300"},/area/lavaland/surface/outdoors/unexplored)
"ldJ" = (/turf/open/floor/clockwork{initial_gas_mix = "o2=14;n2=23;TEMP=300"},/area/lavaland/surface/outdoors/unexplored)
"mKU" = (/obj/structure/lattice/clockwork,/turf/open/floor/plating/asteroid/basalt/lava_land_surface,/area/lavaland/surface/outdoors/unexplored)
"mLC" = (/turf/closed/wall/clockwork,/area/lavaland/surface/outdoors/unexplored)
"oMo" = (/obj/item/clockwork/weapon/ratvarian_spear,/turf/open/floor/clockwork{initial_gas_mix = "o2=14;n2=23;TEMP=300"},/area/lavaland/surface/outdoors/unexplored)
"pfU" = (/obj/item/clockwork/alloy_shards/medium,/turf/open/floor/clockwork{initial_gas_mix = "o2=14;n2=23;TEMP=300"},/area/lavaland/surface/outdoors/unexplored)
"pvH" = (/obj/item/clockwork/alloy_shards/large,/turf/open/floor/plating/asteroid/basalt/lava_land_surface,/area/lavaland/surface/outdoors/unexplored)
"qgl" = (/obj/item/clockwork/alloy_shards/small,/turf/open/floor/clockwork{initial_gas_mix = "o2=14;n2=23;TEMP=300"},/area/lavaland/surface/outdoors/unexplored)
"qLN" = (/obj/structure/grille/ratvar,/turf/open/floor/plating/asteroid/basalt/lava_land_surface,/area/lavaland/surface/outdoors/unexplored)
"rCg" = (/obj/item/clockwork/alloy_shards/medium/gear_bit,/turf/open/floor/clockwork{initial_gas_mix = "o2=14;n2=23;TEMP=300"},/area/lavaland/surface/outdoors/unexplored)
"tgi" = (/turf/open/lava/smooth/lava_land_surface,/area/lavaland/surface/outdoors/unexplored)
"tvB" = (/obj/structure/grille/ratvar/broken,/turf/open/floor/plating/asteroid/basalt/lava_land_surface,/area/lavaland/surface/outdoors/unexplored)
"tCB" = (/obj/item/clockwork/alloy_shards/large,/turf/open/floor/clockwork{initial_gas_mix = "o2=14;n2=23;TEMP=300"},/area/lavaland/surface/outdoors/unexplored)
"tDI" = (/obj/structure/grille/ratvar/broken,/turf/open/floor/clockwork{initial_gas_mix = "o2=14;n2=23;TEMP=300"},/area/lavaland/surface/outdoors/unexplored)
"ubn" = (/obj/item/clockwork/alloy_shards/small,/turf/open/floor/plating/asteroid/basalt/lava_land_surface,/area/lavaland/surface/outdoors/unexplored)
"udE" = (/obj/item/clockwork/alloy_shards/medium,/obj/structure/lattice/clockwork,/turf/open/floor/plating/asteroid/basalt/lava_land_surface,/area/lavaland/surface/outdoors/unexplored)
"uZe" = (/obj/item/stack/tile/brass,/turf/open/floor/clockwork{initial_gas_mix = "o2=14;n2=23;TEMP=300"},/area/lavaland/surface/outdoors/unexplored)
"wNS" = (/obj/item/stack/tile/brass,/turf/open/floor/plating/asteroid/basalt/lava_land_surface,/area/lavaland/surface/outdoors/unexplored)
"wVt" = (/obj/structure/lattice/catwalk/clockwork,/turf/open/lava/smooth/lava_land_surface,/area/lavaland/surface/outdoors/unexplored)
"wXL" = (/obj/structure/destructible/clockwork/wall_gear,/turf/open/floor/plating/asteroid/basalt/lava_land_surface,/area/lavaland/surface/outdoors/unexplored)

(1,1,1) = {"
arG
arG
arG
arG
arG
arG
arG
arG
arG
arG
arG
arG
arG
gzZ
tCB
ldJ
gzZ
arG
arG
arG
arG
arG
arG
arG
"}
(2,1,1) = {"
arG
arG
arG
arG
arG
arG
arG
pvH
gzZ
arG
ldJ
gzZ
mKU
ubn
mLC
kQR
gzZ
gzZ
dIk
arG
arG
arG
arG
arG
"}
(3,1,1) = {"
arG
arG
arG
arG
arG
arG
cGc
gzZ
tgi
gzZ
udE
gzZ
pfU
tDI
mLC
mLC
ubn
tgi
gzZ
gzZ
arG
arG
arG
arG
"}
(4,1,1) = {"
arG
arG
arG
arG
arG
arG
cGc
tgi
tgi
mKU
gzZ
gzZ
tgi
mLC
mLC
mLC
pfU
tgi
gzZ
ldJ
ubn
mKU
arG
arG
"}
(5,1,1) = {"
arG
arG
arG
arG
arG
gzZ
tgi
tgi
pfU
ldJ
ubn
tgi
tgi
tgi
mLC
tgi
gzZ
tgi
tgi
qLN
ldJ
mKU
arG
arG
"}
(6,1,1) = {"
arG
arG
arG
ldJ
ubn
ldJ
hlo
tgi
tgi
ubn
tgi
tgi
tgi
tgi
tDI
tgi
tgi
tgi
hlo
ubn
ldJ
cGc
arG
arG
"}
(7,1,1) = {"
arG
arG
gzZ
gzZ
gzZ
tgi
tgi
tgi
tgi
ldJ
gzZ
tgi
tgi
tgi
tgi
tgi
tgi
tgi
tgi
ubn
cGc
cGc
gzZ
arG
"}
(8,1,1) = {"
arG
ldJ
ldJ
dIk
ubn
gzZ
tgi
tgi
tgi
tgi
dfw
ldJ
mKU
tgi
tgi
gzZ
tgi
tgi
tgi
tgi
cGc
gzZ
arG
arG
"}
(9,1,1) = {"
arG
gzZ
ubn
gzZ
gzZ
tgi
tgi
tgi
tgi
wNS
ldJ
gzZ
ldJ
tDI
pfU
gzZ
dIk
tgi
tgi
gzZ
gzZ
gzZ
gzZ
arG
"}
(10,1,1) = {"
gzZ
ldJ
tgi
tgi
tgi
tgi
tgi
tgi
gzZ
gzZ
pfU
mKU
kFe
gzZ
ldJ
fsm
gzZ
tgi
tgi
tgi
hlo
tgi
tgi
arG
"}
(11,1,1) = {"
ubn
tvB
mLC
mLC
tgi
tgi
tgi
tgi
tgi
gzZ
ldJ
qgl
ldJ
ldJ
ldJ
mKU
tgi
tgi
tgi
tgi
tgi
tgi
gzZ
arG
"}
(12,1,1) = {"
wXL
mLC
mLC
mLC
ldJ
tgi
tgi
gzZ
tgi
wVt
mKU
ldJ
ldJ
ldJ
ubn
wVt
tgi
gzZ
tgi
tgi
gzZ
ldJ
pvH
arG
"}
(13,1,1) = {"
uZe
qgl
gzZ
tgi
tgi
tgi
gzZ
pfU
tCB
mKU
ldJ
ldJ
ldJ
ldJ
ldJ
ldJ
ldJ
tgi
tgi
tgi
tgi
gzZ
gzZ
arG
"}
(14,1,1) = {"
gzZ
gzZ
gzZ
hlo
tgi
tgi
tgi
gzZ
ldJ
ldJ
qgl
ldJ
ldJ
ldJ
ldJ
ldJ
ubn
gzZ
tgi
tgi
gzZ
gzZ
ldJ
gzZ
"}
(15,1,1) = {"
gzZ
gzZ
gzZ
tgi
tgi
tgi
tgi
ldJ
ldJ
ldJ
ldJ
ldJ
ldJ
ldJ
qgl
oMo
ldJ
tgi
tgi
tgi
tgi
gzZ
gzZ
arG
"}
(16,1,1) = {"
cGc
tgi
tgi
tgi
tgi
tgi
tgi
wVt
gzZ
ldJ
ldJ
ldJ
ldJ
ldJ
ldJ
tCB
gzZ
tgi
tgi
tgi
tgi
cGc
cGc
arG
"}
(17,1,1) = {"
gzZ
gzZ
gzZ
tgi
tgi
tgi
gzZ
tgi
wVt
mKU
ldJ
ldJ
ldJ
ldJ
ldJ
gzZ
tCB
mKU
tgi
mKU
tgi
tgi
gzZ
arG
"}
(18,1,1) = {"
gzZ
ldJ
tgi
tgi
tgi
gzZ
gzZ
ldJ
gzZ
ldJ
ldJ
ldJ
ldJ
ldJ
mKU
qgl
gzZ
rCg
mKU
ldJ
gzZ
gzZ
hlo
gzZ
"}
(19,1,1) = {"
gzZ
gzZ
tgi
tgi
tgi
tgi
ldJ
gzZ
ldJ
ldJ
ldJ
ldJ
ldJ
ldJ
ldJ
mKU
mLC
ldJ
ubn
ldJ
mKU
ldJ
gzZ
gzZ
"}
(20,1,1) = {"
gzZ
tgi
tgi
tgi
tgi
gzZ
gzZ
pfU
ldJ
ubn
ldJ
qgl
ldJ
ldJ
pvH
gzZ
tgi
tgi
tgi
gzZ
aXK
mKU
dXs
pvH
"}
(21,1,1) = {"
dIk
gzZ
tgi
tgi
tgi
tgi
tgi
mKU
ldJ
mKU
ldJ
ldJ
ldJ
ldJ
bwe
tgi
tgi
tgi
tgi
tgi
tgi
mLC
mLC
mKU
"}
(22,1,1) = {"
ubn
ubn
gzZ
tgi
tgi
gzZ
ldJ
ldJ
wNS
gzZ
ldJ
ldJ
ldJ
ldJ
ldJ
hlo
gzZ
tgi
tgi
tgi
ldJ
mLC
mLC
mLC
"}
(23,1,1) = {"
gzZ
ldJ
hlo
dfw
gzZ
ldJ
tgi
pvH
mLC
iEA
mKU
pfU
ldJ
mKU
ldJ
gzZ
tgi
tgi
tgi
gzZ
gzZ
tDI
mKU
gzZ
"}
(24,1,1) = {"
arG
arG
gzZ
gzZ
tgi
tgi
tgi
mLC
mLC
wVt
pfU
ldJ
hlo
uZe
dyW
mLC
mLC
tgi
tgi
ubn
tgi
tgi
gzZ
arG
"}
(25,1,1) = {"
arG
arG
arG
tgi
tgi
tgi
tgi
mLC
tgi
tgi
gzZ
ldJ
mKU
kQR
ldJ
tgi
tgi
tgi
tgi
tgi
tgi
arG
arG
arG
"}
(26,1,1) = {"
arG
arG
arG
ubn
gzZ
tgi
tgi
tgi
tgi
tgi
tgi
dIk
wVt
gzZ
ldJ
tgi
tgi
tgi
ubn
hlo
gzZ
arG
arG
arG
"}
(27,1,1) = {"
arG
arG
arG
gzZ
ldJ
gzZ
tgi
tgi
tgi
tgi
tgi
tgi
tgi
tgi
tgi
tgi
tgi
tgi
tgi
gzZ
arG
arG
arG
arG
"}
(28,1,1) = {"
arG
arG
arG
arG
ubn
gzZ
tgi
gzZ
tgi
tgi
tgi
tgi
tgi
tgi
tgi
tgi
gzZ
tgi
cGc
arG
arG
arG
arG
arG
"}
(29,1,1) = {"
arG
arG
arG
arG
gzZ
gzZ
cGc
ubn
gzZ
tgi
ubn
tgi
tgi
tgi
tgi
ubn
pvH
tgi
gzZ
arG
arG
arG
arG
arG
"}
(30,1,1) = {"
arG
arG
arG
arG
arG
dIk
ubn
gzZ
tgi
tgi
gzZ
hlo
tgi
gzZ
tgi
cGc
gzZ
arG
arG
arG
arG
arG
arG
arG
"}
(31,1,1) = {"
arG
arG
arG
arG
arG
arG
arG
gzZ
tgi
gzZ
arG
gzZ
tgi
ubn
cGc
cGc
arG
arG
arG
arG
arG
arG
arG
arG
"}
(32,1,1) = {"
arG
arG
arG
arG
arG
arG
arG
arG
arG
arG
arG
arG
arG
arG
ubn
arG
arG
arG
arG
arG
arG
arG
arG
arG
"}
