//MAP CONVERTED BY dmm2tgm.py THIS HEADER COMMENT PREVENTS RECONVERSION, DO NOT REMOVE
"a" = (
/obj/effect/mapping_helpers/no_lava,
/obj/effect/decal/cleanable/blood/tracks{
	dir = 1
	},
/turf/open/floor/plating/asteroid/basalt/lava_land_surface,
/area/ruin/powered)
"b" = (
/mob/living/simple_animal/hostile/megafauna/demonic_frost_miner,
/turf/open/floor/plating/ice/colder,
/area/ruin/powered)
"d" = (
/turf/closed/indestructible/rock/snow,
/area/lavaland/surface/outdoors)
"e" = (
/obj/effect/decal/cleanable/blood/tracks{
	dir = 5
	},
/turf/open/floor/plating/asteroid/snow/icemoon,
/area/ruin/powered)
"g" = (
/obj/structure/closet/crate/wooden,
/obj/item/storage/firstaid/hypospray/advanced/hypo{
	pixel_x = 4
	},
/obj/item/storage/firstaid/hypospray/advanced{
	pixel_x = -5
	},
/obj/item/hypospray_upgrade/quickload{
	pixel_x = 2;
	pixel_y = -2
	},
/obj/item/hypospray_upgrade/piercing{
	pixel_x = -5;
	pixel_y = -1
	},
/turf/open/floor/plating/ice/colder,
/area/ruin/powered)
"h" = (
/obj/effect/mapping_helpers/no_lava,
/obj/structure/fluff/grave/empty,
/turf/open/floor/plating/asteroid/basalt/lava_land_surface,
/area/lavaland/surface/outdoors)
"i" = (
/turf/closed/indestructible/rock,
/area/lavaland/surface/outdoors)
"j" = (
/obj/effect/mapping_helpers/no_lava,
/obj/effect/decal/cleanable/blood/tracks{
	dir = 1
	},
/turf/open/floor/plating/asteroid/basalt/lava_land_surface,
/area/lavaland/surface/outdoors)
"k" = (
/obj/effect/decal/cleanable/blood/footprints{
	dir = 8
	},
/obj/effect/decal/cleanable/blood/footprints,
/turf/open/floor/plating/ice/colder,
/area/ruin/powered)
"l" = (
/turf/open/floor/plating/ice/colder,
/area/ruin/powered)
"m" = (
/obj/effect/decal/cleanable/blood/gibs/down,
/obj/item/coin/adamantine{
	pixel_x = 6;
	pixel_y = -2
	},
/obj/item/clothing/suit/hooded/explorer,
/obj/item/clothing/shoes/winterboots/ice_boots{
	pixel_x = -9;
	pixel_y = -6
	},
/turf/open/floor/plating/ice/colder,
/area/ruin/powered)
"n" = (
/obj/effect/mapping_helpers/no_lava,
/turf/open/floor/plating/asteroid/basalt/lava_land_surface,
/area/lavaland/surface/outdoors)
"o" = (
/obj/effect/decal/cleanable/blood/gibs/core,
/obj/effect/decal/cleanable/blood/innards,
/turf/open/floor/plating/ice/colder,
/area/ruin/powered)
"p" = (
/obj/effect/decal/cleanable/blood/gibs/torso,
/obj/item/clothing/suit/hooded/explorer,
/turf/open/floor/plating/ice/colder,
/area/ruin/powered)
"r" = (
/obj/effect/mapping_helpers/no_lava,
/obj/effect/decal/cleanable/blood/splatter,
/turf/open/floor/plating/asteroid/basalt/lava_land_surface,
/area/lavaland/surface/outdoors)
"v" = (
/obj/structure/closet/crate/wooden,
/obj/item/borg/upgrade/modkit/chassis_mod/orange{
	pixel_y = -1
	},
/obj/item/borg/upgrade/modkit/hardness{
	pixel_x = -8;
	pixel_y = -1
	},
/obj/item/borg/upgrade/modkit/cooldown{
	pixel_x = 9;
	pixel_y = -1
	},
/obj/item/gun/energy/kinetic_accelerator,
/turf/open/floor/plating/ice/colder,
/area/ruin/powered)
"w" = (
/obj/effect/decal/cleanable/blood/footprints,
/turf/open/floor/plating/ice/colder,
/area/ruin/powered)
"y" = (
/obj/effect/mapping_helpers/no_lava,
/obj/structure/fans/tiny/invisible,
/obj/effect/decal/cleanable/blood/tracks{
	dir = 1
	},
/turf/open/floor/plating/asteroid/basalt/lava_land_surface,
/area/ruin/powered)
"z" = (
/obj/effect/mapping_helpers/no_lava,
/obj/structure/fluff/fokoff_sign,
/turf/open/floor/plating/asteroid/basalt/lava_land_surface,
/area/ruin/powered)
"A" = (
/obj/structure/closet/crate/wooden,
/obj/item/fugu_gland{
	pixel_x = -1;
	pixel_y = -4
	},
/obj/item/fugu_gland{
	pixel_x = 4;
	pixel_y = 3
	},
/obj/item/fugu_gland{
	pixel_x = -8;
	pixel_y = 3
	},
/turf/open/floor/plating/ice/colder,
/area/ruin/powered)
"B" = (
/obj/effect/mapping_helpers/no_lava,
/obj/effect/decal/cleanable/blood/tracks{
	dir = 5
	},
/turf/open/floor/plating/asteroid/basalt/lava_land_surface,
/area/ruin/powered)
"C" = (
/obj/effect/decal/cleanable/blood/gibs/old,
/turf/open/floor/plating/ice/colder,
/area/ruin/powered)
"E" = (
/obj/machinery/power/floodlight,
/turf/open/floor/plating/ice/colder,
/area/ruin/powered)
"F" = (
/obj/effect/decal/cleanable/blood/tracks{
	dir = 1
	},
/turf/open/floor/plating/asteroid/snow/icemoon,
/area/ruin/powered)
"G" = (
/obj/structure/closet/crate/wooden,
/obj/item/coin/adamantine{
	pixel_x = 4;
	pixel_y = 1
	},
/obj/item/coin/adamantine{
	pixel_x = 4;
	pixel_y = -8
	},
/obj/item/coin/adamantine{
	pixel_x = 10;
	pixel_y = -8
	},
/obj/item/coin/adamantine{
	pixel_x = -2;
	pixel_y = -5
	},
/obj/item/coin/adamantine{
	pixel_x = -9;
	pixel_y = -7
	},
/obj/item/coin/adamantine{
	pixel_x = 8;
	pixel_y = 3
	},
/obj/item/coin/adamantine{
	pixel_x = -2;
	pixel_y = 3
	},
/obj/item/coin/adamantine{
	pixel_x = -9;
	pixel_y = 2
	},
/turf/open/floor/plating/ice/colder,
/area/ruin/powered)
"J" = (
/obj/effect/mapping_helpers/no_lava,
/obj/effect/decal/cleanable/blood/tracks{
	dir = 10
	},
/turf/open/floor/plating/asteroid/basalt/lava_land_surface,
/area/ruin/powered)
"L" = (
/turf/template_noop,
/area/template_noop)
"M" = (
/obj/item/extraction_pack,
/turf/open/floor/plating/ice/colder,
/area/ruin/powered)
"N" = (
/turf/closed/indestructible/rock/snow/ice,
/area/lavaland/surface/outdoors)
"O" = (
/obj/effect/decal/cleanable/blood/tracks{
	dir = 4
	},
/turf/open/floor/plating/asteroid/snow/icemoon,
/area/ruin/powered)
"P" = (
/obj/effect/decal/cleanable/robot_debris,
/obj/effect/decal/cleanable/oil/streak,
/turf/open/floor/plating/ice/colder,
/area/ruin/powered)
"Q" = (
/obj/effect/decal/cleanable/blood/gibs/up,
/obj/item/clothing/suit/hooded/explorer,
/obj/item/flashlight/lantern{
	on = 1;
	pixel_x = -11;
	pixel_y = -11
	},
/obj/item/kitchen/knife/combat/survival{
	pixel_x = 6;
	pixel_y = -8
	},
/obj/effect/decal/cleanable/blood/footprints,
/turf/open/floor/plating/ice/colder,
/area/ruin/powered)
"R" = (
/obj/structure/closet/crate/wooden,
/obj/item/grenade/antigravity{
	pixel_y = 1
	},
/obj/item/grenade/antigravity{
	pixel_x = 9;
	pixel_y = 1
	},
/obj/item/grenade/antigravity{
	pixel_x = -9;
	pixel_y = 1
	},
/turf/open/floor/plating/ice/colder,
/area/ruin/powered)
"S" = (
/obj/effect/decal/cleanable/blood/old,
/turf/open/floor/plating/ice/colder,
/area/ruin/powered)
"T" = (
/obj/effect/decal/cleanable/blood/footprints{
	dir = 8
	},
/turf/open/floor/plating/ice/colder,
/area/ruin/powered)
"U" = (
/obj/item/clothing/shoes/winterboots/ice_boots,
/obj/effect/decal/cleanable/blood/tracks{
	dir = 4
	},
/turf/open/floor/plating/ice/colder,
/area/ruin/powered)
"V" = (
/obj/effect/mapping_helpers/no_lava,
/obj/structure/fluff/grave,
/turf/open/floor/plating/asteroid/basalt/lava_land_surface,
/area/lavaland/surface/outdoors)
"Y" = (
/obj/effect/decal/cleanable/blood/footprints,
/obj/effect/decal/cleanable/blood/footprints{
	dir = 8
	},
/turf/open/floor/plating/ice/colder,
/area/ruin/powered)
"Z" = (
/obj/machinery/power/floodlight,
/obj/effect/decal/cleanable/blood/gibs/core,
/turf/open/floor/plating/ice/colder,
/area/ruin/powered)

(1,1,1) = {"
L
L
L
L
L
L
L
L
L
L
L
L
n
n
n
n
n
n
n
n
n
n
n
n
n
n
n
n
n
n
n
n
n
n
n
n
L
L
L
L
L
L
L
L
"}
(2,1,1) = {"
L
L
L
L
L
L
L
L
L
L
n
n
n
n
n
n
n
n
n
i
i
i
n
i
n
i
n
i
n
n
n
n
n
n
n
n
L
L
L
L
L
L
L
L
"}
(3,1,1) = {"
L
L
L
L
L
L
L
L
n
n
n
n
n
i
i
i
i
i
i
i
i
i
i
i
i
i
i
i
i
i
i
i
i
n
n
n
n
n
L
L
L
L
L
L
"}
(4,1,1) = {"
L
L
L
L
L
L
L
n
n
n
n
n
n
i
i
i
i
i
i
i
i
i
i
i
i
i
i
i
i
i
i
i
i
n
n
n
n
n
L
L
L
L
L
L
"}
(5,1,1) = {"
L
L
L
L
L
L
L
n
n
i
i
i
i
i
i
i
d
d
d
d
d
d
d
d
d
d
d
d
d
d
d
i
i
i
i
i
n
n
n
L
L
L
L
L
"}
(6,1,1) = {"
L
L
L
L
L
L
L
n
n
i
i
i
i
i
i
d
d
N
N
N
N
N
N
N
N
N
N
N
N
N
d
d
i
i
i
i
n
n
n
L
L
L
L
L
"}
(7,1,1) = {"
L
L
L
L
L
L
n
n
n
i
i
i
i
d
d
d
N
N
N
N
N
N
N
N
N
N
N
N
N
N
N
d
d
i
i
i
i
n
n
n
L
L
L
L
"}
(8,1,1) = {"
L
L
L
L
L
L
n
n
i
i
i
i
d
d
N
N
N
N
l
l
l
l
l
G
l
l
l
l
l
N
N
N
d
d
i
i
i
n
n
n
n
L
L
L
"}
(9,1,1) = {"
L
L
L
L
L
n
n
n
i
i
i
d
d
N
N
N
l
l
l
l
l
l
l
l
l
l
l
l
l
l
N
N
N
d
d
i
i
i
i
n
n
L
L
L
"}
(10,1,1) = {"
L
L
L
L
L
n
n
i
i
i
d
d
N
N
N
l
C
l
l
l
l
l
C
l
l
l
l
l
l
l
l
N
N
N
d
i
i
i
i
n
n
L
L
L
"}
(11,1,1) = {"
L
L
L
L
L
n
n
i
i
i
d
N
N
N
l
S
l
l
l
l
C
l
l
l
l
l
l
l
l
l
l
v
N
N
d
d
i
i
i
n
n
L
L
L
"}
(12,1,1) = {"
L
L
L
L
L
n
n
i
i
d
d
N
N
A
l
l
l
l
l
l
l
l
l
l
l
l
l
o
l
l
l
l
l
N
N
d
d
i
i
n
n
L
L
L
"}
(13,1,1) = {"
L
L
L
L
L
n
n
i
i
d
N
N
N
l
l
l
l
l
l
l
l
l
l
l
l
l
l
l
l
l
l
l
l
l
N
N
d
i
i
n
n
L
L
L
"}
(14,1,1) = {"
L
L
L
L
n
n
i
i
i
d
N
N
l
l
l
l
E
l
l
S
l
l
l
C
l
l
l
l
l
E
l
l
l
l
N
N
d
i
i
n
n
L
L
L
"}
(15,1,1) = {"
L
L
L
L
n
n
n
i
i
d
N
N
l
l
l
l
S
l
l
l
l
l
l
l
l
l
l
l
l
l
l
l
l
l
l
N
d
i
i
n
n
L
L
L
"}
(16,1,1) = {"
L
L
L
L
n
n
n
i
i
d
N
N
l
l
l
l
l
l
l
C
l
l
l
l
l
l
S
l
l
l
S
l
l
l
l
N
d
i
i
n
n
n
L
L
"}
(17,1,1) = {"
L
L
L
L
n
n
n
i
i
d
N
N
l
l
l
l
l
l
l
l
l
l
l
l
l
l
l
l
l
C
l
l
l
l
l
N
d
i
i
i
n
n
L
L
"}
(18,1,1) = {"
L
L
L
L
n
n
i
i
i
d
N
N
l
l
l
l
l
S
l
l
l
m
l
S
l
l
l
l
l
l
l
l
l
l
l
N
d
i
i
i
n
n
L
L
"}
(19,1,1) = {"
L
L
L
L
n
n
i
i
i
d
N
N
l
l
l
o
l
l
l
l
l
l
l
l
l
l
C
l
l
l
l
l
l
l
l
N
d
i
i
n
n
n
L
L
"}
(20,1,1) = {"
L
L
L
L
n
n
n
i
i
d
N
N
l
l
l
l
l
l
l
l
l
l
l
l
l
l
l
l
l
S
l
l
l
l
l
N
d
i
i
i
n
n
L
L
"}
(21,1,1) = {"
L
L
L
L
n
n
i
i
i
d
N
N
l
l
l
l
l
p
l
l
l
l
l
b
l
l
l
l
l
l
l
l
l
l
g
N
d
i
i
n
n
n
L
L
"}
(22,1,1) = {"
L
L
L
L
n
n
i
i
i
d
N
N
l
l
l
l
l
M
l
l
l
l
l
T
l
l
l
l
l
l
l
l
l
l
l
N
d
i
i
n
n
n
L
L
"}
(23,1,1) = {"
L
L
L
L
n
n
n
i
i
d
N
N
l
l
l
l
l
l
l
S
l
l
l
T
l
l
l
l
l
l
l
l
l
l
l
N
d
i
i
i
n
n
L
L
"}
(24,1,1) = {"
L
L
L
L
n
n
i
i
i
d
N
N
l
l
l
C
l
l
l
l
l
l
l
T
l
l
l
l
l
l
l
l
l
l
l
N
d
i
i
i
n
n
L
L
"}
(25,1,1) = {"
L
L
L
L
n
n
i
i
i
d
N
N
R
l
l
l
l
l
l
l
l
l
o
T
l
l
l
l
l
l
l
l
l
l
l
N
d
i
i
n
n
n
L
L
"}
(26,1,1) = {"
L
L
L
L
n
n
n
i
i
d
N
N
l
l
l
l
l
l
l
l
l
l
l
T
l
l
l
l
l
C
l
l
C
l
l
N
d
i
i
i
n
n
L
L
"}
(27,1,1) = {"
L
L
L
L
L
n
n
i
i
d
N
N
l
l
l
l
l
l
l
l
Y
w
w
k
l
C
l
l
l
l
l
l
l
l
l
N
d
i
i
n
n
n
L
L
"}
(28,1,1) = {"
L
L
L
L
L
n
n
i
i
d
N
N
l
l
l
l
l
l
l
l
T
l
l
l
l
S
l
l
l
l
l
l
l
l
l
N
d
i
i
n
n
L
L
L
"}
(29,1,1) = {"
L
L
L
L
L
n
n
i
i
d
N
N
l
l
l
l
E
o
l
l
T
C
l
l
l
l
l
l
l
Z
l
l
l
l
N
N
d
i
i
n
n
L
L
L
"}
(30,1,1) = {"
L
L
L
L
L
n
n
i
i
d
N
N
N
l
l
S
l
l
l
l
T
l
l
l
l
l
l
l
l
l
l
l
l
N
N
N
d
i
i
n
n
L
L
L
"}
(31,1,1) = {"
L
L
L
L
L
n
n
i
i
d
d
N
N
N
l
l
l
l
l
l
T
l
l
l
l
o
l
l
S
l
l
l
N
N
N
d
d
i
i
n
n
L
L
L
"}
(32,1,1) = {"
L
L
L
L
L
n
n
i
i
i
d
d
N
N
N
l
l
l
l
l
T
l
l
l
S
C
l
l
l
l
l
N
N
N
d
d
i
i
i
n
n
L
L
L
"}
(33,1,1) = {"
L
L
L
L
L
n
n
i
i
i
i
d
d
N
N
N
l
l
S
Q
k
l
l
l
l
l
l
l
l
l
N
N
N
d
d
i
i
i
i
n
n
L
L
L
"}
(34,1,1) = {"
L
L
L
L
L
n
n
n
i
i
i
i
d
d
N
N
N
N
l
U
l
P
l
l
l
l
l
l
S
N
N
N
d
d
i
i
i
i
n
n
n
L
L
L
"}
(35,1,1) = {"
L
L
L
L
L
L
n
n
n
n
i
i
i
d
d
N
N
N
N
O
N
N
N
N
N
N
N
N
N
N
N
d
d
i
i
i
i
h
n
n
n
L
L
L
"}
(36,1,1) = {"
L
L
L
L
L
L
n
n
n
n
n
i
i
i
d
d
N
N
N
O
N
N
N
N
N
N
N
N
N
N
d
d
i
i
i
i
n
n
n
h
n
n
L
L
"}
(37,1,1) = {"
L
L
L
L
L
L
L
L
n
n
n
i
i
i
i
d
d
d
d
O
d
d
d
d
d
d
d
d
d
d
d
i
i
i
i
i
i
n
n
n
n
n
L
L
"}
(38,1,1) = {"
L
L
L
L
L
L
L
L
L
n
n
n
i
i
i
i
i
i
i
e
F
F
y
a
a
a
a
a
J
i
i
i
i
i
i
z
n
n
n
n
n
n
L
L
"}
(39,1,1) = {"
L
L
L
L
L
L
L
L
L
L
n
n
n
n
i
i
i
i
i
i
i
i
i
i
i
i
i
i
B
a
a
a
a
a
a
a
j
j
r
n
n
n
L
L
"}
(40,1,1) = {"
L
L
L
L
L
L
L
L
L
L
L
n
n
n
n
n
i
i
i
i
i
i
i
i
i
i
i
i
i
i
i
i
i
i
i
i
n
n
n
n
n
L
L
L
"}
(41,1,1) = {"
L
L
L
L
L
L
L
L
L
L
L
L
L
n
n
n
n
i
i
i
n
n
n
n
n
n
n
i
i
i
i
i
i
i
i
i
n
V
n
n
L
L
L
L
"}
(42,1,1) = {"
L
L
L
L
L
L
L
L
L
L
L
L
L
L
L
n
n
n
n
n
n
n
n
n
n
n
n
n
n
n
n
n
n
n
n
n
n
n
n
n
L
L
L
L
"}
