// This map has been converted using maphash
"aaY" = (/obj/machinery/light/small{dir = 1},/turf/open/floor/plasteel/freezer,/area/ruin/powered/gluttony)
"bHl" = (/obj/item/trash/semki,/turf/open/floor/plasteel/freezer,/area/ruin/powered/gluttony)
"cmG" = (/obj/machinery/light/small{dir = 4},/turf/open/floor/plasteel/freezer,/area/ruin/powered/gluttony)
"eWd" = (/obj/machinery/door/airlock/uranium,/obj/structure/fans/tiny/invisible,/turf/open/floor/plasteel/freezer,/area/ruin/powered/gluttony)
"gnn" = (/obj/item/veilrender/vealrender,/turf/open/floor/plasteel/freezer,/area/ruin/powered/gluttony)
"gBx" = (/obj/item/trash/plate,/obj/machinery/light/small{dir = 8},/turf/open/floor/plasteel/freezer,/area/ruin/powered/gluttony)
"hmI" = (/turf/open/lava/smooth/lava_land_surface,/area/lavaland/surface/outdoors)
"hGP" = (/obj/item/trash/syndi_cakes,/turf/open/floor/plasteel/freezer,/area/ruin/powered/gluttony)
"ikU" = (/turf/closed/mineral/volcanic/lava_land_surface,/area/lavaland/surface/outdoors)
"iom" = (/obj/item/reagent_containers/syringe/gluttony,/turf/open/floor/plasteel/freezer,/area/ruin/powered/gluttony)
"mlx" = (/obj/item/trash/plate,/turf/open/floor/plasteel/freezer,/area/ruin/powered/gluttony)
"myZ" = (/obj/item/trash/pistachios,/turf/open/floor/plasteel/freezer,/area/ruin/powered/gluttony)
"okr" = (/obj/item/trash/popcorn,/turf/open/floor/plasteel/freezer,/area/ruin/powered/gluttony)
"oUk" = (/turf/closed/indestructible/riveted/uranium,/area/ruin/powered/gluttony)
"qrg" = (/obj/item/trash/raisins,/turf/open/floor/plasteel/freezer,/area/ruin/powered/gluttony)
"rEH" = (/obj/effect/gluttony,/turf/open/floor/plasteel/freezer,/area/ruin/powered/gluttony)
"rRt" = (/obj/item/trash/candy,/turf/open/floor/plasteel/freezer,/area/ruin/powered/gluttony)
"tik" = (/turf/open/floor/plasteel/freezer,/area/ruin/powered/gluttony)
"tBB" = (/obj/effect/gluttony,/obj/machinery/light/small{dir = 1},/turf/open/floor/plasteel/freezer,/area/ruin/powered/gluttony)
"tHP" = (/obj/machinery/light/small,/turf/open/floor/plasteel/freezer,/area/ruin/powered/gluttony)
"wMC" = (/turf/open/lava/smooth,/area/ruin/powered/gluttony)
"wUl" = (/turf/open/floor/plating/asteroid/basalt/lava_land_surface,/area/lavaland/surface/outdoors)

(1,1,1) = {"
ikU
ikU
ikU
wUl
wUl
ikU
ikU
wUl
ikU
wUl
wUl
wUl
wUl
wUl
wUl
wUl
ikU
ikU
ikU
ikU
"}
(2,1,1) = {"
ikU
ikU
ikU
wUl
wUl
wUl
wUl
wUl
wUl
wUl
wUl
wUl
wUl
wUl
wUl
wUl
ikU
ikU
ikU
ikU
"}
(3,1,1) = {"
wUl
ikU
ikU
ikU
wUl
wUl
wUl
hmI
hmI
hmI
wUl
hmI
hmI
hmI
wUl
wUl
ikU
ikU
ikU
ikU
"}
(4,1,1) = {"
wUl
ikU
ikU
ikU
wUl
wUl
wUl
hmI
oUk
oUk
eWd
oUk
oUk
hmI
wUl
ikU
ikU
ikU
ikU
ikU
"}
(5,1,1) = {"
wUl
wUl
ikU
ikU
ikU
wUl
wUl
hmI
oUk
gnn
tik
okr
oUk
hmI
wUl
ikU
ikU
ikU
ikU
ikU
"}
(6,1,1) = {"
ikU
ikU
ikU
ikU
ikU
wUl
wUl
hmI
oUk
tik
tik
tHP
oUk
hmI
wUl
wUl
wUl
wUl
wUl
ikU
"}
(7,1,1) = {"
ikU
wUl
wUl
wUl
wUl
wUl
wUl
hmI
oUk
tik
rRt
tik
oUk
hmI
wUl
wUl
wUl
wUl
wUl
ikU
"}
(8,1,1) = {"
ikU
wUl
hmI
hmI
hmI
hmI
hmI
hmI
oUk
aaY
tik
qrg
oUk
hmI
hmI
hmI
hmI
hmI
hmI
wUl
"}
(9,1,1) = {"
wUl
wUl
hmI
oUk
oUk
oUk
oUk
oUk
oUk
rEH
qrg
tHP
oUk
oUk
oUk
oUk
oUk
oUk
hmI
wUl
"}
(10,1,1) = {"
ikU
wUl
hmI
oUk
wMC
oUk
tBB
rEH
rEH
rEH
rEH
tik
bHl
tik
gBx
rRt
tik
oUk
hmI
wUl
"}
(11,1,1) = {"
ikU
wUl
hmI
oUk
iom
rEH
rEH
rEH
rEH
rEH
myZ
tik
tik
tik
tik
tik
tik
eWd
wUl
wUl
"}
(12,1,1) = {"
ikU
wUl
hmI
oUk
wMC
oUk
tBB
rEH
rEH
rEH
tik
rEH
tik
rRt
cmG
tik
hGP
oUk
hmI
wUl
"}
(13,1,1) = {"
ikU
wUl
hmI
oUk
oUk
oUk
oUk
oUk
oUk
rEH
tik
tHP
oUk
oUk
oUk
oUk
oUk
oUk
hmI
wUl
"}
(14,1,1) = {"
ikU
wUl
hmI
hmI
hmI
hmI
hmI
hmI
oUk
tBB
tik
tik
oUk
hmI
hmI
hmI
hmI
hmI
hmI
wUl
"}
(15,1,1) = {"
ikU
wUl
wUl
wUl
wUl
wUl
wUl
hmI
oUk
tik
rEH
tik
oUk
hmI
wUl
wUl
wUl
wUl
wUl
wUl
"}
(16,1,1) = {"
wUl
wUl
wUl
ikU
wUl
wUl
wUl
hmI
oUk
mlx
tik
tHP
oUk
hmI
wUl
wUl
wUl
ikU
ikU
ikU
"}
(17,1,1) = {"
wUl
wUl
wUl
ikU
wUl
wUl
wUl
hmI
oUk
tik
myZ
tik
oUk
hmI
wUl
wUl
wUl
ikU
ikU
ikU
"}
(18,1,1) = {"
ikU
ikU
ikU
ikU
wUl
wUl
wUl
hmI
oUk
oUk
eWd
oUk
oUk
hmI
wUl
wUl
wUl
ikU
ikU
ikU
"}
(19,1,1) = {"
ikU
ikU
ikU
ikU
ikU
ikU
ikU
hmI
hmI
hmI
wUl
hmI
hmI
hmI
wUl
wUl
ikU
ikU
ikU
ikU
"}
(20,1,1) = {"
ikU
ikU
ikU
ikU
ikU
ikU
ikU
wUl
wUl
wUl
wUl
wUl
wUl
wUl
ikU
ikU
wUl
ikU
ikU
ikU
"}
