//MAP CONVERTED BY dmm2tgm.py THIS HEADER COMMENT PREVENTS RECONVERSION, DO NOT REMOVE
"aa" = (
/turf/open/lava/smooth/lava_land_surface,
/area/lavaland/surface/outdoors)
"ab" = (
/turf/closed/mineral/volcanic/lava_land_surface,
/area/lavaland/surface/outdoors)
"ac" = (
/turf/open/floor/plating/asteroid/basalt/lava_land_surface,
/area/lavaland/surface/outdoors)
"ad" = (
/turf/closed/mineral/volcanic/lava_land_surface,
/area/ruin/unpowered)
"ae" = (
/turf/closed/wall/mineral/sandstone,
/area/ruin/unpowered)
"ai" = (
/turf/open/floor/plating/asteroid/basalt/lava_land_surface,
/area/ruin/unpowered)
"ao" = (
/obj/structure/spider,
/obj/structure/spider{
	icon_state = "stickyweb2"
	},
/turf/open/floor/plating/asteroid/basalt/lava_land_surface,
/area/ruin/unpowered)
"aq" = (
/obj/effect/mob_spawn/human/skeleton,
/obj/structure/spider{
	icon_state = "stickyweb2"
	},
/obj/structure/spider,
/turf/open/floor/plating/asteroid/basalt/lava_land_surface,
/area/ruin/unpowered)
"at" = (
/obj/structure/spider{
	icon_state = "stickyweb2"
	},
/turf/open/floor/plating/asteroid/basalt/lava_land_surface,
/area/ruin/unpowered)
"av" = (
/mob/living/simple_animal/hostile/asteroid/marrowweaver,
/turf/open/floor/plating/asteroid/basalt/lava_land_surface,
/area/ruin/unpowered)
"aw" = (
/obj/item/kitchen/knife/combat/bone,
/turf/open/floor/plating/asteroid/basalt/lava_land_surface,
/area/ruin/unpowered)
"aD" = (
/obj/structure/spider,
/turf/open/floor/plating/asteroid/basalt/lava_land_surface,
/area/ruin/unpowered)
"aG" = (
/obj/item/reagent_containers/food/snacks/spidereggs,
/turf/open/floor/plating/asteroid/basalt/lava_land_surface,
/area/ruin/unpowered)
"aH" = (
/obj/effect/mob_spawn/human/skeleton,
/obj/structure/spider,
/obj/structure/spider{
	icon_state = "stickyweb2"
	},
/turf/open/floor/plating/asteroid/basalt/lava_land_surface,
/area/ruin/unpowered)
"aI" = (
/obj/effect/mob_spawn/human/skeleton,
/obj/structure/spider{
	icon_state = "stickyweb2"
	},
/turf/open/floor/plating/asteroid/basalt/lava_land_surface,
/area/ruin/unpowered)
"aL" = (
/obj/item/reagent_containers/food/snacks/spiderleg,
/turf/open/floor/plating/asteroid/basalt/lava_land_surface,
/area/ruin/unpowered)
"aM" = (
/obj/item/tank/internals/air,
/turf/open/floor/plating/asteroid/basalt/lava_land_surface,
/area/ruin/unpowered)
"aN" = (
/obj/effect/mob_spawn/human/skeleton,
/obj/item/twohanded/bonespear,
/obj/structure/spider{
	icon_state = "stickyweb2"
	},
/obj/structure/spider,
/turf/open/floor/plating/asteroid/basalt/lava_land_surface,
/area/ruin/unpowered)
"aO" = (
/obj/item/pickaxe/silver,
/turf/open/floor/plating/asteroid/basalt/lava_land_surface,
/area/ruin/unpowered)
"aP" = (
/obj/item/storage/firstaid/toxin,
/turf/open/floor/plating/asteroid/basalt/lava_land_surface,
/area/ruin/unpowered)
"aR" = (
/obj/item/reagent_containers/food/snacks/spidereggs,
/obj/item/reagent_containers/food/snacks/spiderleg,
/turf/open/floor/plating/asteroid/basalt/lava_land_surface,
/area/ruin/unpowered)
"aT" = (
/obj/effect/mob_spawn/human/skeleton,
/obj/item/clothing/suit/armor/bone,
/obj/item/twohanded/fireaxe/boneaxe,
/obj/structure/spider{
	icon_state = "stickyweb2"
	},
/obj/structure/spider,
/turf/open/floor/plating/asteroid/basalt/lava_land_surface,
/area/ruin/unpowered)
"aU" = (
/obj/effect/mob_spawn/human/corpse/nanotrasensoldier,
/obj/item/melee/classic_baton,
/obj/item/gun/ballistic/shotgun/doublebarrel,
/turf/open/floor/plating/asteroid/basalt/lava_land_surface,
/area/ruin/unpowered)
"aV" = (
/obj/structure/spider{
	icon_state = "stickyweb2"
	},
/obj/structure/spider,
/turf/open/floor/plating/asteroid/basalt/lava_land_surface,
/area/ruin/unpowered)
"aW" = (
/obj/item/tank/internals/emergency_oxygen/double,
/turf/open/floor/plating/asteroid/basalt/lava_land_surface,
/area/ruin/unpowered)
"ba" = (
/obj/structure/mineral_door/sandstone,
/turf/open/floor/plasteel,
/area/ruin/unpowered)
"cY" = (
/obj/structure/bed,
/obj/effect/mob_spawn/human/skeleton,
/obj/effect/turf_decal/sand,
/turf/open/floor/plasteel/lavaland,
/area/ruin/unpowered)
"hT" = (
/obj/structure/table,
/obj/item/twohanded/spear,
/obj/effect/turf_decal/sand,
/turf/open/floor/plasteel/lavaland,
/area/ruin/unpowered)
"it" = (
/obj/effect/mob_spawn/human/corpse/syndicatesoldier,
/obj/effect/turf_decal/sand,
/turf/open/floor/plasteel/lavaland,
/area/ruin/unpowered)
"ln" = (
/obj/effect/turf_decal/sand,
/turf/open/floor/plasteel/lavaland,
/area/ruin/unpowered)
"lB" = (
/obj/structure/table,
/obj/item/stack/sheet/animalhide/weaver_chitin,
/obj/effect/turf_decal/sand,
/turf/open/floor/plasteel/lavaland,
/area/ruin/unpowered)
"ni" = (
/obj/structure/spider{
	icon_state = "stickyweb2"
	},
/obj/structure/spider,
/obj/effect/turf_decal/sand,
/turf/open/floor/plasteel/lavaland,
/area/ruin/unpowered)
"qH" = (
/obj/effect/mob_spawn/human/skeleton,
/obj/structure/spider{
	icon_state = "stickyweb2"
	},
/obj/structure/spider,
/obj/structure/spider,
/obj/effect/turf_decal/sand,
/turf/open/floor/plasteel/lavaland,
/area/ruin/unpowered)
"uU" = (
/obj/structure/spider,
/obj/item/gun/energy/kinetic_accelerator,
/obj/structure/spider{
	icon_state = "stickyweb2"
	},
/obj/structure/spider{
	icon_state = "stickyweb2"
	},
/obj/effect/turf_decal/sand,
/obj/item/borg/upgrade/modkit/trigger_guard,
/obj/item/borg/upgrade/modkit/chassis_mod/orange,
/turf/open/floor/plasteel/lavaland,
/area/ruin/unpowered)
"wt" = (
/obj/item/reagent_containers/food/snacks/spidereggs,
/obj/effect/turf_decal/sand,
/turf/open/floor/plasteel/lavaland,
/area/ruin/unpowered)
"zF" = (
/obj/effect/mob_spawn/human/corpse/russian/ranged/trooper,
/obj/effect/turf_decal/sand,
/obj/item/gun/ballistic/rifle/boltaction,
/turf/open/floor/plasteel/lavaland,
/area/ruin/unpowered)
"CS" = (
/obj/effect/mob_spawn/human/skeleton,
/obj/structure/spider{
	icon_state = "stickyweb2"
	},
/obj/structure/spider,
/obj/effect/turf_decal/sand,
/turf/open/floor/plasteel/lavaland,
/area/ruin/unpowered)
"Df" = (
/obj/effect/mob_spawn/human/corpse/damaged{
	gloves = /obj/item/clothing/gloves/yogs/chitinhands;
	shoes = /obj/item/clothing/shoes/yogs/chitintreads;
	suit = /obj/item/clothing/suit/yogs/armor/chitinplate
	},
/obj/item/pickaxe/drill/diamonddrill,
/obj/effect/turf_decal/sand,
/turf/open/floor/plasteel/lavaland,
/area/ruin/unpowered)
"Dz" = (
/obj/effect/mob_spawn/human/corpse/russian/ranged/trooper,
/obj/effect/turf_decal/sand,
/turf/open/floor/plasteel/lavaland,
/area/ruin/unpowered)
"Gi" = (
/obj/effect/mob_spawn/human/corpse/pirate,
/obj/item/melee/transforming/energy/sword/pirate,
/obj/effect/turf_decal/sand,
/turf/open/floor/plasteel/lavaland,
/area/ruin/unpowered)
"GB" = (
/obj/effect/mob_spawn/human/skeleton,
/obj/item/kitchen/knife/combat/bone,
/obj/structure/spider,
/obj/structure/spider{
	icon_state = "stickyweb2"
	},
/obj/effect/turf_decal/sand,
/turf/open/floor/plasteel/lavaland,
/area/ruin/unpowered)
"KZ" = (
/obj/structure/spider{
	icon_state = "stickyweb2"
	},
/obj/effect/turf_decal/sand,
/turf/open/floor/plasteel/lavaland,
/area/ruin/unpowered)
"Mn" = (
/obj/effect/turf_decal/sand,
/mob/living/simple_animal/hostile/asteroid/marrowweaver,
/turf/open/floor/plasteel/lavaland,
/area/ruin/unpowered)
"Nh" = (
/obj/structure/spider{
	icon_state = "stickyweb2"
	},
/obj/structure/spider{
	icon_state = "stickyweb2"
	},
/obj/effect/turf_decal/sand,
/turf/open/floor/plasteel/lavaland,
/area/ruin/unpowered)
"NX" = (
/obj/effect/mob_spawn/human/clown,
/obj/effect/turf_decal/sand,
/turf/open/floor/plasteel/lavaland,
/area/ruin/unpowered)
"PC" = (
/obj/structure/spider,
/obj/structure/spider{
	icon_state = "stickyweb2"
	},
/obj/effect/turf_decal/sand,
/turf/open/floor/plasteel/lavaland,
/area/ruin/unpowered)
"Rd" = (
/obj/effect/mob_spawn/human/corpse/russian/ranged,
/obj/item/storage/firstaid,
/obj/effect/turf_decal/sand,
/turf/open/floor/plasteel/lavaland,
/area/ruin/unpowered)
"Um" = (
/obj/effect/mob_spawn/human/corpse/nanotrasensoldier,
/obj/effect/turf_decal/sand,
/turf/open/floor/plasteel/lavaland,
/area/ruin/unpowered)
"VI" = (
/obj/effect/mob_spawn/human/skeleton,
/obj/structure/spider{
	icon_state = "stickyweb2"
	},
/obj/structure/spider,
/obj/structure/spider{
	icon_state = "stickyweb2"
	},
/obj/effect/turf_decal/sand,
/turf/open/floor/plasteel/lavaland,
/area/ruin/unpowered)
"Wq" = (
/obj/structure/spider,
/obj/effect/turf_decal/sand,
/turf/open/floor/plasteel/lavaland,
/area/ruin/unpowered)
"WE" = (
/obj/item/reagent_containers/food/snacks/spiderleg,
/obj/effect/turf_decal/sand,
/turf/open/floor/plasteel/lavaland,
/area/ruin/unpowered)
"WY" = (
/obj/item/storage/firstaid/regular,
/obj/effect/turf_decal/sand,
/turf/open/floor/plasteel/lavaland,
/area/ruin/unpowered)
"Zs" = (
/obj/item/reagent_containers/spray/spraytan,
/obj/effect/turf_decal/sand,
/turf/open/floor/plasteel/lavaland,
/area/ruin/unpowered)

(1,1,1) = {"
aa
aa
aa
aa
aa
ab
aa
aa
aa
aa
ab
aa
ac
ac
ac
ac
ac
aa
aa
aa
aa
aa
aa
aa
ab
ac
aa
aa
aa
aa
aa
aa
aa
aa
aa
"}
(2,1,1) = {"
aa
aa
aa
ab
aa
aa
aa
aa
aa
aa
aa
aa
aa
aa
ac
ac
ac
ae
aa
aa
aa
aa
aa
aa
aa
aa
aa
ab
ab
aa
aa
aa
aa
aa
aa
"}
(3,1,1) = {"
aa
ab
aa
aa
aa
ac
ac
ab
ab
aa
ab
aa
aa
aa
aa
ad
KZ
Wq
ad
aa
aa
ad
aa
aa
ab
aa
aa
aa
ac
aa
ab
ab
aa
aa
aa
"}
(4,1,1) = {"
aa
ab
aa
aa
aa
ac
ac
aa
aa
aa
ac
aa
aa
ad
aa
ae
KZ
PC
PC
ad
aa
ad
ac
ac
aa
ad
aa
aa
aa
aa
aa
aa
aa
aa
ab
"}
(5,1,1) = {"
aa
aa
aa
aa
ad
ac
aa
aa
ad
ad
ad
ac
ac
ad
ad
ad
ad
KZ
Wq
ae
ad
ad
ac
ad
aa
ad
ac
ac
ad
aa
aa
aa
aa
aa
aa
"}
(6,1,1) = {"
aa
aa
aa
aa
ad
ad
ad
ad
ad
ad
ad
ad
aa
ad
ai
at
ad
ln
ln
ad
ad
ad
ad
ad
ad
ad
ad
ad
ad
ad
ac
ac
ab
aa
aa
"}
(7,1,1) = {"
aa
aa
aa
aa
ad
ad
ae
ae
ae
ae
ae
ae
ad
ad
at
ad
ad
ad
ln
ad
ad
ad
ad
ad
aU
ad
ad
ad
ad
ad
aa
aa
aa
ab
ab
"}
(8,1,1) = {"
ab
aa
aa
ac
ad
ae
it
Gi
ae
Um
Rd
ae
ad
at
ai
ai
ai
ad
ai
aD
ad
ad
aD
aD
aV
aD
ad
ad
ad
ad
ad
ad
ae
ae
aa
"}
(9,1,1) = {"
aa
aa
aa
aa
ac
ae
ni
ni
PC
ni
ni
zF
ae
ad
ad
ai
ai
ao
ai
aN
ai
ai
ai
ad
wt
ad
ad
ad
ad
ad
ae
hT
lB
ae
aa
"}
(10,1,1) = {"
aa
aa
aa
ad
ad
ae
ln
ln
ln
Mn
PC
ae
ad
ad
ad
ad
ao
av
aD
ao
ad
ad
ai
ad
ai
ad
ad
ad
ad
ad
ae
ln
ln
ae
aa
"}
(11,1,1) = {"
aa
ab
aa
ac
ac
ae
ln
NX
Mn
Zs
PC
ae
ae
aG
at
ln
Wq
ai
ai
aO
ad
wt
ai
ad
at
aD
ad
ad
ad
ad
ae
cY
ln
ae
aa
"}
(12,1,1) = {"
aa
aa
aa
aa
ad
ae
ln
ln
ln
PC
ni
Dz
ae
ai
aD
ai
ao
ai
ai
ai
ai
ai
ad
ad
ai
ad
ad
ad
ad
ad
ad
ae
ba
ae
aa
"}
(13,1,1) = {"
aa
aa
aa
aa
aa
ae
ad
ln
ln
ad
Df
ae
ad
ad
at
ai
ad
ad
ad
aI
ad
ad
ad
aT
ao
ad
ad
ad
ad
ad
ac
ac
ac
ac
ac
"}
(14,1,1) = {"
aa
aa
aa
aa
ad
ad
ae
ad
at
ae
ae
ad
ad
ad
ai
av
ad
ad
ad
aP
ln
av
ao
aD
ao
ad
ad
ae
ae
ai
ac
ac
ac
ac
ac
"}
(15,1,1) = {"
aa
ab
aa
ad
ad
ad
ai
ad
ln
av
ad
ad
ad
at
ao
ln
ln
aL
aw
ln
WE
ad
ad
ad
ai
KZ
ao
ln
KZ
ai
ai
ac
ac
ac
ac
"}
(16,1,1) = {"
aa
aa
aa
aa
ad
ad
ai
ai
ai
ai
ad
aG
ad
ai
aI
ad
at
ad
aG
ao
ao
ad
ad
ad
aD
ad
ad
ae
ad
ad
ad
ac
ac
ac
aa
"}
(17,1,1) = {"
aa
aa
aa
aa
aa
ad
ai
ad
at
ad
ad
ln
ln
ai
ai
at
ai
ad
ad
ao
ai
ai
ad
ai
ln
ad
ad
ad
ad
ad
ac
ac
aa
aa
aa
"}
(18,1,1) = {"
aa
aa
aa
ad
ad
ad
ai
ad
KZ
ad
ad
ai
ad
ad
at
at
ai
aD
aM
ai
ln
ai
aD
ln
ai
ad
ad
ad
ad
ad
ad
ad
aa
aa
aa
"}
(19,1,1) = {"
aa
ab
aa
ad
ad
ad
ae
ad
ln
ai
ae
ln
ad
at
av
ad
ai
ad
ad
ai
ad
ad
ad
at
ad
ad
ad
ad
ad
ad
ad
ac
aa
aa
aa
"}
(20,1,1) = {"
aa
ab
aa
aa
aa
ae
ad
ai
ln
ad
ad
ad
ad
ad
ao
aD
ai
ad
aD
aD
ad
ai
aD
ai
ad
at
aG
ad
aa
aa
aa
aa
aa
aa
aa
"}
(21,1,1) = {"
aa
aa
aa
aa
ad
ae
uU
ao
ai
Wq
ln
ad
ad
aH
ln
ln
Mn
at
ai
ln
ai
aR
ad
ai
at
ai
ad
ad
ad
aa
aa
aa
aa
aa
aa
"}
(22,1,1) = {"
ab
aa
aa
ad
ad
ae
Nh
VI
ai
CS
ln
ao
ai
ao
WE
WY
ai
ad
ad
ad
ad
ad
ad
ad
ai
ad
ad
ad
ad
aa
ab
ab
ab
ab
aa
"}
(23,1,1) = {"
aa
aa
aa
aa
ad
ad
ai
ln
av
ln
ai
ao
ad
ad
ad
aH
at
ad
ad
ad
ad
PC
ai
aD
aD
ad
ad
ad
ad
aa
aa
ac
ab
ab
aa
"}
(24,1,1) = {"
aa
aa
aa
aa
aa
ae
ad
ai
aw
av
ai
ad
ad
ad
ad
ai
ai
aD
ad
ao
ai
ln
ad
ad
ai
aD
ad
ad
aa
aa
aa
ab
ac
aa
aa
"}
(25,1,1) = {"
aa
ab
aa
ad
ad
ad
Wq
aq
ai
aw
ln
ln
ae
ad
ad
ad
aD
ai
ad
ai
ln
ln
ad
aD
ai
ln
ai
ad
ad
aa
aa
aa
aa
aa
aa
"}
(26,1,1) = {"
aa
aa
ac
ac
ad
ad
ad
Wq
ai
qH
aD
Wq
ad
aG
at
ai
at
ai
at
av
ad
ln
ai
ai
ad
ai
at
ae
ad
aa
aa
aa
aa
aa
aa
"}
(27,1,1) = {"
aa
aa
ac
ac
ac
ad
ad
ai
Mn
ai
ai
ad
ad
at
ad
aG
ad
ai
at
ad
ad
GB
ln
ai
ad
ad
at
ad
ad
ad
ad
ad
aa
ab
aa
"}
(28,1,1) = {"
aa
ab
aa
aa
aa
ae
ln
ln
ai
ai
ln
ln
ad
ad
ad
ad
ad
ad
ad
ad
ad
ad
PC
ad
ad
ad
ai
aD
aW
ad
ad
aa
aa
aa
aa
"}
(29,1,1) = {"
aa
ab
aa
aa
ad
ad
ad
ad
ae
ae
ad
ad
ad
ad
ad
ad
ad
ad
ad
ad
ad
ad
ln
ad
ad
ad
ad
ad
ad
ad
aa
ab
aa
aa
aa
"}
(30,1,1) = {"
aa
aa
aa
ab
aa
aa
aa
ad
aa
aa
ac
ad
aa
aa
aa
aa
ac
aa
ad
ad
ad
ad
ln
ad
ad
ad
ad
ad
aa
aa
aa
ac
aa
aa
aa
"}
(31,1,1) = {"
ab
aa
aa
aa
ab
ac
ac
aa
aa
aa
aa
ac
aa
aa
aa
ab
ab
ab
ac
ad
ai
ai
ai
ai
ad
ad
ad
ad
aa
ac
aa
aa
ab
aa
aa
"}
(32,1,1) = {"
aa
aa
aa
aa
aa
aa
aa
aa
aa
aa
aa
aa
ab
aa
aa
aa
aa
aa
aa
aa
aa
ac
ac
ac
ac
ac
ad
aa
aa
aa
ab
aa
ab
aa
aa
"}
(33,1,1) = {"
aa
ab
aa
aa
ab
aa
aa
aa
aa
ab
aa
aa
ab
aa
aa
aa
aa
aa
aa
aa
aa
ac
ac
ac
aa
aa
aa
ac
ac
aa
aa
aa
ab
aa
aa
"}
(34,1,1) = {"
aa
aa
aa
aa
ab
aa
aa
aa
aa
aa
aa
aa
aa
aa
ab
aa
aa
aa
aa
aa
aa
ac
ac
ac
aa
aa
aa
ab
aa
ab
aa
aa
aa
aa
aa
"}
(35,1,1) = {"
aa
aa
aa
aa
ab
aa
aa
aa
ab
aa
aa
aa
aa
aa
aa
aa
aa
aa
aa
aa
ac
ac
ac
aa
aa
aa
aa
aa
aa
aa
aa
aa
aa
aa
aa
"}
