//MAP CONVERTED BY dmm2tgm.py THIS HEADER COMMENT PREVENTS RECONVERSION, DO NOT REMOVE
"a" = (
/turf/open/lava/smooth/lava_land_surface,
/area/lavaland/surface/outdoors)
"b" = (
/turf/closed/wall/mineral/iron,
/area/ruin/unpowered)
"c" = (
/obj/structure/closet/crate/coffin,
/obj/effect/mob_spawn/human/skeleton,
/turf/open/floor/plasteel/dark,
/area/ruin/unpowered)
"d" = (
/obj/structure/closet/crate/coffin,
/obj/effect/mob_spawn/human/skeleton,
/obj/item/shield/riot/buckler,
/turf/open/floor/plasteel/dark,
/area/ruin/unpowered)
"e" = (
/obj/structure/closet/crate/coffin,
/obj/item/shield/riot/buckler,
/obj/item/twohanded/spear,
/turf/open/floor/plasteel/dark,
/area/ruin/unpowered)
"f" = (
/obj/structure/closet/crate/coffin,
/obj/effect/mob_spawn/human/skeleton,
/obj/item/twohanded/spear,
/turf/open/floor/plasteel/dark,
/area/ruin/unpowered)
"g" = (
/obj/structure/closet/crate/coffin,
/obj/effect/decal/cleanable/dirt,
/turf/open/floor/plasteel/dark,
/area/ruin/unpowered)
"h" = (
/turf/open/floor/plasteel/dark,
/area/ruin/unpowered)
"i" = (
/obj/effect/decal/cleanable/dirt,
/turf/open/floor/plasteel/dark,
/area/ruin/unpowered)
"j" = (
/mob/living/simple_animal/hostile/skeleton/eskimo,
/turf/open/floor/plasteel/dark,
/area/ruin/unpowered)
"k" = (
/obj/structure/mineral_door/iron,
/obj/structure/fans/tiny/invisible,
/turf/open/floor/plasteel/dark,
/area/ruin/unpowered)
"l" = (
/obj/effect/decal/remains/human,
/turf/open/floor/plasteel/dark,
/area/ruin/unpowered)
"m" = (
/obj/effect/decal/cleanable/blood/old,
/obj/effect/decal/cleanable/blood/old,
/turf/open/floor/plasteel/dark,
/area/ruin/unpowered)
"n" = (
/mob/living/simple_animal/hostile/skeleton/templar{
	speak = list("THE NECROPOLIS WILLS IT!","DEUS VULT!","REMOVE KABAB!");
	speak_chance = 0
	},
/turf/open/floor/plasteel/dark,
/area/ruin/unpowered)
"o" = (
/obj/effect/decal/cleanable/blood/old,
/turf/open/floor/plasteel/dark,
/area/ruin/unpowered)
"p" = (
/obj/effect/mob_spawn/human/skeleton,
/turf/open/floor/plasteel/dark,
/area/ruin/unpowered)
"q" = (
/obj/effect/decal/cleanable/dirt,
/obj/effect/decal/remains/human,
/turf/open/floor/plasteel/dark,
/area/ruin/unpowered)
"r" = (
/obj/structure/closet/crate/coffin,
/obj/effect/mob_spawn/human/skeleton,
/obj/effect/decal/cleanable/dirt,
/turf/open/floor/plasteel/dark,
/area/ruin/unpowered)
"s" = (
/obj/structure/closet/crate/coffin,
/obj/effect/decal/cleanable/dirt,
/obj/item/shield/riot/buckler,
/obj/item/twohanded/spear,
/turf/open/floor/plasteel/dark,
/area/ruin/unpowered)
"t" = (
/obj/structure/closet/crate/coffin,
/turf/open/floor/plasteel/dark,
/area/ruin/unpowered)
"u" = (
/obj/structure/mineral_door/gold,
/obj/structure/fans/tiny/invisible,
/turf/open/floor/plasteel/dark,
/area/ruin/unpowered)
"v" = (
/obj/structure/mineral_door/iron,
/obj/structure/fans/tiny/invisible,
/turf/open/lava/smooth/lava_land_surface,
/area/ruin/unpowered)
"w" = (
/obj/item/stack/sheet/mineral/gold,
/turf/open/floor/plasteel/dark,
/area/ruin/unpowered)
"x" = (
/obj/item/slimecross/industrial/silver,
/turf/open/floor/plasteel/dark,
/area/ruin/unpowered)
"y" = (
/obj/structure/closet/crate/coffin,
/obj/item/immortality_talisman,
/obj/effect/mob_spawn/human/skeleton,
/turf/open/floor/mineral/diamond,
/area/ruin/unpowered)
"z" = (
/obj/structure/table,
/obj/item/wisp_lantern,
/obj/structure/sign/warning/securearea{
	desc = "Under the painting a plaque reads: 'While the meat grinder may not have spared you, fear not. Not one part of you has gone to waste... You were delicious.'";
	icon_state = "monkey_painting";
	name = "Mr. Deempisi portrait";
	pixel_x = 0;
	pixel_y = 28
	},
/turf/open/floor/mineral/diamond,
/area/ruin/unpowered)
"A" = (
/obj/structure/table,
/obj/item/necromantic_stone,
/obj/item/stack/sheet/mineral/diamond,
/turf/open/floor/mineral/diamond,
/area/ruin/unpowered)
"B" = (
/obj/effect/decal/cleanable/dirt,
/obj/item/slimecross/industrial/silver,
/obj/item/slimecross/industrial/silver,
/turf/open/floor/plasteel/dark,
/area/ruin/unpowered)
"C" = (
/obj/effect/decal/cleanable/dirt,
/turf/open/floor/mineral/diamond,
/area/ruin/unpowered)
"D" = (
/obj/item/chair,
/turf/open/floor/mineral/diamond,
/area/ruin/unpowered)
"E" = (
/obj/structure/table,
/obj/item/book/codex_gigas,
/turf/open/floor/mineral/diamond,
/area/ruin/unpowered)
"F" = (
/mob/living/simple_animal/hostile/skeleton,
/turf/open/floor/plasteel/dark,
/area/ruin/unpowered)
"G" = (
/obj/structure/mineral_door/transparent/diamond,
/obj/structure/fans/tiny/invisible,
/turf/open/floor/mineral/diamond,
/area/ruin/unpowered)
"H" = (
/obj/item/stack/sheet/mineral/silver,
/turf/open/floor/plasteel/dark,
/area/ruin/unpowered)
"I" = (
/obj/effect/decal/cleanable/dirt,
/obj/effect/decal/remains/human,
/obj/item/coin/gold,
/turf/open/floor/plasteel/dark,
/area/ruin/unpowered)
"J" = (
/obj/effect/decal/cleanable/blood/old,
/obj/item/stack/sheet/mineral/gold,
/turf/open/floor/plasteel/dark,
/area/ruin/unpowered)
"K" = (
/obj/effect/decal/cleanable/dirt,
/mob/living/simple_animal/hostile/skeleton,
/turf/open/floor/plasteel/dark,
/area/ruin/unpowered)
"L" = (
/obj/structure/table,
/obj/item/flashlight/lantern,
/turf/open/floor/plasteel/dark,
/area/ruin/unpowered)
"M" = (
/obj/structure/table,
/obj/item/twohanded/spear,
/turf/open/floor/plasteel/dark,
/area/ruin/unpowered)
"N" = (
/obj/item/coin/gold,
/turf/open/floor/plasteel/dark,
/area/ruin/unpowered)
"O" = (
/turf/template_noop,
/area/lavaland/surface/outdoors)
"P" = (
/turf/open/floor/plating/asteroid/basalt/lava_land_surface,
/area/lavaland/surface/outdoors)
"R" = (
/obj/effect/decal/remains/human,
/turf/open/floor/plating/asteroid/basalt/lava_land_surface,
/area/lavaland/surface/outdoors)
"S" = (
/obj/effect/mob_spawn/human/skeleton,
/turf/open/floor/plating/asteroid/basalt/lava_land_surface,
/area/lavaland/surface/outdoors)
"T" = (
/turf/open/floor/plasteel/dark/lavaland,
/area/lavaland/surface/outdoors)
"U" = (
/turf/open/floor/plasteel/dark/lavaland,
/area/ruin/unpowered)

(1,1,1) = {"
a
a
a
a
a
a
a
a
a
a
a
a
a
a
a
a
a
a
a
a
a
O
O
O
O
O
O
O
"}
(2,1,1) = {"
a
b
b
b
a
b
a
b
a
b
a
b
a
b
a
b
a
b
b
b
a
O
O
O
O
O
O
O
"}
(3,1,1) = {"
a
b
b
b
b
b
b
b
b
b
b
b
b
b
b
b
b
b
b
b
a
O
O
O
O
O
O
O
"}
(4,1,1) = {"
a
b
b
b
b
b
b
b
b
b
b
b
b
b
b
b
b
b
b
b
a
O
O
O
O
O
O
O
"}
(5,1,1) = {"
a
a
b
b
c
h
i
i
h
u
h
h
h
h
I
h
N
b
b
a
a
O
P
P
P
P
P
O
"}
(6,1,1) = {"
a
b
b
b
d
h
i
l
h
u
h
i
n
h
i
n
h
b
b
b
a
P
P
R
P
R
P
O
"}
(7,1,1) = {"
a
a
b
b
b
b
k
b
b
b
h
x
o
b
J
h
i
b
b
a
a
P
P
R
R
P
R
O
"}
(8,1,1) = {"
a
b
b
b
e
h
i
h
r
b
w
h
n
b
h
p
h
b
b
b
a
P
P
S
R
P
P
O
"}
(9,1,1) = {"
a
a
b
b
b
i
l
h
b
b
x
B
w
H
n
h
x
b
b
a
a
P
P
R
S
R
P
O
"}
(10,1,1) = {"
a
b
b
b
f
h
m
i
s
b
h
h
x
i
h
H
N
b
b
b
a
P
P
T
P
P
O
O
"}
(11,1,1) = {"
a
a
b
b
b
h
n
h
b
b
b
b
b
n
b
b
b
b
b
a
a
P
P
P
T
O
O
O
"}
(12,1,1) = {"
a
b
b
b
d
h
i
h
f
b
y
C
b
i
b
L
i
b
b
b
a
P
P
P
P
O
O
O
"}
(13,1,1) = {"
a
a
b
b
b
h
h
h
b
b
z
D
G
h
b
i
h
b
b
U
U
P
P
T
P
O
O
O
"}
(14,1,1) = {"
a
b
b
b
g
h
h
h
t
b
A
E
b
b
b
M
h
k
U
U
U
T
T
T
O
O
O
O
"}
(15,1,1) = {"
a
a
b
b
b
b
k
b
b
b
b
b
b
b
b
b
k
b
b
U
U
P
P
P
O
O
O
O
"}
(16,1,1) = {"
a
b
b
b
h
h
h
h
h
v
o
h
h
h
h
i
h
b
b
b
a
P
P
P
O
O
O
O
"}
(17,1,1) = {"
a
a
b
b
h
i
o
j
i
b
h
h
q
F
h
h
h
b
b
a
a
O
O
O
O
O
O
O
"}
(18,1,1) = {"
a
b
b
b
h
j
p
h
h
b
h
F
h
b
h
F
h
b
b
b
a
O
O
O
O
O
O
O
"}
(19,1,1) = {"
a
a
b
b
i
h
i
q
h
k
h
i
o
b
h
p
i
b
b
a
a
O
O
O
O
O
O
O
"}
(20,1,1) = {"
a
b
b
b
h
h
j
h
h
b
h
F
h
h
h
h
h
b
b
b
a
O
O
O
O
O
O
O
"}
(21,1,1) = {"
a
a
b
b
h
i
h
h
h
v
h
h
h
h
K
h
h
b
b
a
a
O
O
O
O
O
O
O
"}
(22,1,1) = {"
a
b
b
b
b
b
b
b
b
b
b
b
b
b
b
b
b
b
b
b
a
O
O
O
O
O
O
O
"}
(23,1,1) = {"
a
b
b
b
b
b
b
b
b
b
b
b
b
b
b
b
b
b
b
b
a
O
O
O
O
O
O
O
"}
(24,1,1) = {"
a
b
b
b
a
b
a
b
a
b
a
b
a
b
a
b
a
b
b
b
a
O
O
O
O
O
O
O
"}
(25,1,1) = {"
a
a
a
a
a
a
a
a
a
a
a
a
a
a
a
a
a
a
a
a
a
O
O
O
O
O
O
O
"}
