// This map has been converted using maphash
"aSy" = (/obj/item/paper/crumpled/bloody{info = "Week 2, day 6. <B>Success!<B> I've managed to synthesize a small amount of solid plasma! The block I created took days to stabilize and cool down, but after running some tests it's exceeding all my expectactions. I'll have to refine the process more before sending a sample to Centcom, but soon we won't have to waste thousands of credits sending those miners to work in this... hellscape anymore. The rest of my mineral samples remained stable too. I'll just have to hope those Space Pirates won't track me down after I stole their trisulfideoxide again... I've hidden the recipe in the safe for now. Code is 8124."},/obj/effect/decal/cleanable/blood,/turf/open/floor/plating,/area/lavaland/surface/outdoors)
"cga" = (/obj/structure/table,/obj/item/stack/cable_coil/yellow,/obj/effect/turf_decal/tile/blue{dir = 4; icon_state = "tile_corner"},/obj/effect/turf_decal/tile/blue{dir = 8; icon_state = "tile_corner"},/turf/open/floor/plasteel/white,/area/ruin/powered)
"cBD" = (/obj/effect/turf_decal/tile/blue{dir = 4; icon_state = "tile_corner"},/obj/effect/turf_decal/tile/blue{dir = 8; icon_state = "tile_corner"},/turf/open/floor/plasteel/white,/area/ruin/powered)
"cDr" = (/obj/structure/table,/obj/effect/turf_decal/tile/blue{dir = 4; icon_state = "tile_corner"},/obj/effect/turf_decal/tile/blue{dir = 8; icon_state = "tile_corner"},/obj/item/reagent_containers/glass/bottle/plasma,/obj/item/reagent_containers/glass/bottle/plasma,/turf/open/floor/plasteel/white,/area/ruin/powered)
"dmT" = (/obj/structure/cable/yellow{icon_state = "1-2"},/obj/structure/cable/yellow{icon_state = "2-8"},/turf/open/floor/plating,/area/ruin/powered)
"dpE" = (/obj/item/clothing/under/pirate,/obj/effect/decal/cleanable/blood,/turf/open/floor/plating,/area/lavaland/surface/outdoors)
"drG" = (/turf/closed/wall/r_wall,/area/ruin/powered)
"eFH" = (/obj/effect/turf_decal/tile/blue{dir = 4; icon_state = "tile_corner"},/obj/effect/turf_decal/tile/blue{dir = 8; icon_state = "tile_corner"},/mob/living/simple_animal/hostile/pirate,/turf/open/floor/plasteel/white,/area/ruin/powered)
"eUs" = (/obj/structure/table,/obj/item/stack/sheet/mineral/plasma,/obj/item/stack/sheet/mineral/plasma{pixel_x = -6; pixel_y = 1},/obj/item/stack/sheet/mineral/plasma{pixel_x = 3},/obj/effect/turf_decal/tile/blue{dir = 4; icon_state = "tile_corner"},/obj/effect/turf_decal/tile/blue{dir = 8; icon_state = "tile_corner"},/turf/open/floor/plasteel/white,/area/ruin/powered)
"fDs" = (/obj/machinery/door/airlock/hatch,/obj/structure/fans/tiny,/turf/open/floor/plating,/area/ruin/powered)
"gyj" = (/obj/structure/table,/obj/item/stack/sheet/mineral/gold{pixel_y = 4},/obj/item/stack/sheet/mineral/gold,/obj/effect/turf_decal/tile/blue{dir = 4; icon_state = "tile_corner"},/obj/effect/turf_decal/tile/blue{dir = 8; icon_state = "tile_corner"},/turf/open/floor/plasteel/white,/area/ruin/powered)
"huy" = (/turf/open/floor/plating,/area/ruin/powered)
"hPd" = (/obj/effect/decal/cleanable/blood,/obj/effect/turf_decal/tile/blue{dir = 4; icon_state = "tile_corner"},/obj/effect/turf_decal/tile/blue{dir = 8; icon_state = "tile_corner"},/turf/open/floor/plasteel/white,/area/ruin/powered)
"idL" = (/turf/open/floor/plating,/area/lavaland/surface/outdoors)
"ikU" = (/turf/closed/mineral/volcanic/lava_land_surface,/area/lavaland/surface/outdoors)
"izb" = (/obj/structure/closet/wardrobe/chemistry_white,/obj/effect/turf_decal/tile/blue{dir = 4; icon_state = "tile_corner"},/obj/effect/turf_decal/tile/blue{dir = 8; icon_state = "tile_corner"},/turf/open/floor/plasteel/white,/area/ruin/powered)
"iVZ" = (/obj/structure/cable/yellow{icon_state = "0-2"},/obj/machinery/light{dir = 4; icon_state = "tube1"},/turf/open/floor/plating,/area/ruin/powered)
"iWo" = (/obj/item/stack/sheet/metal,/turf/open/floor/plating,/area/lavaland/surface/outdoors)
"jcJ" = (/obj/item/clothing/head/helmet/space/pirate,/turf/open/floor/plating,/area/lavaland/surface/outdoors)
"jRc" = (/obj/item/wrench,/turf/open/floor/plating,/area/lavaland/surface/outdoors)
"kxL" = (/turf/open/floor/mineral/plastitanium/red,/area/ruin/powered)
"lcs" = (/obj/machinery/power/port_gen/pacman{sheets = 100},/obj/structure/cable/yellow,/turf/open/floor/plating,/area/ruin/powered)
"mIg" = (/obj/machinery/chem_heater,/obj/structure/cable/yellow{icon_state = "0-4"},/obj/structure/cable/yellow{icon_state = "4-8"},/turf/open/floor/plating,/area/ruin/powered)
"oTs" = (/obj/structure/lattice,/turf/open/floor/plating/asteroid/basalt/lava_land_surface,/area/lavaland/surface/outdoors)
"oXK" = (/obj/structure/table,/obj/item/stack/sheet/mineral/silver,/obj/effect/turf_decal/tile/blue{dir = 4; icon_state = "tile_corner"},/obj/effect/turf_decal/tile/blue{dir = 8; icon_state = "tile_corner"},/turf/open/floor/plasteel/white,/area/ruin/powered)
"oZC" = (/obj/machinery/chem_dispenser,/obj/structure/cable/yellow{icon_state = "0-4"},/obj/structure/cable/yellow{icon_state = "4-8"},/turf/open/floor/plating,/area/ruin/powered)
"pFg" = (/obj/machinery/door/airlock/centcom,/turf/open/floor/mineral/plastitanium/red,/area/ruin/powered)
"qtW" = (/obj/structure/chair{dir = 4},/turf/open/floor/mineral/plastitanium/red,/area/ruin/powered)
"qIM" = (/obj/effect/turf_decal/tile/blue{dir = 4; icon_state = "tile_corner"},/obj/effect/turf_decal/tile/blue{dir = 8; icon_state = "tile_corner"},/mob/living/simple_animal/hostile/pirate/ranged,/turf/open/floor/plasteel/white,/area/ruin/powered)
"qMZ" = (/obj/effect/decal/cleanable/blood,/obj/structure/cable/yellow{icon_state = "4-8"},/turf/open/floor/plating,/area/ruin/powered)
"qYM" = (/turf/template_noop,/area/space)
"rpW" = (/obj/effect/decal/cleanable/chem_pile,/obj/effect/turf_decal/tile/blue{dir = 4; icon_state = "tile_corner"},/obj/effect/turf_decal/tile/blue{dir = 8; icon_state = "tile_corner"},/turf/open/floor/plasteel/white,/area/ruin/powered)
"rCm" = (/obj/item/storage/secure/safe,/obj/item/paper{info = "Mix 30 units of O2 with precisely 12 units of \[br]\[i]*a few paragraphs are torn out*\[/i] \[br]within an oxygenated atmosphere of roughly 650-degree Chlorine. Once the gray mass has solidifed, carefully remove it (hot!) and place in distilled water. Check the object regularly. Once the outer layer peels off, the plasma should shine below! \[br]Note, the recipe is a work-in-progress and should not be attempted without proper safety precautions."; name = "Plasma Synthetizing Recipe"},/turf/closed/wall/r_wall,/area/ruin/powered)
"scc" = (/obj/structure/chair{dir = 8},/turf/open/floor/mineral/plastitanium/red,/area/ruin/powered)
"siX" = (/obj/item/storage/toolbox/mechanical,/turf/open/floor/plating,/area/lavaland/surface/outdoors)
"sDt" = (/obj/effect/mob_spawn/human/corpse/damaged,/obj/effect/turf_decal/tile/blue{dir = 4; icon_state = "tile_corner"},/obj/effect/turf_decal/tile/blue{dir = 8; icon_state = "tile_corner"},/turf/open/floor/plasteel/white,/area/ruin/powered)
"tlH" = (/obj/structure/table,/obj/effect/turf_decal/tile/blue{dir = 4; icon_state = "tile_corner"},/obj/effect/turf_decal/tile/blue{dir = 8; icon_state = "tile_corner"},/obj/item/extinguisher,/turf/open/floor/plasteel/white,/area/ruin/powered)
"tLm" = (/obj/structure/table,/obj/effect/turf_decal/tile/blue{dir = 4; icon_state = "tile_corner"},/obj/effect/turf_decal/tile/blue{dir = 8; icon_state = "tile_corner"},/turf/open/floor/plasteel/white,/area/ruin/powered)
"tNF" = (/obj/machinery/computer/shuttle,/turf/open/floor/mineral/plastitanium/red,/area/ruin/powered)
"uGk" = (/obj/structure/table,/obj/item/stack/sheet/mineral/diamond,/obj/effect/turf_decal/tile/blue{dir = 4; icon_state = "tile_corner"},/obj/effect/turf_decal/tile/blue{dir = 8; icon_state = "tile_corner"},/turf/open/floor/plasteel/white,/area/ruin/powered)
"uPJ" = (/obj/structure/fans,/obj/effect/turf_decal/tile/blue{dir = 4; icon_state = "tile_corner"},/turf/open/floor/plasteel/white,/area/ruin/powered)
"uWY" = (/obj/machinery/chem_master,/obj/structure/cable/yellow{icon_state = "0-4"},/turf/open/floor/plating,/area/ruin/powered)
"wsq" = (/obj/structure/table,/obj/effect/turf_decal/tile/blue{dir = 4; icon_state = "tile_corner"},/obj/effect/turf_decal/tile/blue{dir = 8; icon_state = "tile_corner"},/obj/item/reagent_containers/glass/beaker/bluespace,/obj/item/reagent_containers/glass/beaker/bluespace,/obj/item/reagent_containers/glass/beaker/bluespace,/turf/open/floor/plasteel/white,/area/ruin/powered)
"wCK" = (/obj/structure/shuttle/engine/propulsion{dir = 4; icon_state = "propulsion_l"},/obj/structure/window/reinforced/tinted{dir = 4; icon_state = "twindow"},/turf/closed/wall/mineral/plastitanium,/area/ruin/powered)
"wUl" = (/turf/open/floor/plating/asteroid/basalt/lava_land_surface,/area/lavaland/surface/outdoors)
"wWq" = (/obj/effect/decal/cleanable/blood/old,/obj/effect/turf_decal/tile/blue{dir = 4; icon_state = "tile_corner"},/obj/effect/turf_decal/tile/blue{dir = 8; icon_state = "tile_corner"},/turf/open/floor/plasteel/white,/area/ruin/powered)
"xQR" = (/obj/structure/table,/obj/item/flashlight/lamp,/obj/effect/turf_decal/tile/blue{dir = 4; icon_state = "tile_corner"},/obj/effect/turf_decal/tile/blue{dir = 8; icon_state = "tile_corner"},/turf/open/floor/plasteel/white,/area/ruin/powered)
"xZM" = (/turf/closed/wall/mineral/plastitanium,/area/ruin/powered)

(1,1,1) = {"
ikU
ikU
wUl
wUl
wUl
wUl
wUl
qYM
qYM
qYM
qYM
qYM
qYM
qYM
qYM
qYM
qYM
qYM
qYM
qYM
"}
(2,1,1) = {"
ikU
ikU
wUl
wUl
wUl
wUl
wUl
ikU
qYM
qYM
qYM
qYM
qYM
qYM
qYM
qYM
ikU
qYM
ikU
qYM
"}
(3,1,1) = {"
ikU
wUl
xZM
wCK
wCK
xZM
wUl
ikU
qYM
qYM
ikU
ikU
qYM
ikU
ikU
qYM
ikU
ikU
ikU
qYM
"}
(4,1,1) = {"
ikU
wUl
xZM
qtW
qtW
xZM
wUl
ikU
ikU
ikU
ikU
ikU
ikU
ikU
ikU
ikU
ikU
ikU
ikU
qYM
"}
(5,1,1) = {"
ikU
wUl
pFg
kxL
kxL
pFg
wUl
wUl
ikU
ikU
ikU
ikU
ikU
ikU
ikU
ikU
ikU
ikU
ikU
qYM
"}
(6,1,1) = {"
ikU
wUl
xZM
tNF
scc
xZM
wUl
ikU
ikU
drG
drG
drG
drG
drG
drG
drG
ikU
ikU
qYM
qYM
"}
(7,1,1) = {"
ikU
wUl
xZM
xZM
xZM
xZM
wUl
ikU
ikU
drG
xQR
wsq
oXK
cBD
tLm
drG
ikU
ikU
ikU
ikU
"}
(8,1,1) = {"
ikU
ikU
wUl
wUl
wUl
wUl
wUl
ikU
ikU
drG
tlH
eFH
cBD
rpW
eUs
drG
ikU
ikU
qYM
qYM
"}
(9,1,1) = {"
wUl
ikU
wUl
wUl
oTs
oTs
oTs
drG
drG
drG
cDr
cBD
uWY
eFH
tLm
drG
ikU
ikU
qYM
qYM
"}
(10,1,1) = {"
wUl
wUl
wUl
wUl
wUl
dpE
jcJ
fDs
huy
fDs
cBD
rpW
oZC
sDt
uGk
drG
ikU
ikU
ikU
qYM
"}
(11,1,1) = {"
wUl
wUl
wUl
wUl
aSy
oTs
oTs
drG
drG
drG
uPJ
hPd
mIg
wWq
gyj
drG
ikU
ikU
ikU
qYM
"}
(12,1,1) = {"
wUl
wUl
wUl
wUl
wUl
wUl
oTs
iWo
jRc
drG
izb
qIM
qMZ
cBD
cga
drG
ikU
ikU
qYM
qYM
"}
(13,1,1) = {"
wUl
wUl
wUl
wUl
wUl
oTs
iWo
siX
idL
drG
cBD
iVZ
dmT
lcs
tLm
drG
ikU
ikU
qYM
qYM
"}
(14,1,1) = {"
ikU
ikU
ikU
ikU
ikU
ikU
oTs
idL
idL
drG
rCm
drG
drG
drG
drG
drG
ikU
ikU
ikU
qYM
"}
(15,1,1) = {"
qYM
qYM
qYM
qYM
qYM
ikU
ikU
ikU
ikU
ikU
ikU
ikU
ikU
ikU
ikU
ikU
ikU
ikU
ikU
qYM
"}
(16,1,1) = {"
qYM
qYM
qYM
qYM
qYM
qYM
qYM
qYM
ikU
ikU
ikU
ikU
ikU
ikU
ikU
ikU
ikU
ikU
ikU
qYM
"}
(17,1,1) = {"
qYM
qYM
qYM
qYM
qYM
qYM
qYM
qYM
qYM
qYM
ikU
qYM
qYM
qYM
ikU
ikU
qYM
qYM
qYM
qYM
"}
(18,1,1) = {"
qYM
qYM
qYM
qYM
qYM
qYM
qYM
qYM
qYM
qYM
qYM
qYM
qYM
qYM
ikU
ikU
qYM
qYM
qYM
qYM
"}
(19,1,1) = {"
qYM
qYM
qYM
qYM
qYM
qYM
qYM
qYM
qYM
qYM
qYM
qYM
qYM
qYM
qYM
qYM
qYM
qYM
qYM
qYM
"}
(20,1,1) = {"
qYM
qYM
qYM
qYM
qYM
qYM
qYM
qYM
qYM
qYM
qYM
qYM
qYM
qYM
qYM
qYM
qYM
qYM
qYM
qYM
"}
