//MAP CONVERTED BY dmm2tgm.py THIS HEADER COMMENT PREVENTS RECONVERSION, DO NOT REMOVE
"a" = (
/obj/structure/flora/rock,
/obj/effect/decal/cleanable/blood,
/obj/effect/mapping_helpers/no_lava,
/turf/open/floor/plating/asteroid/basalt/lava_land_surface,
/area/lavaland/surface)
"c" = (
/obj/structure/flora/ash/cap_shroom,
/obj/effect/spawner/lootdrop/effects/landmines,
/obj/effect/mapping_helpers/no_lava,
/turf/open/floor/plating/asteroid/basalt/lava_land_surface,
/area/lavaland/surface)
"d" = (
/turf/template_noop,
/area/template_noop)
"e" = (
/obj/structure/mecha_wreckage/marauder,
/obj/effect/mapping_helpers/no_lava,
/turf/open/floor/plating/asteroid/basalt/lava_land_surface,
/area/lavaland/surface)
"g" = (
/obj/structure/sign/warning/explosives{
	desc = "A warning sign which reads...something in a language you've never seen. The sign itself seems to indicate some kind of explosive danger?";
	name = "\improper Warning sign?"
	},
/turf/closed/indestructible/riveted/boss,
/area/lavaland/surface)
"m" = (
/obj/structure/mecha_wreckage/honker/dark,
/obj/effect/mapping_helpers/no_lava,
/turf/open/floor/plating/asteroid/basalt/lava_land_surface,
/area/lavaland/surface)
"o" = (
/obj/structure/glowshroom/glowcap,
/obj/effect/spawner/lootdrop/effects/landmines,
/obj/effect/mapping_helpers/no_lava,
/turf/open/floor/plating/asteroid/basalt/lava_land_surface,
/area/lavaland/surface)
"q" = (
/obj/structure/mecha_wreckage/durand,
/obj/effect/mapping_helpers/no_lava,
/turf/open/floor/plating/asteroid/basalt/lava_land_surface,
/area/lavaland/surface)
"v" = (
/obj/effect/decal/cleanable/blood,
/obj/effect/spawner/lootdrop/effects/landmines,
/obj/effect/mapping_helpers/no_lava,
/turf/open/floor/plating/asteroid/basalt/lava_land_surface,
/area/lavaland/surface)
"y" = (
/obj/structure/sign/warning/explosives{
	desc = "A warning sign which reads...something in a language you've never seen. The sign itself seems to indicate some kind of explosive danger?";
	name = "\improper Warning sign?"
	},
/obj/effect/mapping_helpers/no_lava,
/turf/closed/indestructible/riveted/boss,
/area/lavaland/surface)
"z" = (
/obj/structure/mecha_wreckage/phazon,
/obj/effect/mapping_helpers/no_lava,
/turf/open/floor/plating/asteroid/basalt/lava_land_surface,
/area/lavaland/surface)
"B" = (
/obj/structure/flora/ash/leaf_shroom,
/obj/effect/spawner/lootdrop/effects/landmines,
/obj/effect/mapping_helpers/no_lava,
/turf/open/floor/plating/asteroid/basalt/lava_land_surface,
/area/lavaland/surface)
"C" = (
/obj/structure/mecha_wreckage/gygax,
/obj/effect/mapping_helpers/no_lava,
/turf/open/floor/plating/asteroid/basalt/lava_land_surface,
/area/lavaland/surface)
"G" = (
/obj/structure/flora/rock,
/obj/effect/mapping_helpers/no_lava,
/turf/open/floor/plating/asteroid/basalt/lava_land_surface,
/area/lavaland/surface)
"H" = (
/obj/structure/flora/ash/stem_shroom,
/obj/effect/spawner/lootdrop/effects/landmines,
/obj/effect/mapping_helpers/no_lava,
/turf/open/floor/plating/asteroid/basalt/lava_land_surface,
/area/lavaland/surface)
"I" = (
/obj/structure/flora/ash/cacti,
/obj/effect/spawner/lootdrop/effects/landmines,
/obj/effect/mapping_helpers/no_lava,
/turf/open/floor/plating/asteroid/basalt/lava_land_surface,
/area/lavaland/surface)
"J" = (
/obj/structure/mecha_wreckage/gygax/dark,
/obj/effect/mapping_helpers/no_lava,
/turf/open/floor/plating/asteroid/basalt/lava_land_surface,
/area/lavaland/surface)
"P" = (
/obj/effect/spawner/lootdrop/effects/landmines,
/obj/effect/mapping_helpers/no_lava,
/turf/open/floor/plating/asteroid/basalt/lava_land_surface,
/area/lavaland/surface)
"U" = (
/obj/item/pod_parts/core,
/obj/item/storage/toolbox/mechanical/old,
/obj/item/spacepod_key,
/obj/item/spacepod_equipment/weaponry/pod_ka,
/obj/item/spacepod_equipment/weaponry/plasma_cutter,
/obj/item/spacepod_equipment/cargo/large/ore,
/obj/item/spacepod_equipment/cargo/large,
/obj/item/spacepod_equipment/cargo,
/obj/item/spacepod_equipment/cargo/chair,
/obj/item/circuitboard/mecha/pod,
/obj/structure/closet/crate/sphere{
	name = "dusty space pod kit"
	},
/obj/item/pod_parts/armor/gold{
	desc = "Gold painted plastitanium spacepod armor. Looks like what a rich spessmen put on their spacepod, but is much stronger.";
	pod_desc = "A custom space pod with a gold painted plastitanium body, must have cost somebody a pretty penny";
	pod_integrity = 400
	},
/obj/item/spacepod_equipment/tracker,
/obj/item/spacepod_equipment/lock/keyed,
/obj/effect/mapping_helpers/no_lava,
/turf/open/floor/plating/asteroid/basalt/lava_land_surface,
/area/lavaland/surface)
"W" = (
/obj/structure/flora/rock,
/obj/effect/spawner/lootdrop/effects/landmines,
/obj/effect/mapping_helpers/no_lava,
/turf/open/floor/plating/asteroid/basalt/lava_land_surface,
/area/lavaland/surface)

(1,1,1) = {"
d
d
d
d
d
d
d
d
d
d
d
d
d
d
d
d
d
d
d
d
d
d
d
d
d
d
d
d
d
d
"}
(2,1,1) = {"
d
d
d
d
d
d
d
d
d
d
d
d
d
d
d
d
d
d
d
d
d
d
d
d
d
d
d
d
d
d
"}
(3,1,1) = {"
d
d
d
d
d
d
d
d
d
d
d
d
d
d
d
d
d
d
d
d
d
d
d
d
d
d
d
d
d
d
"}
(4,1,1) = {"
d
d
d
d
d
d
d
d
d
d
d
d
d
d
d
d
d
d
d
d
d
d
d
d
d
d
d
d
d
d
"}
(5,1,1) = {"
d
d
d
d
d
P
B
P
P
d
d
d
d
P
P
P
P
g
P
P
P
P
P
d
d
d
d
d
d
d
"}
(6,1,1) = {"
d
d
d
d
d
P
P
P
P
P
H
P
v
P
P
P
P
P
P
P
P
P
P
P
P
P
d
d
d
d
"}
(7,1,1) = {"
d
d
d
d
P
P
P
P
P
e
P
P
P
G
P
P
C
H
P
B
P
P
P
c
P
P
P
d
d
d
"}
(8,1,1) = {"
d
d
d
P
P
P
P
P
P
P
P
P
P
P
P
P
P
P
P
P
P
P
v
P
P
P
P
P
d
d
"}
(9,1,1) = {"
d
d
d
P
P
P
P
P
P
P
P
P
P
P
P
P
H
P
P
P
P
P
P
P
P
P
P
P
d
d
"}
(10,1,1) = {"
d
d
P
P
P
P
P
o
c
P
P
P
P
P
P
P
P
P
P
P
P
P
o
P
P
H
P
P
d
d
"}
(11,1,1) = {"
d
d
P
H
P
P
P
P
m
P
P
P
P
P
P
P
P
P
c
P
P
P
P
G
P
P
P
P
P
d
"}
(12,1,1) = {"
d
d
P
P
P
P
P
P
P
P
P
P
P
P
P
P
P
P
P
v
P
P
P
P
q
P
P
P
P
d
"}
(13,1,1) = {"
d
d
P
P
P
H
P
P
P
P
P
P
P
P
I
P
P
P
P
P
P
P
P
P
P
P
P
P
d
d
"}
(14,1,1) = {"
d
d
g
P
P
P
P
P
B
v
P
P
P
o
P
P
I
P
P
P
P
P
P
P
P
P
P
P
d
d
"}
(15,1,1) = {"
d
d
P
P
G
P
P
P
P
P
P
P
P
P
P
P
U
P
P
P
P
P
P
P
P
P
P
g
d
d
"}
(16,1,1) = {"
d
d
P
P
z
P
P
P
P
P
P
P
P
P
P
I
P
B
P
P
P
P
P
P
P
P
P
P
d
d
"}
(17,1,1) = {"
d
d
P
P
P
P
P
P
P
P
P
P
P
H
P
P
P
P
P
P
P
P
P
P
P
P
P
P
d
d
"}
(18,1,1) = {"
d
d
d
P
P
P
P
P
P
P
P
P
P
I
P
P
P
I
P
P
P
P
P
P
o
P
P
d
d
d
"}
(19,1,1) = {"
d
d
d
P
o
c
P
P
P
v
P
P
P
P
P
P
P
P
P
P
P
P
P
P
P
P
P
d
d
d
"}
(20,1,1) = {"
d
d
d
d
P
P
P
P
P
P
P
P
c
P
P
P
P
P
P
P
P
P
P
P
B
P
P
d
d
d
"}
(21,1,1) = {"
d
d
d
d
P
P
P
P
P
P
P
P
P
P
P
P
P
P
P
P
P
P
P
P
P
P
H
d
d
d
"}
(22,1,1) = {"
d
d
d
d
P
P
P
W
P
P
P
P
P
P
P
P
P
P
P
P
P
o
P
P
P
P
P
d
d
d
"}
(23,1,1) = {"
d
d
d
d
P
P
P
P
P
J
P
P
P
P
P
P
H
P
P
P
P
P
z
P
P
P
P
d
d
d
"}
(24,1,1) = {"
d
d
d
d
P
P
P
P
P
P
o
P
P
P
P
P
a
P
P
P
P
P
P
P
P
P
d
d
d
d
"}
(25,1,1) = {"
d
d
d
d
d
P
P
P
P
P
P
P
P
P
P
P
P
P
P
P
c
v
P
P
P
P
d
d
d
d
"}
(26,1,1) = {"
d
d
d
d
d
P
P
P
P
P
P
P
P
H
P
P
P
P
P
P
P
P
P
P
P
d
d
d
d
d
"}
(27,1,1) = {"
d
d
d
d
d
P
P
P
P
P
P
P
P
P
P
P
y
P
P
P
d
d
d
d
d
d
d
d
d
d
"}
(28,1,1) = {"
d
d
d
d
d
d
P
P
P
B
P
P
P
d
d
d
d
d
d
d
d
d
d
d
d
d
d
d
d
d
"}
(29,1,1) = {"
d
d
d
d
d
d
d
d
d
d
d
d
d
d
d
d
d
d
d
d
d
d
d
d
d
d
d
d
d
d
"}
(30,1,1) = {"
d
d
d
d
d
d
d
d
d
d
d
d
d
d
d
d
d
d
d
d
d
d
d
d
d
d
d
d
d
d
"}
