//MAP CONVERTED BY dmm2tgm.py THIS HEADER COMMENT PREVENTS RECONVERSION, DO NOT REMOVE
"b" = (
/obj/structure/flora/rock,
/turf/open/floor/plating/asteroid/basalt/lava_land_surface,
/area/lavaland/surface)
"d" = (
/turf/template_noop,
/area/template_noop)
"e" = (
/obj/structure/flora/ash/cap_shroom,
/turf/open/floor/plating/asteroid/basalt/lava_land_surface,
/area/lavaland/surface)
"k" = (
/obj/structure/mecha_wreckage/marauder,
/turf/open/floor/plating/asteroid/basalt/lava_land_surface,
/area/lavaland/surface)
"l" = (
/obj/structure/flora/ash/leaf_shroom,
/turf/open/floor/plating/asteroid/basalt/lava_land_surface,
/area/lavaland/surface)
"m" = (
/obj/structure/flora/ash/stem_shroom,
/turf/open/floor/plating/asteroid/basalt/lava_land_surface,
/area/lavaland/surface)
"n" = (
/obj/structure/flora/rock,
/obj/effect/decal/cleanable/blood,
/turf/open/floor/plating/asteroid/basalt/lava_land_surface,
/area/lavaland/surface)
"o" = (
/obj/structure/mecha_wreckage/gygax/dark,
/turf/open/floor/plating/asteroid/basalt/lava_land_surface,
/area/lavaland/surface)
"p" = (
/obj/structure/flora/ash/cacti,
/turf/open/floor/plating/asteroid/basalt/lava_land_surface,
/area/lavaland/surface)
"r" = (
/obj/item/pod_parts/core,
/obj/item/storage/toolbox/mechanical/old,
/obj/item/spacepod_key,
/obj/item/spacepod_equipment/weaponry/pod_ka,
/obj/item/spacepod_equipment/weaponry/plasma_cutter,
/obj/item/spacepod_equipment/cargo/large/ore,
/obj/item/spacepod_equipment/cargo/large,
/obj/item/spacepod_equipment/cargo,
/obj/item/spacepod_equipment/cargo/chair,
/obj/item/circuitboard/mecha/pod,
/obj/structure/closet/crate/sphere{
	name = "dusty space pod kit"
	},
/obj/item/pod_parts/armor/gold{
	desc = "Gold painted plastitanium spacepod armor. Looks like what a rich spessmen put on their spacepod, but is much stronger.";
	pod_desc = "A custom space pod with a gold painted plastitanium body, must have cost somebody a pretty penny";
	pod_integrity = 400
	},
/obj/item/spacepod_equipment/tracker,
/obj/item/spacepod_equipment/lock/keyed,
/turf/open/floor/plating/asteroid/basalt/lava_land_surface,
/area/lavaland/surface)
"s" = (
/obj/structure/mecha_wreckage/gygax,
/turf/open/floor/plating/asteroid/basalt/lava_land_surface,
/area/lavaland/surface)
"w" = (
/obj/effect/decal/cleanable/blood,
/turf/open/floor/plating/asteroid/basalt/lava_land_surface,
/area/lavaland/surface)
"x" = (
/obj/structure/glowshroom/glowcap,
/turf/open/floor/plating/asteroid/basalt/lava_land_surface,
/area/lavaland/surface)
"y" = (
/obj/structure/mecha_wreckage/reticence,
/turf/open/floor/plating/asteroid/basalt/lava_land_surface,
/area/lavaland/surface)
"z" = (
/obj/structure/mecha_wreckage/phazon,
/turf/open/floor/plating/asteroid/basalt/lava_land_surface,
/area/lavaland/surface)
"B" = (
/obj/structure/sign/warning/explosives{
	desc = "A warning sign which reads...something in a language you've never seen. The sign itself seems to indicate some kind of explosive danger?";
	name = "\improper Warning sign?"
	},
/turf/closed/indestructible/riveted/boss,
/area/lavaland/surface)
"G" = (
/obj/structure/mecha_wreckage/honker/dark,
/turf/open/floor/plating/asteroid/basalt/lava_land_surface,
/area/lavaland/surface)
"N" = (
/obj/effect/mine/sound,
/turf/open/floor/plating/asteroid/basalt/lava_land_surface,
/area/lavaland/surface)
"Q" = (
/obj/effect/mine/stun,
/turf/open/floor/plating/asteroid/basalt/lava_land_surface,
/area/lavaland/surface)
"R" = (
/obj/structure/mecha_wreckage/durand,
/turf/open/floor/plating/asteroid/basalt/lava_land_surface,
/area/lavaland/surface)
"S" = (
/turf/open/floor/plating/asteroid/basalt/lava_land_surface,
/area/lavaland/surface)
"U" = (
/obj/structure/mecha_wreckage/seraph,
/turf/open/floor/plating/asteroid/basalt/lava_land_surface,
/area/lavaland/surface)
"X" = (
/obj/effect/mine/explosive,
/turf/open/floor/plating/asteroid/basalt/lava_land_surface,
/area/lavaland/surface)

(1,1,1) = {"
d
d
d
d
d
d
d
d
d
d
d
d
d
d
d
d
d
d
d
d
d
d
d
d
d
d
d
d
d
d
"}
(2,1,1) = {"
d
d
d
d
d
d
d
d
d
d
d
d
d
d
d
d
d
d
d
d
d
d
d
d
d
d
d
d
d
d
"}
(3,1,1) = {"
d
d
d
d
d
d
d
d
d
d
d
d
d
d
d
d
d
d
d
d
d
d
d
d
d
d
d
d
d
d
"}
(4,1,1) = {"
d
d
d
d
d
d
d
d
d
d
d
d
d
d
d
d
d
d
d
d
d
d
d
d
d
d
d
d
d
d
"}
(5,1,1) = {"
d
d
d
d
d
S
l
S
S
d
d
d
d
S
S
S
S
B
S
S
S
S
S
d
d
d
d
d
d
d
"}
(6,1,1) = {"
d
d
d
d
d
S
S
S
S
S
m
S
w
S
S
S
S
S
S
S
S
S
S
S
S
S
d
d
d
d
"}
(7,1,1) = {"
d
d
d
d
S
Q
S
S
S
k
S
S
S
b
S
S
s
m
S
l
S
Q
S
e
S
S
S
d
d
d
"}
(8,1,1) = {"
d
d
d
S
S
S
S
S
S
S
S
N
S
S
S
Q
S
S
S
S
S
S
w
S
S
S
S
S
d
d
"}
(9,1,1) = {"
d
d
d
S
S
S
S
S
S
Q
S
S
S
S
S
S
m
N
S
S
X
S
S
Q
S
S
S
S
d
d
"}
(10,1,1) = {"
d
d
S
S
S
S
S
x
e
S
S
S
S
N
S
S
S
S
S
S
S
S
x
S
S
m
S
S
d
d
"}
(11,1,1) = {"
d
d
S
m
S
Q
S
S
G
S
S
Q
S
S
S
S
S
S
e
S
N
S
S
b
S
S
S
S
S
d
"}
(12,1,1) = {"
d
d
S
S
S
S
S
S
S
S
X
S
S
S
S
N
S
X
S
w
S
Q
S
S
R
S
S
S
S
d
"}
(13,1,1) = {"
d
d
S
S
S
m
S
X
S
S
S
S
S
N
p
S
S
S
S
S
S
S
S
S
S
N
S
S
d
d
"}
(14,1,1) = {"
d
d
B
S
S
S
S
S
l
w
S
S
S
x
S
S
p
S
S
Q
S
S
S
S
S
S
S
S
d
d
"}
(15,1,1) = {"
d
d
S
N
b
S
S
S
S
S
S
N
S
Q
S
S
r
S
S
S
S
S
S
N
S
X
S
B
d
d
"}
(16,1,1) = {"
d
d
S
S
z
Q
S
S
S
S
S
S
S
y
S
p
S
l
S
S
S
S
S
S
S
S
S
S
d
d
"}
(17,1,1) = {"
d
d
S
S
S
S
S
S
Q
S
N
S
S
m
S
S
S
S
S
N
S
N
S
S
S
S
S
S
d
d
"}
(18,1,1) = {"
d
d
d
S
S
S
S
S
N
S
S
S
S
p
S
S
N
p
S
S
S
S
S
S
x
Q
S
d
d
d
"}
(19,1,1) = {"
d
d
d
S
x
e
S
S
S
w
S
S
S
S
Q
S
S
S
S
S
S
S
S
S
S
S
S
d
d
d
"}
(20,1,1) = {"
d
d
d
d
N
S
S
N
S
S
S
S
e
S
S
S
S
S
X
S
N
S
S
N
l
S
S
d
d
d
"}
(21,1,1) = {"
d
d
d
d
S
S
S
S
X
S
S
Q
S
S
S
S
S
S
S
S
S
S
S
S
S
S
m
d
d
d
"}
(22,1,1) = {"
d
d
d
d
S
S
S
b
S
S
S
S
S
S
S
N
S
S
U
Q
S
x
S
S
S
S
S
d
d
d
"}
(23,1,1) = {"
d
d
d
d
S
S
Q
S
N
o
S
N
S
S
S
S
m
S
S
S
S
X
z
S
S
S
S
d
d
d
"}
(24,1,1) = {"
d
d
d
d
S
S
S
S
S
S
x
S
S
N
S
S
n
S
N
S
S
S
S
Q
S
S
d
d
d
d
"}
(25,1,1) = {"
d
d
d
d
d
S
S
S
S
S
S
S
S
S
S
S
S
S
S
S
e
w
S
S
S
S
d
d
d
d
"}
(26,1,1) = {"
d
d
d
d
d
S
S
X
S
Q
S
N
S
m
S
S
S
S
N
S
S
S
S
S
S
d
d
d
d
d
"}
(27,1,1) = {"
d
d
d
d
d
S
S
S
S
S
S
S
S
S
S
S
B
S
S
S
d
d
d
d
d
d
d
d
d
d
"}
(28,1,1) = {"
d
d
d
d
d
d
S
S
S
l
S
S
S
d
d
d
d
d
d
d
d
d
d
d
d
d
d
d
d
d
"}
(29,1,1) = {"
d
d
d
d
d
d
d
d
d
d
d
d
d
d
d
d
d
d
d
d
d
d
d
d
d
d
d
d
d
d
"}
(30,1,1) = {"
d
d
d
d
d
d
d
d
d
d
d
d
d
d
d
d
d
d
d
d
d
d
d
d
d
d
d
d
d
d
"}
