// This map has been converted using maphash
"arG" = (/turf/template_noop,/area/template_noop)
"dwA" = (/turf/closed/mineral/volcanic/lava_land_surface,/area/template_noop)
"kZY" = (/turf/open/floor/mineral/plastitanium/red{initial_gas_mix = "o2=14;n2=23;TEMP=300"},/area/ruin/unpowered)
"qPh" = (/obj/structure/shuttle/engine/propulsion{dir = 4},/turf/template_noop,/area/ruin/unpowered)
"sSX" = (/mob/living/simple_animal/hostile/megafauna/swarmer_swarm_beacon,/turf/open/floor/mineral/plastitanium/red{initial_gas_mix = "o2=14;n2=23;TEMP=300"},/area/ruin/unpowered)
"tCQ" = (/turf/closed/wall/mineral/plastitanium,/area/ruin/unpowered)

(1,1,1) = {"
arG
arG
arG
arG
dwA
arG
arG
arG
arG
arG
arG
arG
arG
arG
"}
(2,1,1) = {"
arG
arG
arG
dwA
dwA
dwA
tCQ
arG
tCQ
arG
dwA
dwA
arG
arG
"}
(3,1,1) = {"
arG
arG
dwA
dwA
dwA
dwA
kZY
kZY
kZY
tCQ
dwA
dwA
arG
arG
"}
(4,1,1) = {"
dwA
dwA
dwA
dwA
dwA
dwA
arG
kZY
kZY
dwA
dwA
dwA
arG
arG
"}
(5,1,1) = {"
dwA
dwA
dwA
dwA
dwA
dwA
arG
arG
arG
dwA
dwA
dwA
dwA
arG
"}
(6,1,1) = {"
arG
dwA
dwA
dwA
dwA
tCQ
arG
arG
kZY
tCQ
arG
dwA
dwA
arG
"}
(7,1,1) = {"
arG
dwA
dwA
dwA
tCQ
kZY
kZY
kZY
kZY
kZY
tCQ
dwA
dwA
arG
"}
(8,1,1) = {"
arG
dwA
dwA
arG
tCQ
kZY
kZY
kZY
kZY
kZY
tCQ
dwA
dwA
arG
"}
(9,1,1) = {"
arG
arG
dwA
arG
tCQ
kZY
kZY
sSX
kZY
kZY
tCQ
dwA
dwA
dwA
"}
(10,1,1) = {"
arG
arG
dwA
arG
arG
kZY
kZY
kZY
kZY
kZY
tCQ
dwA
dwA
dwA
"}
(11,1,1) = {"
arG
arG
dwA
dwA
arG
kZY
kZY
kZY
kZY
kZY
tCQ
dwA
dwA
arG
"}
(12,1,1) = {"
arG
arG
arG
dwA
arG
kZY
tCQ
tCQ
tCQ
arG
arG
arG
arG
arG
"}
(13,1,1) = {"
arG
arG
arG
arG
tCQ
tCQ
qPh
qPh
qPh
tCQ
tCQ
arG
arG
arG
"}
(14,1,1) = {"
arG
arG
arG
arG
tCQ
qPh
arG
arG
arG
qPh
tCQ
arG
arG
arG
"}
