//MAP CONVERTED BY dmm2tgm.py THIS HEADER COMMENT PREVENTS RECONVERSION, DO NOT REMOVE
"a" = (
/obj/structure/mecha_wreckage/gygax/dark,
/turf/open/floor/plating/asteroid/basalt/lava_land_surface,
/area/lavaland/surface)
"c" = (
/turf/open/floor/plating/asteroid/basalt/lava_land_surface,
/area/lavaland/surface)
"d" = (
/turf/template_noop,
/area/template_noop)
"e" = (
/obj/structure/mecha_wreckage/honker/dark,
/turf/open/floor/plating/asteroid/basalt/lava_land_surface,
/area/lavaland/surface)
"f" = (
/obj/structure/mecha_wreckage/durand,
/turf/open/floor/plating/asteroid/basalt/lava_land_surface,
/area/lavaland/surface)
"g" = (
/obj/structure/sign/warning/explosives{
	desc = "A warning sign which reads...something in a language you've never seen. The sign itself seems to indicate some kind of explosive danger?";
	name = "\improper Warning sign?"
	},
/turf/closed/indestructible/riveted/boss,
/area/lavaland/surface)
"h" = (
/obj/effect/decal/cleanable/blood,
/turf/open/floor/plating/asteroid/basalt/lava_land_surface,
/area/lavaland/surface)
"i" = (
/obj/structure/mecha_wreckage/seraph,
/turf/open/floor/plating/asteroid/basalt/lava_land_surface,
/area/lavaland/surface)
"k" = (
/obj/structure/glowshroom/glowcap,
/turf/open/floor/plating/asteroid/basalt/lava_land_surface,
/area/lavaland/surface)
"t" = (
/obj/structure/mecha_wreckage/gygax,
/turf/open/floor/plating/asteroid/basalt/lava_land_surface,
/area/lavaland/surface)
"x" = (
/obj/structure/flora/ash/cap_shroom,
/turf/open/floor/plating/asteroid/basalt/lava_land_surface,
/area/lavaland/surface)
"y" = (
/obj/effect/mine/sound,
/turf/open/floor/plating/asteroid/basalt/lava_land_surface,
/area/lavaland/surface)
"E" = (
/obj/effect/mine/stun,
/turf/open/floor/plating/asteroid/basalt/lava_land_surface,
/area/lavaland/surface)
"I" = (
/obj/item/pod_parts/core,
/obj/item/storage/toolbox/mechanical/old,
/obj/item/spacepod_key,
/obj/item/spacepod_equipment/weaponry/pod_ka,
/obj/item/spacepod_equipment/weaponry/plasma_cutter,
/obj/item/spacepod_equipment/cargo/large/ore,
/obj/item/spacepod_equipment/cargo/large,
/obj/item/spacepod_equipment/cargo,
/obj/item/spacepod_equipment/cargo/chair,
/obj/item/circuitboard/mecha/pod,
/obj/structure/closet/crate/sphere{
	name = "dusty space pod kit"
	},
/obj/item/pod_parts/armor/gold{
	desc = "Gold painted plastitanium spacepod armor. Looks like what a rich spessmen put on their spacepod, but is much stronger.";
	pod_desc = "A custom space pod with a gold painted plastitanium body, must have cost somebody a pretty penny";
	pod_integrity = 400
	},
/obj/item/spacepod_equipment/tracker,
/obj/item/spacepod_equipment/lock/keyed,
/turf/open/floor/plating/asteroid/basalt/lava_land_surface,
/area/lavaland/surface)
"K" = (
/obj/structure/flora/ash/leaf_shroom,
/turf/open/floor/plating/asteroid/basalt/lava_land_surface,
/area/lavaland/surface)
"L" = (
/obj/structure/flora/ash/cacti,
/turf/open/floor/plating/asteroid/basalt/lava_land_surface,
/area/lavaland/surface)
"M" = (
/obj/structure/flora/ash/stem_shroom,
/turf/open/floor/plating/asteroid/basalt/lava_land_surface,
/area/lavaland/surface)
"N" = (
/obj/structure/mecha_wreckage/phazon,
/turf/open/floor/plating/asteroid/basalt/lava_land_surface,
/area/lavaland/surface)
"O" = (
/obj/structure/flora/rock,
/turf/open/floor/plating/asteroid/basalt/lava_land_surface,
/area/lavaland/surface)
"T" = (
/obj/effect/mine/explosive,
/turf/open/floor/plating/asteroid/basalt/lava_land_surface,
/area/lavaland/surface)
"W" = (
/obj/structure/mecha_wreckage/marauder,
/turf/open/floor/plating/asteroid/basalt/lava_land_surface,
/area/lavaland/surface)
"Z" = (
/obj/structure/flora/rock,
/obj/effect/decal/cleanable/blood,
/turf/open/floor/plating/asteroid/basalt/lava_land_surface,
/area/lavaland/surface)

(1,1,1) = {"
d
d
d
d
d
d
d
d
d
d
d
d
d
d
d
d
d
d
d
d
d
d
d
d
d
d
d
d
d
d
"}
(2,1,1) = {"
d
d
d
d
d
d
d
d
d
d
d
d
d
d
d
d
d
d
d
d
d
d
d
d
d
d
d
d
d
d
"}
(3,1,1) = {"
d
d
d
d
d
d
d
d
d
d
d
d
d
d
d
d
d
d
d
d
d
d
d
d
d
d
d
d
d
d
"}
(4,1,1) = {"
d
d
d
d
d
d
d
d
d
d
d
d
d
d
d
d
d
d
d
d
d
d
d
d
d
d
d
d
d
d
"}
(5,1,1) = {"
d
d
d
d
d
c
K
c
c
d
d
d
d
c
c
c
c
g
c
c
c
c
c
d
d
d
d
d
d
d
"}
(6,1,1) = {"
d
d
d
d
d
c
c
c
c
c
M
c
h
c
c
c
c
c
c
c
c
c
c
c
c
c
d
d
d
d
"}
(7,1,1) = {"
d
d
d
d
c
E
c
c
c
W
c
c
c
O
c
c
t
M
c
K
c
E
c
x
c
c
c
d
d
d
"}
(8,1,1) = {"
d
d
d
c
c
c
c
c
c
c
c
y
c
c
c
E
c
c
c
c
c
c
h
c
c
c
c
c
d
d
"}
(9,1,1) = {"
d
d
d
c
c
c
c
c
c
E
c
c
c
c
c
c
M
y
c
c
T
c
c
E
c
c
c
c
d
d
"}
(10,1,1) = {"
d
d
c
c
c
c
c
k
x
c
c
c
c
y
c
c
c
c
c
c
c
c
k
c
c
M
c
c
d
d
"}
(11,1,1) = {"
d
d
c
M
c
E
c
c
e
c
c
E
c
c
c
c
c
c
x
c
y
c
c
O
c
c
c
c
c
d
"}
(12,1,1) = {"
d
d
c
c
c
c
c
c
c
c
T
c
c
c
c
y
c
T
c
h
c
E
c
c
f
c
c
c
c
d
"}
(13,1,1) = {"
d
d
c
c
c
M
c
T
c
c
c
c
c
y
L
c
c
c
c
c
c
c
c
c
c
y
c
c
d
d
"}
(14,1,1) = {"
d
d
g
c
c
c
c
c
K
h
c
c
c
k
c
c
L
c
c
E
c
c
c
c
c
c
c
c
d
d
"}
(15,1,1) = {"
d
d
c
y
O
c
c
c
c
c
c
y
c
E
c
c
I
c
c
c
c
c
c
y
c
T
c
g
d
d
"}
(16,1,1) = {"
d
d
c
c
N
E
c
c
c
c
c
c
c
c
c
L
c
K
c
c
c
c
c
c
c
c
c
c
d
d
"}
(17,1,1) = {"
d
d
c
c
c
c
c
c
E
c
y
c
c
M
c
c
c
c
c
y
c
y
c
c
c
c
c
c
d
d
"}
(18,1,1) = {"
d
d
d
c
c
c
c
c
y
c
c
c
c
L
c
c
y
L
c
c
c
c
c
c
k
E
c
d
d
d
"}
(19,1,1) = {"
d
d
d
c
k
x
c
c
c
h
c
c
c
c
E
c
c
c
c
c
c
c
c
c
c
c
c
d
d
d
"}
(20,1,1) = {"
d
d
d
d
y
c
c
y
c
c
c
c
x
c
c
c
c
c
T
c
y
c
c
y
K
c
c
d
d
d
"}
(21,1,1) = {"
d
d
d
d
c
c
c
c
T
c
c
E
c
c
c
c
c
c
c
c
c
c
c
c
c
c
M
d
d
d
"}
(22,1,1) = {"
d
d
d
d
c
c
c
O
c
c
c
c
c
c
c
y
c
c
i
E
c
k
c
c
c
c
c
d
d
d
"}
(23,1,1) = {"
d
d
d
d
c
c
E
c
y
a
c
y
c
c
c
c
M
c
c
c
c
T
N
c
c
c
c
d
d
d
"}
(24,1,1) = {"
d
d
d
d
c
c
c
c
c
c
k
c
c
y
c
c
Z
c
y
c
c
c
c
E
c
c
d
d
d
d
"}
(25,1,1) = {"
d
d
d
d
d
c
c
c
c
c
c
c
c
c
c
c
c
c
c
c
x
h
c
c
c
c
d
d
d
d
"}
(26,1,1) = {"
d
d
d
d
d
c
c
T
c
E
c
y
c
M
c
c
c
c
y
c
c
c
c
c
c
d
d
d
d
d
"}
(27,1,1) = {"
d
d
d
d
d
c
c
c
c
c
c
c
c
c
c
c
g
c
c
c
d
d
d
d
d
d
d
d
d
d
"}
(28,1,1) = {"
d
d
d
d
d
d
c
c
c
K
c
c
c
d
d
d
d
d
d
d
d
d
d
d
d
d
d
d
d
d
"}
(29,1,1) = {"
d
d
d
d
d
d
d
d
d
d
d
d
d
d
d
d
d
d
d
d
d
d
d
d
d
d
d
d
d
d
"}
(30,1,1) = {"
d
d
d
d
d
d
d
d
d
d
d
d
d
d
d
d
d
d
d
d
d
d
d
d
d
d
d
d
d
d
"}
