// This map has been converted using maphash
"arG" = (/turf/template_noop,/area/template_noop)
"bOD" = (/turf/closed/wall/mineral/titanium,/area/ruin/powered)
"dJS" = (/obj/item/paper/crumpled{name = "Crumpled Note"},/obj/effect/decal/cleanable/dirt,/turf/open/floor/plasteel/yellowsiding{dir = 1},/area/ruin/powered)
"eeA" = (/obj/machinery/suit_storage_unit/standard_unit{helmet_type = null; suit_type = /obj/item/clothing/suit/space/hardsuit/ert/sec},/obj/effect/decal/cleanable/dirt,/obj/effect/decal/cleanable/cobweb,/obj/effect/decal/cleanable/dirt,/turf/open/floor/plasteel/yellowsiding{dir = 1},/area/ruin/powered)
"ehV" = (/obj/effect/decal/cleanable/dirt,/obj/effect/decal/cleanable/dirt,/obj/effect/turf_decal/stripes/line{dir = 8; icon_state = "warningline"},/turf/open/floor/plasteel{dir = 8},/area/ruin/powered)
"esz" = (/obj/item/trash/raisins,/obj/item/trash/candy,/obj/item/trash/chips,/obj/item/trash/chips,/obj/item/trash/chips,/obj/item/trash/chips,/obj/item/trash/sosjerky,/obj/item/trash/raisins,/obj/item/trash/raisins,/obj/item/trash/cheesie,/obj/effect/decal/cleanable/generic,/obj/effect/decal/cleanable/dirt,/obj/effect/decal/cleanable/dirt,/turf/open/floor/plasteel,/area/ruin/powered)
"fod" = (/obj/effect/decal/cleanable/cobweb/cobweb2,/obj/machinery/computer,/turf/open/floor/plasteel/yellowsiding{dir = 1},/area/ruin/powered)
"fzI" = (/obj/machinery/computer,/turf/open/floor/plasteel/yellowsiding,/area/ruin/powered)
"gBY" = (/obj/effect/decal/cleanable/generic,/obj/effect/decal/cleanable/generic,/obj/effect/decal/cleanable/dirt,/turf/open/floor/plasteel,/area/ruin/powered)
"jxG" = (/obj/structure/shuttle/engine/propulsion{dir = 4; icon_state = "propulsion"},/turf/closed/wall/mineral/titanium,/area/ruin/powered)
"kQD" = (/obj/effect/decal/cleanable/vomit,/obj/effect/mob_spawn/human/corpse/nanotrasensoldier,/obj/effect/decal/cleanable/generic,/obj/effect/decal/cleanable/dirt,/obj/effect/decal/cleanable/dirt,/turf/open/floor/plasteel,/area/ruin/powered)
"lrS" = (/obj/effect/decal/cleanable/cobweb/cobweb2,/obj/machinery/computer,/turf/open/floor/plasteel,/area/ruin/powered)
"lwe" = (/obj/effect/decal/cleanable/dirt,/obj/effect/turf_decal/stripes/line{dir = 8; icon_state = "warningline"},/turf/open/floor/plasteel{dir = 8},/area/ruin/powered)
"okN" = (/obj/effect/spawner/structure/window/reinforced,/turf/open/floor/plating,/area/ruin/powered)
"qKU" = (/obj/structure/chair/office/dark{dir = 4},/obj/effect/decal/cleanable/dirt,/turf/open/floor/plasteel,/area/ruin/powered)
"qXw" = (/obj/item/trash/candy,/obj/item/trash/candy,/obj/item/trash/candy,/obj/item/trash/candy,/obj/item/trash/sosjerky,/obj/item/trash/sosjerky,/obj/item/trash/sosjerky,/obj/effect/decal/cleanable/dirt,/obj/effect/decal/cleanable/dirt,/turf/open/floor/plasteel/yellowsiding,/area/ruin/powered)
"slU" = (/obj/effect/decal/cleanable/dirt,/obj/machinery/vending/snack{product_slogans = "Use Getmore Chocolate to avoid starving to death on a crashed ship in the middle of a volcanic wasteland!"; products = list(/obj/item/reagent_containers/food/snacks/spacetwinkie = 0, /obj/item/reagent_containers/food/snacks/cheesiehonkers = 0, /obj/item/reagent_containers/food/snacks/candy = 0, /obj/item/reagent_containers/food/snacks/chips = 0, /obj/item/reagent_containers/food/snacks/sosjerky = 0, /obj/item/reagent_containers/food/snacks/no_raisin = 0, /obj/item/reagent_containers/food/drinks/dry_ramen = 0, /obj/item/reagent_containers/food/snacks/energybar = 0); slogan_delay = 1000},/turf/open/floor/plasteel/yellowsiding,/area/ruin/powered)
"sAd" = (/obj/item/storage/box/hug/medical,/obj/item/storage/box/hug/medical,/obj/effect/decal/cleanable/dirt,/obj/effect/decal/cleanable/robot_debris,/turf/open/floor/plasteel/yellowsiding,/area/ruin/powered)
"sWb" = (/obj/effect/decal/cleanable/generic,/obj/effect/decal/cleanable/dirt,/obj/item/circuitboard/computer/crew,/obj/item/trash/chips,/turf/open/floor/plasteel,/area/ruin/powered)
"tlw" = (/obj/structure/shuttle/engine/heater{dir = 8; icon_state = "heater"},/turf/closed/wall/mineral/titanium/interior,/area/ruin/powered)
"ues" = (/obj/effect/decal/cleanable/generic,/obj/effect/decal/cleanable/dirt,/obj/effect/decal/cleanable/molten_object,/obj/item/restraints/handcuffs,/turf/open/floor/plasteel/yellowsiding{dir = 1},/area/ruin/powered)
"ukS" = (/obj/machinery/door/airlock/external/glass,/turf/open/floor/plating,/area/ruin/powered)
"vaa" = (/obj/item/trash/candy,/obj/item/trash/chips,/obj/item/trash/sosjerky,/obj/item/trash/sosjerky,/obj/item/trash/raisins,/obj/item/trash/cheesie,/obj/item/trash/cheesie,/obj/item/trash/cheesie,/obj/item/trash/cheesie,/obj/effect/decal/cleanable/generic,/obj/effect/decal/cleanable/dirt,/obj/effect/decal/cleanable/dirt,/obj/effect/decal/cleanable/dirt,/turf/open/floor/plasteel,/area/ruin/powered)
"vcM" = (/obj/machinery/computer,/turf/open/floor/plasteel,/area/ruin/powered)
"vKg" = (/obj/item/reagent_containers/food/snacks/deadmouse,/obj/effect/decal/cleanable/dirt,/obj/item/wallframe/apc,/obj/item/electronics/apc,/turf/open/floor/plasteel,/area/ruin/powered)
"xKx" = (/obj/structure/chair/office/dark{dir = 1},/obj/effect/decal/cleanable/dirt,/turf/open/floor/plasteel,/area/ruin/powered)

(1,1,1) = {"
arG
arG
arG
arG
arG
arG
arG
arG
arG
arG
"}
(2,1,1) = {"
arG
arG
arG
jxG
ukS
ukS
jxG
arG
arG
arG
"}
(3,1,1) = {"
arG
arG
bOD
tlw
lwe
ehV
tlw
bOD
arG
arG
"}
(4,1,1) = {"
arG
arG
bOD
eeA
sWb
esz
slU
bOD
arG
arG
"}
(5,1,1) = {"
arG
arG
okN
ues
kQD
vaa
qXw
okN
arG
arG
"}
(6,1,1) = {"
arG
arG
okN
dJS
vKg
gBY
sAd
okN
arG
arG
"}
(7,1,1) = {"
arG
arG
bOD
fod
xKx
qKU
fzI
bOD
arG
arG
"}
(8,1,1) = {"
arG
arG
bOD
bOD
lrS
vcM
bOD
bOD
arG
arG
"}
(9,1,1) = {"
arG
arG
arG
bOD
bOD
bOD
bOD
arG
arG
arG
"}
(10,1,1) = {"
arG
arG
arG
arG
arG
arG
arG
arG
arG
arG
"}
