//MAP CONVERTED BY dmm2tgm.py THIS HEADER COMMENT PREVENTS RECONVERSION, DO NOT REMOVE
"a" = (
/turf/closed/mineral/volcanic/lava_land_surface,
/area/lavaland/surface/outdoors)
"b" = (
/turf/open/floor/plating/asteroid/basalt/lava_land_surface,
/area/lavaland/surface/outdoors)
"c" = (
/obj/structure/disposalpipe/segment,
/obj/machinery/hydroponics/constructable,
/turf/open/floor/plasteel/freezer,
/area/ruin/powered/seedvault)
"d" = (
/obj/structure/table/wood,
/obj/item/lighter,
/obj/item/lighter,
/obj/item/storage/box/fancy/rollingpapers,
/obj/item/storage/box/fancy/rollingpapers,
/obj/item/storage/box/fancy/rollingpapers,
/obj/item/storage/box/fancy/rollingpapers,
/turf/open/floor/plasteel/freezer,
/area/ruin/powered/seedvault)
"e" = (
/obj/structure/table/wood,
/obj/item/storage/box/disks_plantgene,
/turf/open/floor/plasteel/freezer,
/area/ruin/powered/seedvault)
"f" = (
/obj/machinery/plantgenes/seedvault{
	pixel_y = 6
	},
/obj/structure/table/wood,
/turf/open/floor/plasteel/freezer,
/area/ruin/powered/seedvault)
"g" = (
/obj/structure/table/wood,
/obj/machinery/smartfridge/disks{
	pixel_y = 2
	},
/turf/open/floor/plasteel/freezer,
/area/ruin/powered/seedvault)
"h" = (
/turf/open/floor/plasteel/freezer,
/area/ruin/powered/seedvault)
"i" = (
/obj/structure/closet/crate/hydroponics,
/obj/structure/beebox,
/obj/item/melee/flyswatter,
/obj/item/honey_frame,
/obj/item/honey_frame,
/obj/item/honey_frame,
/obj/item/queen_bee/bought,
/obj/item/clothing/head/beekeeper_head,
/obj/item/clothing/suit/beekeeper_suit,
/turf/open/floor/plasteel/freezer,
/area/ruin/powered/seedvault)
"j" = (
/obj/structure/shuttle/engine/propulsion{
	dir = 4
	},
/turf/open/floor/plating/asteroid/basalt/lava_land_surface,
/area/ruin/powered/seedvault)
"k" = (
/obj/structure/closet/crate,
/obj/effect/spawner/lootdrop/seed_vault,
/turf/open/floor/plasteel/freezer,
/area/ruin/powered/seedvault)
"m" = (
/obj/machinery/door/airlock/external,
/obj/structure/fans/tiny,
/obj/effect/mapping_helpers/airlock/cyclelink_helper{
	dir = 8
	},
/turf/open/floor/plasteel/freezer,
/area/ruin/powered/seedvault)
"n" = (
/obj/structure/sink{
	pixel_y = 20
	},
/turf/open/floor/plasteel/freezer,
/area/ruin/powered/seedvault)
"p" = (
/obj/machinery/hydroponics/constructable,
/turf/open/floor/plasteel/freezer,
/area/ruin/powered/seedvault)
"q" = (
/turf/open/floor/plating/asteroid/basalt/lava_land_surface,
/area/ruin/powered/seedvault)
"r" = (
/obj/machinery/light/small{
	dir = 8
	},
/turf/open/floor/plating/asteroid/basalt/lava_land_surface,
/area/lavaland/surface/outdoors)
"s" = (
/obj/machinery/light{
	dir = 1
	},
/obj/machinery/biogenerator,
/turf/open/floor/plasteel/freezer,
/area/ruin/powered/seedvault)
"t" = (
/obj/effect/mob_spawn/human/seed_vault,
/turf/open/floor/plasteel/freezer,
/area/ruin/powered/seedvault)
"u" = (
/obj/structure/sink{
	dir = 8;
	pixel_x = -12;
	pixel_y = 2
	},
/turf/open/floor/plasteel/freezer,
/area/ruin/powered/seedvault)
"x" = (
/obj/machinery/reagentgrinder{
	pixel_y = 5
	},
/obj/structure/table/glass,
/obj/item/reagent_containers/glass/beaker/bluespace,
/obj/item/reagent_containers/glass/beaker/bluespace,
/obj/item/reagent_containers/glass/beaker/bluespace,
/obj/item/reagent_containers/glass/beaker/bluespace,
/turf/open/floor/plasteel/freezer,
/area/ruin/powered/seedvault)
"y" = (
/obj/effect/spawner/lootdrop/seed_vault,
/obj/structure/closet/crate,
/turf/open/floor/plasteel/freezer,
/area/ruin/powered/seedvault)
"z" = (
/obj/machinery/door/airlock/external,
/obj/effect/mapping_helpers/airlock/cyclelink_helper{
	dir = 4
	},
/turf/open/floor/plasteel/freezer,
/area/ruin/powered/seedvault)
"A" = (
/obj/machinery/door/airlock,
/obj/machinery/door/firedoor/border_only,
/obj/machinery/door/firedoor/border_only{
	dir = 1
	},
/turf/open/floor/plasteel/freezer,
/area/ruin/powered/seedvault)
"B" = (
/obj/structure/disposalpipe/segment{
	dir = 6
	},
/turf/open/floor/plasteel/freezer,
/area/ruin/powered/seedvault)
"C" = (
/obj/machinery/seed_extractor,
/turf/open/floor/plasteel/freezer,
/area/ruin/powered/seedvault)
"D" = (
/obj/machinery/disposal/bin,
/obj/structure/disposalpipe/trunk{
	dir = 8
	},
/turf/open/floor/plasteel/freezer,
/area/ruin/powered/seedvault)
"E" = (
/obj/machinery/chem_dispenser/mutagensaltpeter,
/turf/open/floor/plasteel/freezer,
/area/ruin/powered/seedvault)
"F" = (
/obj/structure/disposalpipe/segment,
/turf/open/floor/plasteel/freezer,
/area/ruin/powered/seedvault)
"G" = (
/obj/structure/closet/crate/hydroponics,
/obj/item/clothing/under/rank/hydroponics,
/obj/item/clothing/under/rank/hydroponics,
/obj/item/clothing/under/rank/hydroponics,
/obj/item/clothing/under/rank/hydroponics,
/turf/open/floor/plasteel/freezer,
/area/ruin/powered/seedvault)
"H" = (
/obj/machinery/chem_master/condimaster,
/turf/open/floor/plasteel/freezer,
/area/ruin/powered/seedvault)
"I" = (
/obj/structure/table/wood,
/obj/item/reagent_containers/glass/bucket,
/obj/item/reagent_containers/glass/bucket,
/obj/item/reagent_containers/glass/bucket,
/obj/item/reagent_containers/glass/bucket,
/turf/open/floor/plasteel/freezer,
/area/ruin/powered/seedvault)
"J" = (
/obj/item/storage/toolbox/syndicate,
/obj/structure/table/wood,
/turf/open/floor/plasteel/freezer,
/area/ruin/powered/seedvault)
"L" = (
/obj/structure/disposalpipe/segment{
	dir = 5
	},
/turf/open/floor/plating/asteroid/basalt/lava_land_surface,
/area/lavaland/surface/outdoors)
"N" = (
/obj/structure/table/wood,
/obj/item/storage/box/disks_plantgene,
/obj/machinery/light{
	dir = 1
	},
/turf/open/floor/plasteel/freezer,
/area/ruin/powered/seedvault)
"O" = (
/obj/machinery/light{
	dir = 1
	},
/turf/open/floor/plasteel/freezer,
/area/ruin/powered/seedvault)
"P" = (
/obj/structure/disposalpipe/trunk{
	dir = 8
	},
/obj/machinery/disposal/deliveryChute{
	dir = 4
	},
/turf/open/floor/plating/asteroid/basalt/lava_land_surface,
/area/lavaland/surface/outdoors)
"Q" = (
/turf/closed/wall/r_wall,
/area/ruin/powered/seedvault)
"R" = (
/obj/machinery/smartfridge,
/turf/closed/wall/r_wall,
/area/ruin/powered/seedvault)
"U" = (
/obj/machinery/light,
/turf/open/floor/plasteel/freezer,
/area/ruin/powered/seedvault)
"V" = (
/obj/structure/disposalpipe/segment,
/turf/closed/wall/r_wall,
/area/ruin/powered/seedvault)
"X" = (
/obj/machinery/hydroponics/constructable,
/obj/machinery/light,
/turf/open/floor/plasteel/freezer,
/area/ruin/powered/seedvault)
"Z" = (
/obj/machinery/door/airlock,
/obj/machinery/door/firedoor/border_only{
	dir = 4
	},
/obj/machinery/door/firedoor/border_only{
	dir = 8
	},
/turf/open/floor/plasteel/freezer,
/area/ruin/powered/seedvault)

(1,1,1) = {"
a
a
a
a
a
a
a
Q
Q
Q
Q
Q
Q
a
a
a
a
a
a
a
"}
(2,1,1) = {"
a
a
a
a
a
a
a
Q
t
t
t
t
Q
a
a
a
a
a
a
a
"}
(3,1,1) = {"
b
a
a
a
a
a
Q
Q
O
h
h
U
Q
Q
a
b
a
a
a
a
"}
(4,1,1) = {"
b
a
a
a
Q
Q
Q
Q
Q
Z
Z
Q
Q
Q
Q
Q
a
a
a
a
"}
(5,1,1) = {"
a
a
a
Q
Q
g
k
Q
u
h
h
u
Q
p
p
Q
Q
a
a
a
"}
(6,1,1) = {"
a
a
a
Q
d
h
h
Q
h
h
h
h
Q
h
h
p
Q
a
a
a
"}
(7,1,1) = {"
a
a
a
Q
N
h
h
Q
O
h
h
U
Q
n
h
X
Q
b
b
a
"}
(8,1,1) = {"
b
a
a
Q
e
h
h
A
h
h
h
B
A
F
F
c
V
L
b
a
"}
(9,1,1) = {"
b
a
a
Q
f
h
h
Q
h
h
h
D
Q
C
h
p
Q
P
b
a
"}
(10,1,1) = {"
a
a
a
Q
H
h
h
Q
h
h
h
h
R
h
h
p
Q
b
b
a
"}
(11,1,1) = {"
a
a
a
Q
E
h
h
Q
h
h
h
h
Q
h
h
p
Q
b
b
a
"}
(12,1,1) = {"
b
a
a
Q
s
h
h
Q
O
h
h
X
Q
h
h
X
Q
b
a
a
"}
(13,1,1) = {"
a
a
a
Q
x
h
h
Q
G
h
h
I
Q
h
h
p
Q
b
a
a
"}
(14,1,1) = {"
a
a
a
Q
Q
i
i
Q
y
h
h
J
Q
p
p
Q
Q
b
a
a
"}
(15,1,1) = {"
a
a
a
b
Q
Q
Q
Q
Q
z
z
Q
Q
Q
Q
Q
a
b
a
a
"}
(16,1,1) = {"
a
a
a
a
q
j
Q
j
Q
h
h
Q
j
Q
j
a
a
b
a
a
"}
(17,1,1) = {"
a
a
a
a
a
b
b
b
Q
m
m
Q
b
b
b
a
a
a
a
b
"}
(18,1,1) = {"
a
a
a
b
b
b
b
b
r
b
b
r
b
b
a
a
a
a
b
b
"}
(19,1,1) = {"
a
a
a
a
b
b
a
b
b
b
b
b
b
b
a
a
a
b
b
b
"}
(20,1,1) = {"
a
a
a
b
b
b
a
b
b
b
b
b
b
b
a
a
a
b
b
a
"}
