// This map has been converted using maphash
"arG" = (/turf/template_noop,/area/template_noop)
"axf" = (/obj/structure/stone_tile/surrounding/cracked{dir = 6},/obj/structure/stone_tile/center,/turf/open/floor/plating/asteroid/basalt/lava_land_surface,/area/lavaland/surface/outdoors)
"aUr" = (/obj/structure/stone_tile{dir = 1},/turf/open/floor/plating/asteroid/basalt/lava_land_surface,/area/lavaland/surface/outdoors)
"bia" = (/obj/structure/stone_tile/block/cracked,/turf/open/floor/plating/asteroid/basalt/lava_land_surface,/area/lavaland/surface/outdoors)
"bWm" = (/obj/structure/stone_tile{dir = 4},/turf/open/floor/plating/asteroid/basalt/lava_land_surface,/area/lavaland/surface/outdoors)
"csg" = (/obj/structure/stone_tile,/obj/structure/stone_tile{dir = 4},/obj/structure/stone_tile/cracked{dir = 8},/turf/open/floor/plating/asteroid/basalt/lava_land_surface,/area/lavaland/surface/outdoors)
"cKc" = (/obj/structure/stone_tile{dir = 4},/obj/structure/stone_tile/cracked,/obj/structure/stone_tile{dir = 8},/turf/open/floor/plating/asteroid/basalt/lava_land_surface,/area/lavaland/surface/outdoors)
"dxD" = (/obj/structure/stone_tile/cracked,/obj/structure/stone_tile{dir = 8},/obj/structure/stone_tile{dir = 1},/turf/open/floor/plating/asteroid/basalt/lava_land_surface,/area/lavaland/surface/outdoors)
"dUl" = (/obj/structure/stone_tile/block{dir = 8},/obj/structure/stone_tile/block{dir = 4},/turf/open/floor/plating/asteroid/basalt/lava_land_surface,/area/lavaland/surface/outdoors)
"ikU" = (/turf/closed/mineral/volcanic/lava_land_surface,/area/lavaland/surface/outdoors)
"iEf" = (/obj/structure/stone_tile/block{dir = 8},/obj/structure/stone_tile/block{dir = 4},/mob/living/simple_animal/hostile/megafauna/blood_drunk_miner/hunter,/turf/open/floor/plating/asteroid/basalt/lava_land_surface,/area/lavaland/surface/outdoors)
"mhD" = (/obj/structure/stone_tile/block{dir = 8},/obj/structure/stone_tile/block/cracked{dir = 4},/turf/open/floor/plating/asteroid/basalt/lava_land_surface,/area/lavaland/surface/outdoors)
"oco" = (/obj/structure/stone_tile{dir = 8},/obj/structure/stone_tile,/obj/structure/stone_tile/cracked{dir = 4},/turf/open/floor/plating/asteroid/basalt/lava_land_surface,/area/lavaland/surface/outdoors)
"pss" = (/obj/structure/stone_tile/block{dir = 4},/obj/structure/stone_tile/block/cracked{dir = 8},/turf/open/floor/plating/asteroid/basalt/lava_land_surface,/area/lavaland/surface/outdoors)
"rdR" = (/obj/structure/stone_tile/surrounding_tile{dir = 8},/turf/open/floor/plating/asteroid/basalt/lava_land_surface,/area/lavaland/surface/outdoors)
"rll" = (/obj/structure/stone_tile/cracked{dir = 4},/turf/open/floor/plating/asteroid/basalt/lava_land_surface,/area/lavaland/surface/outdoors)
"sUY" = (/obj/structure/stone_tile{dir = 1},/obj/structure/stone_tile{dir = 8},/obj/structure/stone_tile,/turf/open/floor/plating/asteroid/basalt/lava_land_surface,/area/lavaland/surface/outdoors)
"tzY" = (/obj/structure/stone_tile{dir = 8},/obj/structure/stone_tile{dir = 1},/obj/structure/stone_tile/cracked,/turf/open/floor/plating/asteroid/basalt/lava_land_surface,/area/lavaland/surface/outdoors)
"uuu" = (/obj/structure/stone_tile{dir = 4},/obj/structure/stone_tile{dir = 8},/obj/structure/stone_tile/cracked,/turf/open/floor/plating/asteroid/basalt/lava_land_surface,/area/lavaland/surface/outdoors)
"uyg" = (/obj/structure/stone_tile{dir = 1},/obj/structure/stone_tile/cracked{dir = 8},/obj/structure/stone_tile,/turf/open/floor/plating/asteroid/basalt/lava_land_surface,/area/lavaland/surface/outdoors)
"vHQ" = (/obj/structure/stone_tile/surrounding_tile/cracked,/turf/open/floor/plating/asteroid/basalt/lava_land_surface,/area/lavaland/surface/outdoors)
"wUl" = (/turf/open/floor/plating/asteroid/basalt/lava_land_surface,/area/lavaland/surface/outdoors)

(1,1,1) = {"
arG
arG
arG
arG
arG
arG
arG
arG
ikU
ikU
ikU
ikU
ikU
arG
arG
arG
"}
(2,1,1) = {"
arG
ikU
ikU
ikU
arG
arG
ikU
ikU
ikU
wUl
wUl
ikU
ikU
ikU
arG
arG
"}
(3,1,1) = {"
ikU
ikU
ikU
ikU
ikU
ikU
ikU
ikU
wUl
bWm
uuu
wUl
wUl
ikU
ikU
arG
"}
(4,1,1) = {"
ikU
wUl
wUl
ikU
ikU
ikU
wUl
wUl
bWm
dxD
aUr
cKc
wUl
wUl
ikU
ikU
"}
(5,1,1) = {"
ikU
wUl
wUl
wUl
wUl
wUl
wUl
bWm
tzY
wUl
wUl
aUr
vHQ
wUl
wUl
ikU
"}
(6,1,1) = {"
ikU
dUl
mhD
mhD
dUl
pss
dUl
pss
mhD
dUl
iEf
pss
bia
axf
wUl
ikU
"}
(7,1,1) = {"
ikU
wUl
wUl
wUl
wUl
wUl
wUl
aUr
csg
wUl
wUl
rll
rdR
wUl
ikU
ikU
"}
(8,1,1) = {"
ikU
ikU
ikU
wUl
wUl
wUl
wUl
wUl
aUr
oco
rll
sUY
wUl
ikU
ikU
ikU
"}
(9,1,1) = {"
arG
ikU
ikU
ikU
ikU
wUl
wUl
wUl
wUl
aUr
uyg
wUl
wUl
ikU
ikU
arG
"}
(10,1,1) = {"
arG
arG
arG
ikU
ikU
ikU
ikU
ikU
wUl
wUl
wUl
wUl
ikU
ikU
arG
arG
"}
(11,1,1) = {"
arG
arG
arG
arG
arG
ikU
ikU
ikU
ikU
ikU
ikU
ikU
ikU
ikU
arG
arG
"}
