//MAP CONVERTED BY dmm2tgm.py THIS HEADER COMMENT PREVENTS RECONVERSION, DO NOT REMOVE
"a" = (
/turf/template_noop,
/area/template_noop)
"b" = (
/turf/open/floor/plating/asteroid/basalt/lava_land_surface,
/area/lavaland/surface/outdoors)
"c" = (
/obj/structure/lattice,
/turf/open/floor/plating/asteroid/basalt/lava_land_surface,
/area/lavaland/surface/outdoors)
"d" = (
/turf/closed/wall,
/area/ruin/unpowered)
"e" = (
/obj/machinery/light{
	dir = 4
	},
/obj/structure/table/wood,
/obj/effect/spawner/lootdrop/pizzaparty,
/obj/effect/decal/cleanable/dirt,
/obj/effect/decal/cleanable/cobweb/cobweb2,
/turf/open/floor/wood/lavaland,
/area/ruin/unpowered)
"g" = (
/obj/effect/decal/remains/human,
/obj/effect/decal/cleanable/dirt,
/turf/open/floor/wood/lavaland,
/area/ruin/unpowered)
"h" = (
/obj/effect/decal/cleanable/dirt,
/obj/item/a_gift,
/turf/open/floor/wood/lavaland,
/area/ruin/unpowered)
"i" = (
/obj/structure/glowshroom/single,
/obj/effect/decal/cleanable/dirt,
/turf/open/floor/wood/lavaland,
/area/ruin/unpowered)
"j" = (
/obj/item/reagent_containers/food/snacks/pizzaslice/mushroom,
/obj/effect/decal/cleanable/dirt,
/turf/open/floor/plating/lavaland_baseturf,
/area/ruin/unpowered)
"k" = (
/obj/structure/table/wood,
/obj/item/reagent_containers/food/snacks/pizzaslice/margherita,
/obj/item/trash/plate,
/turf/open/floor/wood/lavaland,
/area/ruin/unpowered)
"l" = (
/obj/structure/chair/wood/wings{
	dir = 4
	},
/obj/effect/decal/cleanable/dirt,
/turf/open/floor/plating/lavaland_baseturf,
/area/ruin/unpowered)
"m" = (
/obj/structure/table/wood,
/obj/item/trash/plate,
/turf/open/floor/wood/lavaland,
/area/ruin/unpowered)
"n" = (
/obj/structure/glowshroom/single,
/turf/open/floor/wood/lavaland,
/area/ruin/unpowered)
"o" = (
/obj/structure/table/wood,
/obj/item/storage/box/cups,
/turf/open/floor/wood/lavaland,
/area/ruin/unpowered)
"p" = (
/obj/structure/table/wood,
/obj/effect/spawner/lootdrop/pizzaparty,
/obj/effect/decal/cleanable/dirt,
/turf/open/floor/wood/lavaland,
/area/ruin/unpowered)
"q" = (
/obj/item/chair/wood/wings,
/obj/effect/decal/cleanable/dirt,
/turf/open/floor/wood/lavaland,
/area/ruin/unpowered)
"r" = (
/obj/structure/reagent_dispensers/water_cooler{
	name = "punch cooler";
	reagent_id = /datum/reagent/consumable/ethanol/bacchus_blessing
	},
/obj/effect/decal/cleanable/dirt,
/turf/open/floor/wood/lavaland,
/area/ruin/unpowered)
"t" = (
/obj/effect/decal/cleanable/dirt,
/turf/open/floor/plating/lavaland_baseturf,
/area/ruin/unpowered)
"u" = (
/obj/structure/table/wood,
/obj/item/reagent_containers/food/snacks/pizzaslice/meat,
/turf/open/floor/wood/lavaland,
/area/ruin/unpowered)
"v" = (
/obj/structure/lattice,
/obj/item/chair/wood/wings,
/turf/open/floor/plating/asteroid/basalt/lava_land_surface,
/area/lavaland/surface/outdoors)
"w" = (
/obj/structure/table/wood,
/obj/item/trash/plate,
/obj/item/kitchen/fork,
/turf/open/floor/wood/lavaland,
/area/ruin/unpowered)
"x" = (
/obj/structure/glowshroom/single,
/obj/effect/decal/cleanable/dirt,
/turf/open/floor/plating/lavaland_baseturf,
/area/ruin/unpowered)
"y" = (
/obj/machinery/light{
	dir = 4
	},
/obj/effect/decal/cleanable/dirt,
/turf/open/floor/wood/lavaland,
/area/ruin/unpowered)
"z" = (
/obj/item/kitchen/knife,
/obj/effect/decal/cleanable/dirt,
/turf/open/floor/wood/lavaland,
/area/ruin/unpowered)
"A" = (
/obj/structure/table/wood,
/obj/item/reagent_containers/food/snacks/store/cake/birthday,
/turf/open/floor/wood/lavaland,
/area/ruin/unpowered)
"B" = (
/obj/item/trash/plate,
/obj/effect/decal/cleanable/dirt,
/turf/open/floor/wood/lavaland,
/area/ruin/unpowered)
"C" = (
/obj/effect/decal/cleanable/dirt,
/turf/open/floor/wood/lavaland,
/area/ruin/unpowered)
"D" = (
/obj/structure/chair/wood/wings,
/obj/effect/decal/remains/human,
/obj/item/clothing/head/festive{
	desc = "A festive party hat with the name 'timmy' scribbled on the front.";
	name = "party hat"
	},
/turf/open/floor/wood/lavaland,
/area/ruin/unpowered)
"G" = (
/obj/effect/decal/cleanable/dirt,
/obj/effect/decal/cleanable/dirt,
/turf/open/floor/wood/lavaland,
/area/ruin/unpowered)
"H" = (
/obj/item/chair/wood/wings,
/turf/open/floor/wood/lavaland,
/area/ruin/unpowered)
"K" = (
/obj/structure/table/wood,
/obj/effect/spawner/lootdrop/pizzaparty,
/turf/open/floor/wood/lavaland,
/area/ruin/unpowered)
"L" = (
/obj/structure/chair/wood/wings,
/obj/effect/decal/remains/human,
/turf/open/floor/wood/lavaland,
/area/ruin/unpowered)
"M" = (
/obj/item/kitchen/fork,
/obj/effect/decal/cleanable/dirt,
/turf/open/floor/wood/lavaland,
/area/ruin/unpowered)
"N" = (
/obj/structure/lattice,
/obj/effect/decal/cleanable/dirt,
/turf/open/floor/plating/asteroid/basalt/lava_land_surface,
/area/lavaland/surface/outdoors)
"O" = (
/obj/item/chair/wood/wings,
/obj/effect/decal/cleanable/dirt,
/turf/open/floor/plating/lavaland_baseturf,
/area/ruin/unpowered)
"P" = (
/obj/effect/decal/cleanable/dirt,
/obj/effect/decal/cleanable/dirt,
/turf/open/floor/plating/lavaland_baseturf,
/area/ruin/unpowered)
"Q" = (
/obj/item/kitchen/fork,
/obj/effect/decal/cleanable/dirt,
/turf/open/floor/plating/lavaland_baseturf,
/area/ruin/unpowered)
"T" = (
/obj/structure/table/wood,
/obj/structure/glowshroom/single,
/obj/item/a_gift,
/turf/open/floor/wood/lavaland,
/area/ruin/unpowered)
"U" = (
/turf/open/floor/plating/lavaland_baseturf,
/area/ruin/unpowered)
"W" = (
/turf/open/floor/wood/lavaland,
/area/ruin/unpowered)
"X" = (
/obj/structure/chair/wood/wings{
	dir = 1
	},
/obj/effect/decal/remains/human,
/obj/effect/decal/cleanable/dirt,
/turf/open/floor/wood/lavaland,
/area/ruin/unpowered)
"Z" = (
/obj/structure/table/wood,
/turf/open/floor/wood/lavaland,
/area/ruin/unpowered)

(1,1,1) = {"
a
a
b
b
a
a
b
b
b
b
b
b
b
b
a
a
a
a
"}
(2,1,1) = {"
b
b
b
b
b
b
b
b
b
b
c
c
b
b
b
b
a
a
"}
(3,1,1) = {"
b
b
b
b
b
b
b
b
c
c
t
t
c
c
b
b
b
a
"}
(4,1,1) = {"
b
b
b
b
d
b
c
c
t
C
C
t
U
t
d
b
b
a
"}
(5,1,1) = {"
a
b
b
b
d
b
O
t
M
C
M
C
C
t
d
b
b
b
"}
(6,1,1) = {"
a
b
b
b
d
o
i
C
C
c
t
h
t
c
b
b
b
b
"}
(7,1,1) = {"
b
b
b
b
d
r
B
C
C
l
x
C
d
b
b
b
b
b
"}
(8,1,1) = {"
b
b
b
b
t
C
g
q
K
k
X
h
d
b
b
b
b
b
"}
(9,1,1) = {"
b
b
b
c
t
G
C
D
m
u
C
C
c
b
b
b
b
b
"}
(10,1,1) = {"
b
b
b
c
t
j
C
W
T
A
q
N
c
b
b
b
b
b
"}
(11,1,1) = {"
b
b
b
b
t
t
C
L
w
Z
q
C
c
b
b
b
b
b
"}
(12,1,1) = {"
b
b
b
b
d
p
C
W
W
H
C
z
d
b
b
b
b
b
"}
(13,1,1) = {"
b
b
b
b
d
p
C
n
W
W
B
i
d
b
b
b
b
a
"}
(14,1,1) = {"
b
b
b
b
d
e
G
C
t
Q
P
y
d
b
b
b
b
a
"}
(15,1,1) = {"
b
b
b
b
d
d
t
t
N
t
t
d
d
b
b
b
b
a
"}
(16,1,1) = {"
a
b
b
b
b
b
c
v
b
c
b
b
b
b
b
b
b
a
"}
(17,1,1) = {"
a
b
b
b
b
b
b
b
b
b
b
b
b
b
b
a
a
a
"}
(18,1,1) = {"
a
a
a
a
b
b
b
b
b
b
b
b
a
a
a
a
a
a
"}
