// This map has been converted using maphash
"cuh" = (/obj/mecha/working/ripley/mining{ruin_mecha = 1},/turf/open/floor/plating/asteroid/basalt/lava_land_surface,/area/lavaland/surface/outdoors)
"hBM" = (/obj/item/clothing/shoes/workboots/mining,/obj/item/clothing/under/rank/miner/lavaland,/obj/effect/decal/remains/human,/turf/open/floor/plating/asteroid/basalt/lava_land_surface,/area/lavaland/surface/outdoors)
"ikU" = (/turf/closed/mineral/volcanic/lava_land_surface,/area/lavaland/surface/outdoors)
"mvi" = (/turf/template_noop,/area/lavaland/surface/outdoors)
"wUl" = (/turf/open/floor/plating/asteroid/basalt/lava_land_surface,/area/lavaland/surface/outdoors)

(1,1,1) = {"
mvi
ikU
ikU
ikU
mvi
"}
(2,1,1) = {"
ikU
wUl
ikU
wUl
ikU
"}
(3,1,1) = {"
ikU
wUl
cuh
hBM
ikU
"}
(4,1,1) = {"
ikU
wUl
wUl
ikU
ikU
"}
(5,1,1) = {"
ikU
ikU
ikU
ikU
mvi
"}
