//MAP CONVERTED BY dmm2tgm.py THIS HEADER COMMENT PREVENTS RECONVERSION, DO NOT REMOVE
"a" = (
/turf/template_noop,
/area/template_noop)
"b" = (
/turf/closed/wall/mineral/titanium/nodiagonal,
/area/ruin/powered)
"c" = (
/obj/machinery/door/airlock/external,
/obj/structure/fans/tiny/invisible,
/turf/open/floor/mineral/plastitanium/red/brig,
/area/ruin/powered)
"d" = (
/turf/closed/wall/mineral/titanium/interior,
/area/ruin/powered)
"e" = (
/turf/open/floor/mineral/plastitanium/red/brig,
/area/ruin/powered)
"f" = (
/obj/effect/decal/cleanable/blood,
/obj/effect/mob_spawn/human/corpse/syndicatesoldier,
/turf/open/floor/mineral/plastitanium/red/brig,
/area/ruin/powered)
"g" = (
/obj/item/ammo_casing/a762,
/turf/open/floor/mineral/plastitanium/red/brig,
/area/ruin/powered)
"h" = (
/obj/effect/decal/cleanable/xenoblood,
/obj/machinery/light{
	dir = 1
	},
/obj/item/tank/internals/oxygen,
/turf/open/floor/mineral/plastitanium/red/brig,
/area/ruin/powered)
"i" = (
/obj/machinery/door/airlock/hatch,
/obj/structure/fans/tiny/invisible,
/turf/open/floor/mineral/plastitanium/red/brig,
/area/ruin/powered)
"j" = (
/turf/closed/wall/mineral/titanium,
/area/ruin/powered)
"k" = (
/obj/structure/chair,
/mob/living/simple_animal/hostile/alien/sentinel,
/turf/open/floor/mineral/plastitanium/red/brig,
/area/ruin/powered)
"l" = (
/obj/structure/chair,
/turf/open/floor/mineral/plastitanium/red/brig,
/area/ruin/powered)
"m" = (
/obj/effect/decal/cleanable/blood,
/obj/item/chair,
/obj/effect/mob_spawn/human/corpse/syndicatesoldier,
/turf/open/floor/mineral/plastitanium/red/brig,
/area/ruin/powered)
"n" = (
/obj/item/trash/syndi_cakes,
/turf/open/floor/mineral/plastitanium/red/brig,
/area/ruin/powered)
"o" = (
/obj/effect/decal/cleanable/blood,
/turf/open/floor/mineral/plastitanium/red/brig,
/area/ruin/powered)
"p" = (
/obj/effect/decal/cleanable/xenoblood,
/turf/open/floor/mineral/plastitanium/red/brig,
/area/ruin/powered)
"q" = (
/obj/machinery/light{
	dir = 4;
	icon_state = "tube1"
	},
/turf/open/floor/mineral/plastitanium/red/brig,
/area/ruin/powered)
"r" = (
/obj/machinery/light{
	icon_state = "tube1";
	dir = 8
	},
/turf/open/floor/mineral/plastitanium/red/brig,
/area/ruin/powered)
"s" = (
/obj/item/chair,
/turf/open/floor/mineral/plastitanium/red/brig,
/area/ruin/powered)
"t" = (
/obj/structure/closet/crate,
/obj/item/clothing/glasses/meson/night,
/obj/item/toy/nuke,
/obj/item/toy/figure/syndie,
/turf/open/floor/mineral/plastitanium/red/brig,
/area/ruin/powered)
"u" = (
/obj/structure/table,
/obj/item/gun/ballistic/automatic/pistol,
/turf/open/floor/mineral/plastitanium/red/brig,
/area/ruin/powered)
"v" = (
/obj/structure/shuttle/engine/propulsion,
/turf/template_noop,
/area/ruin/powered)
"w" = (
/obj/structure/shuttle/engine/platform,
/turf/closed/wall/mineral/titanium,
/area/ruin/powered)

(1,1,1) = {"
a
a
a
a
a
a
a
a
a
a
"}
(2,1,1) = {"
b
d
d
d
d
d
j
b
a
a
"}
(3,1,1) = {"
j
e
j
k
n
r
f
w
v
a
"}
(4,1,1) = {"
d
f
j
l
o
e
s
j
a
a
"}
(5,1,1) = {"
c
g
i
e
p
e
t
j
a
a
"}
(6,1,1) = {"
d
h
j
l
e
o
p
j
a
a
"}
(7,1,1) = {"
j
e
j
m
q
e
u
w
v
a
"}
(8,1,1) = {"
b
d
d
j
j
j
j
b
a
a
"}
(9,1,1) = {"
a
a
a
a
a
a
a
a
a
a
"}
(10,1,1) = {"
a
a
a
a
a
a
a
a
a
a
"}
