// This map has been converted using maphash
"akW" = (/turf/closed/indestructible/riveted,/area/lavaland/surface/outdoors)
"daU" = (/obj/effect/decal/remains/human,/turf/open/floor/plating/asteroid/basalt/lava_land_surface,/area/lavaland/surface/outdoors)
"ikU" = (/turf/closed/mineral/volcanic/lava_land_surface,/area/lavaland/surface/outdoors)
"nJv" = (/obj/machinery/wish_granter,/obj/effect/mapping_helpers/no_lava,/turf/open/floor/plating/asteroid/basalt/lava_land_surface,/area/lavaland/surface/outdoors)
"wUl" = (/turf/open/floor/plating/asteroid/basalt/lava_land_surface,/area/lavaland/surface/outdoors)

(1,1,1) = {"
ikU
ikU
ikU
ikU
ikU
ikU
ikU
ikU
ikU
ikU
ikU
ikU
ikU
wUl
ikU
wUl
wUl
wUl
wUl
wUl
wUl
ikU
ikU
ikU
ikU
ikU
ikU
ikU
wUl
ikU
"}
(2,1,1) = {"
ikU
ikU
ikU
ikU
ikU
ikU
ikU
ikU
ikU
ikU
ikU
ikU
ikU
wUl
ikU
wUl
wUl
daU
wUl
wUl
wUl
wUl
ikU
ikU
ikU
ikU
ikU
ikU
ikU
ikU
"}
(3,1,1) = {"
ikU
wUl
ikU
ikU
ikU
ikU
wUl
ikU
ikU
ikU
ikU
ikU
ikU
ikU
wUl
ikU
wUl
wUl
wUl
ikU
ikU
wUl
wUl
ikU
ikU
wUl
wUl
ikU
ikU
ikU
"}
(4,1,1) = {"
ikU
ikU
ikU
ikU
wUl
wUl
wUl
ikU
ikU
ikU
ikU
ikU
ikU
ikU
wUl
wUl
wUl
ikU
ikU
wUl
wUl
wUl
wUl
wUl
wUl
wUl
wUl
ikU
wUl
wUl
"}
(5,1,1) = {"
ikU
ikU
wUl
wUl
wUl
wUl
wUl
ikU
ikU
ikU
ikU
ikU
ikU
ikU
ikU
ikU
wUl
wUl
wUl
wUl
wUl
wUl
wUl
wUl
wUl
wUl
wUl
ikU
ikU
wUl
"}
(6,1,1) = {"
wUl
ikU
ikU
ikU
ikU
ikU
ikU
ikU
ikU
ikU
ikU
ikU
ikU
wUl
wUl
wUl
wUl
wUl
wUl
wUl
wUl
wUl
wUl
wUl
wUl
wUl
wUl
wUl
ikU
wUl
"}
(7,1,1) = {"
wUl
ikU
ikU
ikU
ikU
ikU
ikU
ikU
ikU
ikU
wUl
wUl
wUl
wUl
wUl
wUl
wUl
daU
wUl
wUl
daU
wUl
wUl
wUl
daU
wUl
wUl
wUl
wUl
ikU
"}
(8,1,1) = {"
ikU
ikU
ikU
ikU
ikU
ikU
ikU
ikU
ikU
ikU
wUl
wUl
wUl
wUl
wUl
wUl
wUl
wUl
wUl
wUl
wUl
wUl
wUl
wUl
wUl
wUl
wUl
wUl
wUl
ikU
"}
(9,1,1) = {"
ikU
ikU
wUl
ikU
ikU
ikU
ikU
ikU
ikU
ikU
wUl
wUl
wUl
wUl
daU
wUl
wUl
wUl
wUl
wUl
wUl
wUl
wUl
wUl
wUl
wUl
wUl
wUl
wUl
wUl
"}
(10,1,1) = {"
ikU
ikU
ikU
ikU
ikU
ikU
ikU
ikU
ikU
ikU
ikU
ikU
wUl
wUl
wUl
wUl
wUl
daU
wUl
wUl
wUl
wUl
wUl
wUl
wUl
wUl
daU
wUl
wUl
wUl
"}
(11,1,1) = {"
ikU
ikU
ikU
wUl
ikU
ikU
ikU
ikU
ikU
ikU
ikU
ikU
ikU
wUl
wUl
wUl
wUl
wUl
wUl
wUl
wUl
wUl
wUl
daU
wUl
wUl
wUl
wUl
wUl
wUl
"}
(12,1,1) = {"
ikU
ikU
wUl
ikU
ikU
ikU
wUl
wUl
ikU
ikU
daU
wUl
wUl
wUl
wUl
wUl
daU
wUl
daU
wUl
wUl
wUl
wUl
wUl
wUl
wUl
wUl
wUl
wUl
wUl
"}
(13,1,1) = {"
ikU
ikU
wUl
wUl
wUl
wUl
wUl
wUl
wUl
wUl
wUl
wUl
daU
daU
wUl
daU
daU
wUl
wUl
wUl
wUl
wUl
wUl
wUl
wUl
wUl
wUl
wUl
daU
wUl
"}
(14,1,1) = {"
ikU
ikU
wUl
daU
wUl
wUl
wUl
wUl
daU
wUl
daU
akW
akW
akW
akW
akW
wUl
wUl
wUl
wUl
wUl
wUl
daU
wUl
wUl
wUl
wUl
wUl
wUl
wUl
"}
(15,1,1) = {"
ikU
ikU
wUl
wUl
wUl
wUl
daU
wUl
wUl
wUl
wUl
akW
akW
akW
akW
akW
wUl
daU
wUl
wUl
daU
wUl
ikU
wUl
wUl
wUl
wUl
wUl
wUl
wUl
"}
(16,1,1) = {"
ikU
ikU
wUl
wUl
wUl
wUl
wUl
wUl
wUl
daU
wUl
akW
akW
nJv
akW
akW
wUl
wUl
ikU
ikU
wUl
wUl
ikU
ikU
wUl
wUl
wUl
wUl
wUl
wUl
"}
(17,1,1) = {"
ikU
ikU
wUl
wUl
wUl
wUl
wUl
daU
wUl
wUl
daU
akW
akW
akW
akW
akW
daU
daU
ikU
ikU
ikU
ikU
ikU
ikU
ikU
wUl
wUl
ikU
wUl
wUl
"}
(18,1,1) = {"
ikU
ikU
wUl
ikU
ikU
ikU
wUl
wUl
wUl
wUl
wUl
akW
akW
akW
akW
akW
wUl
daU
wUl
ikU
ikU
ikU
ikU
ikU
wUl
wUl
wUl
daU
ikU
ikU
"}
(19,1,1) = {"
ikU
ikU
wUl
ikU
ikU
ikU
wUl
wUl
wUl
wUl
wUl
daU
wUl
daU
daU
wUl
daU
wUl
wUl
ikU
ikU
ikU
ikU
ikU
wUl
ikU
wUl
wUl
ikU
ikU
"}
(20,1,1) = {"
ikU
ikU
wUl
wUl
wUl
wUl
wUl
wUl
daU
wUl
wUl
wUl
daU
wUl
wUl
wUl
wUl
wUl
ikU
ikU
ikU
ikU
ikU
ikU
ikU
ikU
ikU
ikU
ikU
ikU
"}
(21,1,1) = {"
ikU
ikU
wUl
wUl
wUl
wUl
wUl
wUl
wUl
wUl
wUl
wUl
wUl
daU
wUl
wUl
wUl
wUl
wUl
ikU
ikU
ikU
ikU
ikU
ikU
ikU
ikU
ikU
ikU
ikU
"}
(22,1,1) = {"
ikU
ikU
wUl
wUl
wUl
wUl
ikU
wUl
wUl
wUl
ikU
wUl
wUl
wUl
wUl
wUl
wUl
wUl
wUl
wUl
ikU
ikU
ikU
ikU
ikU
ikU
ikU
ikU
ikU
ikU
"}
(23,1,1) = {"
ikU
ikU
ikU
ikU
ikU
ikU
wUl
wUl
wUl
wUl
wUl
wUl
wUl
wUl
wUl
wUl
daU
wUl
wUl
ikU
ikU
ikU
ikU
ikU
ikU
ikU
ikU
ikU
ikU
ikU
"}
(24,1,1) = {"
ikU
ikU
ikU
ikU
ikU
ikU
daU
wUl
wUl
wUl
wUl
wUl
wUl
wUl
daU
wUl
wUl
wUl
wUl
ikU
ikU
ikU
ikU
ikU
ikU
ikU
ikU
ikU
ikU
ikU
"}
(25,1,1) = {"
ikU
ikU
wUl
wUl
wUl
wUl
wUl
wUl
wUl
wUl
wUl
wUl
wUl
wUl
wUl
wUl
ikU
ikU
ikU
ikU
ikU
ikU
ikU
ikU
ikU
ikU
ikU
ikU
ikU
ikU
"}
(26,1,1) = {"
wUl
wUl
wUl
wUl
wUl
wUl
wUl
wUl
wUl
wUl
daU
wUl
wUl
wUl
wUl
wUl
ikU
ikU
ikU
ikU
ikU
wUl
ikU
ikU
ikU
ikU
ikU
ikU
ikU
ikU
"}
(27,1,1) = {"
wUl
wUl
wUl
ikU
ikU
ikU
ikU
ikU
ikU
ikU
ikU
wUl
daU
wUl
wUl
ikU
wUl
wUl
wUl
wUl
wUl
wUl
ikU
ikU
ikU
ikU
ikU
ikU
ikU
ikU
"}
(28,1,1) = {"
wUl
wUl
wUl
ikU
ikU
ikU
ikU
ikU
ikU
ikU
ikU
wUl
wUl
wUl
wUl
wUl
wUl
wUl
wUl
wUl
wUl
wUl
daU
wUl
wUl
wUl
wUl
wUl
wUl
wUl
"}
(29,1,1) = {"
wUl
ikU
ikU
ikU
ikU
ikU
ikU
ikU
ikU
ikU
ikU
wUl
wUl
wUl
wUl
wUl
wUl
wUl
wUl
wUl
ikU
ikU
ikU
ikU
wUl
ikU
wUl
wUl
wUl
wUl
"}
(30,1,1) = {"
wUl
ikU
ikU
ikU
ikU
ikU
ikU
ikU
ikU
ikU
ikU
ikU
ikU
ikU
ikU
ikU
ikU
ikU
ikU
ikU
ikU
ikU
ikU
ikU
ikU
ikU
ikU
ikU
ikU
ikU
"}
