// This map has been converted using maphash
"arG" = (/turf/template_noop,/area/template_noop)
"aVk" = (/obj/structure/closet/abductor,/obj/item/stack/sheet/cloth,/turf/open/floor/plating/abductor,/area/ruin/unpowered)
"beQ" = (/obj/structure/table/abductor,/obj/item/storage/box/alienhandcuffs,/obj/item/storage/box/alienhandcuffs,/turf/open/floor/plating/abductor,/area/ruin/unpowered)
"bjo" = (/obj/structure/table/abductor,/obj/item/clothing/under/schoolgirl,/obj/item/clothing/under/schoolgirl/green,/obj/item/clothing/under/schoolgirl/orange,/obj/item/clothing/under/schoolgirl/red,/turf/open/floor/plating/abductor,/area/ruin/unpowered)
"bzj" = (/obj/structure/closet/abductor,/obj/item/organ/appendix,/obj/item/organ/tongue,/obj/item/organ/tongue,/obj/item/organ/brain/alien,/obj/item/organ/brain/alien,/turf/open/floor/plating/abductor,/area/ruin/unpowered)
"bAF" = (/obj/structure/closet/abductor,/obj/item/clothing/under/syndicate/sniper,/turf/open/floor/plating/abductor,/area/ruin/unpowered)
"bFn" = (/obj/structure/closet/abductor,/obj/item/stack/sheet/mineral/gold,/turf/open/floor/plating/abductor,/area/ruin/unpowered)
"ctq" = (/obj/structure/kitchenspike,/obj/effect/decal/cleanable/blood/old,/obj/effect/decal/remains/human,/turf/open/floor/plating/abductor,/area/ruin/unpowered)
"cMQ" = (/obj/effect/decal/remains/human,/turf/open/floor/plating/abductor,/area/ruin/unpowered)
"deo" = (/obj/structure/table/abductor,/obj/item/stack/ore/bananium,/turf/open/floor/plating/abductor,/area/ruin/unpowered)
"dfU" = (/obj/structure/closet/abductor,/obj/item/stack/sheet/animalhide/xeno,/turf/open/floor/plating/abductor,/area/ruin/unpowered)
"dlo" = (/obj/structure/table/abductor,/obj/item/restraints/handcuffs/alien,/turf/open/floor/plating/abductor,/area/ruin/unpowered)
"dBV" = (/obj/structure/closet/abductor,/obj/item/stack/sheet/mineral/uranium,/turf/open/floor/plating/abductor,/area/ruin/unpowered)
"dLs" = (/obj/effect/decal/cleanable/blood/old,/turf/open/floor/plating/abductor,/area/ruin/unpowered)
"dWU" = (/obj/structure/table/abductor,/obj/item/stack/ore/gold,/turf/open/floor/plating/abductor,/area/ruin/unpowered)
"dXm" = (/obj/structure/closet/abductor,/obj/item/gun/energy/alien,/turf/open/floor/plating/abductor,/area/ruin/unpowered)
"ejc" = (/obj/structure/table/abductor,/obj/item/organ/tongue/lizard,/obj/item/organ/brain/alien,/turf/open/floor/plating/abductor,/area/ruin/unpowered)
"eNR" = (/obj/structure/fans/tiny/invisible,/obj/machinery/door/airlock/abductor{locked = 1},/turf/open/floor/plating/abductor,/area/ruin/unpowered)
"fcp" = (/obj/structure/table/abductor,/obj/item/stack/sheet/mineral/bananium,/turf/open/floor/plating/abductor,/area/ruin/unpowered)
"fsM" = (/turf/open/floor/plating/abductor,/area/lavaland/surface/outdoors/explored)
"fwy" = (/obj/structure/table/abductor,/obj/item/stack/ore/iron,/turf/open/floor/plating/abductor,/area/ruin/unpowered)
"fzM" = (/obj/structure/table/abductor,/obj/item/clothing/under/yogs/tourist,/turf/open/floor/plating/abductor,/area/ruin/unpowered)
"fDX" = (/turf/open/floor/plating/abductor,/area/ruin/unpowered)
"fPb" = (/obj/effect/decal/cleanable/blood/tracks,/turf/open/floor/plating/abductor,/area/ruin/unpowered)
"gcO" = (/obj/structure/closet/abductor,/obj/item/paper/guides/antag/abductor,/turf/open/floor/plating/abductor,/area/ruin/unpowered)
"gsX" = (/obj/structure/bed/abductor,/obj/effect/decal/cleanable/blood/old,/turf/open/floor/plating/abductor,/area/ruin/unpowered)
"gwk" = (/obj/structure/closet/abductor,/obj/item/clothing/under/yogs/ronaldmcdonald,/turf/open/floor/plating/abductor,/area/ruin/unpowered)
"hnS" = (/obj/structure/bed/abductor,/turf/open/floor/plating/abductor,/area/ruin/unpowered)
"hwm" = (/obj/effect/decal/cleanable/blood/drip,/mob/living/simple_animal/hostile/abomination,/turf/open/floor/plating/abductor,/area/ruin/unpowered)
"hzD" = (/obj/structure/closet/abductor,/obj/item/stack/sheet/xenochitin,/turf/open/floor/plating/abductor,/area/ruin/unpowered)
"hFZ" = (/obj/item/gps/mining,/turf/open/floor/plating/abductor,/area/ruin/unpowered)
"isQ" = (/obj/item/clothing/head/helmet/old,/obj/effect/decal/cleanable/blood/drip,/turf/open/floor/plating/abductor,/area/ruin/unpowered)
"iIQ" = (/obj/structure/closet/abductor,/obj/item/stack/sheet/mineral/abductor,/turf/open/floor/plating/abductor,/area/ruin/unpowered)
"iRl" = (/obj/structure/table/abductor,/obj/item/stack/ore/silver,/turf/open/floor/plating/abductor,/area/ruin/unpowered)
"iZy" = (/obj/machinery/door/airlock/abductor,/obj/structure/fans/tiny/invisible,/obj/effect/decal/cleanable/blood/tracks,/turf/open/floor/plating/abductor,/area/ruin/unpowered)
"jsI" = (/obj/effect/mob_spawn/human/abductor,/turf/open/floor/plating/abductor,/area/ruin/unpowered)
"jxv" = (/obj/structure/table/abductor,/obj/item/toy/figure/secofficer,/turf/open/floor/plating/abductor,/area/ruin/unpowered)
"jEL" = (/obj/structure/table/abductor,/obj/item/throwing_star,/turf/open/floor/plating/abductor,/area/ruin/unpowered)
"jLP" = (/obj/effect/decal/cleanable/blood/splatter,/turf/open/floor/plating/abductor,/area/ruin/unpowered)
"jXr" = (/obj/structure/table/abductor,/obj/item/clothing/under/sexymime,/turf/open/floor/plating/abductor,/area/ruin/unpowered)
"koB" = (/obj/effect/decal/remains/human,/obj/effect/decal/cleanable/blood/splatter,/turf/open/floor/plating/abductor,/area/ruin/unpowered)
"kzs" = (/mob/living/simple_animal/hostile/abomination,/turf/open/floor/plating/abductor,/area/ruin/unpowered)
"kNo" = (/turf/closed/wall/mineral/abductor,/area/ruin/unpowered)
"lec" = (/obj/structure/table/abductor,/obj/item/stack/ore/uranium,/turf/open/floor/plating/abductor,/area/ruin/unpowered)
"loq" = (/obj/structure/table/abductor,/obj/item/toy/figure/clown,/turf/open/floor/plating/abductor,/area/ruin/unpowered)
"lFW" = (/obj/effect/decal/cleanable/blood/drip,/turf/open/floor/plating/abductor,/area/ruin/unpowered)
"mda" = (/obj/structure/bed/abductor,/obj/effect/mob_spawn/human/ash_walker/cosmic,/turf/open/floor/plating/abductor,/area/ruin/unpowered)
"mgV" = (/obj/machinery/abductor/pad,/turf/open/floor/plating/abductor,/area/ruin/unpowered)
"mnH" = (/obj/structure/table/abductor,/obj/item/toy/syndicateballoon,/turf/open/floor/plating/abductor,/area/ruin/unpowered)
"muZ" = (/obj/structure/closet/abductor,/obj/item/organ/appendix,/obj/item/organ/appendix,/turf/open/floor/plating/abductor,/area/ruin/unpowered)
"mNk" = (/obj/machinery/door/airlock/abductor,/obj/structure/fans/tiny/invisible,/turf/open/floor/plating/abductor,/area/ruin/unpowered)
"mWi" = (/obj/structure/closet/abductor,/obj/item/stack/sheet/glass,/turf/open/floor/plating/abductor,/area/ruin/unpowered)
"nox" = (/obj/structure/bed/abductor,/obj/effect/decal/cleanable/blood/old,/obj/item/clothing/under/soviet,/turf/open/floor/plating/abductor,/area/ruin/unpowered)
"npY" = (/obj/structure/showcase/horrific_experiment,/turf/open/floor/plating/abductor,/area/ruin/unpowered)
"nCQ" = (/obj/structure/closet/abductor,/obj/item/clothing/under/yogs/tourist,/turf/open/floor/plating/abductor,/area/ruin/unpowered)
"nKv" = (/obj/structure/closet/abductor,/obj/item/stack/sheet/animalhide/monkey,/obj/item/stack/sheet/animalhide/lizard,/obj/item/stack/sheet/animalhide/corgi,/turf/open/floor/plating/abductor,/area/ruin/unpowered)
"nPk" = (/obj/machinery/door/airlock/abductor{name = "Subject Cell: Scales"},/turf/open/floor/plating/abductor,/area/ruin/unpowered)
"nYW" = (/obj/structure/closet/abductor,/obj/item/reagent_containers/food/snacks/burger/human,/obj/item/reagent_containers/food/snacks/burger/human,/turf/open/floor/plating/abductor,/area/ruin/unpowered)
"okv" = (/obj/structure/table/abductor,/obj/item/firing_pin/abductor,/obj/item/firing_pin/abductor,/obj/item/firing_pin/abductor,/obj/item/firing_pin/abductor,/obj/item/firing_pin/abductor,/turf/open/floor/plating/abductor,/area/ruin/unpowered)
"opi" = (/obj/effect/decal/remains/xeno,/obj/effect/decal/cleanable/xenoblood,/turf/open/floor/plating/abductor,/area/ruin/unpowered)
"oCP" = (/obj/structure/closet/abductor,/obj/item/stack/sheet/mineral/diamond,/turf/open/floor/plating/abductor,/area/ruin/unpowered)
"oTg" = (/obj/structure/table/abductor,/obj/item/stack/ore/plasma,/turf/open/floor/plating/abductor,/area/ruin/unpowered)
"oTp" = (/obj/structure/bed/abductor,/obj/effect/mob_spawn/human/abductor,/turf/open/floor/plating/abductor,/area/ruin/unpowered)
"oVz" = (/obj/structure/table/abductor,/obj/item/pickaxe/drill,/obj/item/clothing/glasses/meson/night,/turf/open/floor/plating/abductor,/area/ruin/unpowered)
"psz" = (/obj/effect/decal/cleanable/blood/tracks,/obj/effect/decal/cleanable/blood/splatter,/obj/effect/mob_spawn/human/abductor,/turf/open/floor/plating/abductor,/area/ruin/unpowered)
"qkU" = (/obj/structure/table/abductor,/obj/item/switchblade,/turf/open/floor/plating/abductor,/area/ruin/unpowered)
"qsR" = (/obj/structure/table/abductor,/obj/item/stack/sheet/animalhide/human,/turf/open/floor/plating/abductor,/area/ruin/unpowered)
"qwG" = (/obj/structure/table/abductor,/obj/item/clothing/head/helmet/abductor,/turf/open/floor/plating/abductor,/area/ruin/unpowered)
"qxY" = (/obj/structure/table/abductor,/obj/item/stack/ore/bluespace_crystal,/turf/open/floor/plating/abductor,/area/ruin/unpowered)
"qzs" = (/obj/machinery/abductor/gland_dispenser,/turf/open/floor/plating/abductor,/area/ruin/unpowered)
"qJU" = (/obj/structure/closet/abductor,/obj/item/reagent_containers/food/snacks/meat/slab/human,/obj/item/reagent_containers/food/snacks/meat/slab/human,/obj/item/reagent_containers/food/snacks/meat/slab/human,/obj/item/reagent_containers/food/snacks/meat/slab/human,/turf/open/floor/plating/abductor,/area/ruin/unpowered)
"qML" = (/obj/structure/closet/abductor,/obj/item/organ/heart,/obj/item/organ/heart,/obj/item/organ/lungs,/obj/item/organ/lungs,/obj/item/organ/tongue/alien,/turf/open/floor/plating/abductor,/area/ruin/unpowered)
"qUM" = (/obj/effect/decal/cleanable/greenglow,/turf/open/floor/plating/abductor,/area/ruin/unpowered)
"rxp" = (/obj/item/clothing/head/helmet/old,/turf/open/floor/plating/abductor,/area/ruin/unpowered)
"rMM" = (/obj/structure/closet/abductor,/obj/item/stack/sheet/animalhide/human,/turf/open/floor/plating/abductor,/area/ruin/unpowered)
"rYe" = (/obj/effect/decal/remains/human,/obj/effect/decal/cleanable/blood/old,/turf/open/floor/plating/abductor,/area/ruin/unpowered)
"spC" = (/obj/structure/table/abductor,/obj/item/circular_saw/alien,/obj/item/surgicaldrill/alien,/obj/item/scalpel/alien,/turf/open/floor/plating/abductor,/area/ruin/unpowered)
"sTA" = (/obj/structure/table/abductor,/obj/item/organ/tail/cat,/obj/item/organ/tongue,/obj/item/organ/lungs,/obj/item/organ/lungs,/turf/open/floor/plating/abductor,/area/ruin/unpowered)
"sUq" = (/obj/structure/table/abductor,/turf/open/floor/plating/abductor,/area/ruin/unpowered)
"sVa" = (/obj/structure/closet/abductor,/obj/item/stack/sheet/mineral/silver,/turf/open/floor/plating/abductor,/area/ruin/unpowered)
"tdZ" = (/obj/structure/table/abductor,/obj/item/stack/sheet/animalhide/lizard,/turf/open/floor/plating/abductor,/area/ruin/unpowered)
"tgx" = (/obj/structure/closet/abductor{name = "Weapon Code: Primitive"},/obj/item/shield/riot/roman{desc = "Bears an inscription on the inside: <i>'Ashwalker venio domus'</i>."; name = "Cosmic Ashwalker Shield"},/obj/item/rune_scimmy,/turf/open/floor/plating/abductor,/area/ruin/unpowered)
"tgD" = (/turf/open/lava/smooth/lava_land_surface,/area/lavaland/surface/outdoors/explored)
"tqz" = (/obj/structure/closet/abductor,/turf/open/floor/plating/abductor,/area/ruin/unpowered)
"tsH" = (/obj/item/organ/appendix,/turf/open/floor/plating/abductor,/area/ruin/unpowered)
"tHU" = (/obj/structure/table/abductor,/obj/item/toy/figure/mime,/turf/open/floor/plating/abductor,/area/ruin/unpowered)
"tOw" = (/obj/effect/spawner/structure/window/reinforced,/turf/open/floor/plating/abductor,/area/ruin/unpowered)
"tSZ" = (/obj/structure/table/abductor,/obj/item/abductor/baton,/turf/open/floor/plating/abductor,/area/ruin/unpowered)
"ulq" = (/obj/structure/table/abductor,/obj/item/gun/energy/kinetic_accelerator,/turf/open/floor/plating/abductor,/area/ruin/unpowered)
"upI" = (/obj/effect/spawner/structure/window,/turf/open/floor/plating/abductor,/area/ruin/unpowered)
"vol" = (/obj/machinery/door/airlock/abductor{locked = 1},/obj/structure/fans/tiny/invisible,/turf/open/floor/plating/abductor,/area/ruin/unpowered)
"vsT" = (/obj/structure/table/abductor,/obj/item/organ/ears/cat,/turf/open/floor/plating/abductor,/area/ruin/unpowered)
"vRm" = (/turf/open/floor/plating/asteroid/basalt/lava_land_surface,/area/lavaland/surface/outdoors/explored)
"vWJ" = (/obj/structure/table/abductor,/obj/item/organ/lungs,/obj/item/organ/heart,/obj/item/organ/heart,/obj/item/organ/brain,/turf/open/floor/plating/abductor,/area/ruin/unpowered)
"wcI" = (/obj/structure/closet/abductor,/obj/item/stack/sheet/mineral/plasma,/turf/open/floor/plating/abductor,/area/ruin/unpowered)
"wvB" = (/obj/structure/table/abductor,/obj/item/organ/tongue/abductor,/turf/open/floor/plating/abductor,/area/ruin/unpowered)
"wGm" = (/obj/structure/table/abductor,/obj/item/organ/tongue/fly,/obj/item/organ/tongue/alien,/turf/open/floor/plating/abductor,/area/ruin/unpowered)
"wYS" = (/obj/structure/closet/abductor{name = "Armor Code: Primitive"},/obj/item/clothing/gloves/plate/blue{armor = list("melee" = 5, "bullet" = 5, "laser" = 5, "energy" = 0, "bomb" = 0, "bio" = 0, "rad" = 0); desc = "A pair of heavily modified traditional gauntlets"; name = "Cosmic Gauntlets"},/obj/item/clothing/shoes/plate/blue{name = "Cosmic Boots"},/obj/item/clothing/head/helmet/knight/blue{desc = "A heavily modified traditional helmet"; name = "Cosmic Helmet"},/obj/item/clothing/suit/armor/riot/knight/blue{armor = list("melee" = 50, "bullet" = 30, "laser" = 50, "energy" = 10, "bomb" = 0, "bio" = 0, "rad" = 0); desc = "A modified suit of traditional plate armor, you can see some circuitry shoved into the joints"; name = "Cosmic Armor"},/obj/item/clothing/under/roman{name = "Undergarments"},/turf/open/floor/plating/abductor,/area/ruin/unpowered)
"xrM" = (/obj/machinery/computer/camera_advanced/abductor,/turf/open/floor/plating/abductor,/area/ruin/unpowered)
"xDs" = (/obj/item/organ/tail/cat,/obj/item/organ/tail/cat,/obj/item/organ/appendix,/obj/item/organ/tongue,/obj/item/organ/tongue,/obj/structure/table/abductor,/turf/open/floor/plating/abductor,/area/ruin/unpowered)
"xIk" = (/obj/structure/table/abductor,/obj/item/pickaxe/drill,/turf/open/floor/plating/abductor,/area/ruin/unpowered)
"xUI" = (/obj/structure/table/abductor,/obj/item/cautery/alien,/obj/item/circular_saw/alien,/obj/item/hemostat/alien,/obj/item/retractor/alien,/obj/item/scalpel/alien,/obj/item/surgicaldrill/alien,/obj/item/surgical_drapes,/turf/open/floor/plating/abductor,/area/ruin/unpowered)
"xZX" = (/obj/structure/table/abductor,/obj/item/storage/toolbox/mechanical,/turf/open/floor/plating/abductor,/area/ruin/unpowered)
"ygm" = (/obj/structure/table/abductor,/obj/item/stack/ore/diamond,/turf/open/floor/plating/abductor,/area/ruin/unpowered)
"ygK" = (/turf/closed/wall/mineral/abductor,/area/lavaland/surface/outdoors/explored)

(1,1,1) = {"
arG
arG
arG
arG
arG
arG
arG
arG
arG
arG
arG
arG
arG
arG
arG
arG
arG
arG
arG
arG
arG
arG
arG
arG
arG
arG
arG
arG
arG
arG
arG
arG
arG
arG
arG
arG
arG
arG
arG
arG
arG
arG
arG
arG
arG
arG
arG
arG
arG
arG
"}
(2,1,1) = {"
arG
arG
arG
arG
arG
arG
arG
arG
arG
arG
arG
arG
arG
arG
arG
arG
arG
arG
arG
arG
arG
arG
arG
arG
arG
arG
arG
arG
arG
arG
arG
arG
arG
arG
arG
arG
arG
arG
arG
arG
arG
arG
arG
arG
arG
arG
arG
arG
arG
arG
"}
(3,1,1) = {"
arG
arG
arG
arG
arG
arG
arG
arG
arG
arG
arG
arG
arG
arG
arG
arG
arG
arG
arG
arG
arG
arG
arG
arG
arG
arG
arG
arG
arG
arG
arG
arG
arG
arG
arG
arG
arG
arG
arG
arG
arG
arG
arG
arG
arG
arG
arG
arG
arG
arG
"}
(4,1,1) = {"
arG
arG
arG
arG
arG
arG
arG
arG
arG
arG
arG
arG
arG
arG
arG
arG
arG
arG
arG
arG
arG
arG
arG
arG
arG
arG
arG
arG
arG
arG
arG
arG
arG
arG
arG
arG
arG
arG
arG
arG
arG
arG
arG
arG
arG
arG
arG
arG
arG
arG
"}
(5,1,1) = {"
arG
arG
arG
arG
arG
arG
arG
arG
arG
arG
arG
arG
arG
arG
vRm
vRm
vRm
vRm
vRm
vRm
vRm
arG
arG
arG
arG
arG
vRm
vRm
vRm
vRm
arG
arG
arG
arG
arG
arG
arG
arG
arG
arG
arG
arG
arG
arG
arG
arG
arG
arG
arG
arG
"}
(6,1,1) = {"
arG
arG
arG
arG
arG
arG
arG
arG
arG
arG
arG
arG
arG
arG
vRm
vRm
vRm
vRm
vRm
vRm
vRm
arG
arG
arG
arG
arG
vRm
vRm
vRm
vRm
arG
arG
arG
arG
arG
arG
arG
arG
arG
arG
arG
arG
arG
arG
arG
arG
arG
arG
arG
arG
"}
(7,1,1) = {"
arG
arG
arG
vRm
vRm
vRm
vRm
vRm
vRm
vRm
vRm
vRm
vRm
vRm
vRm
vRm
vRm
vRm
vRm
vRm
vRm
vRm
vRm
vRm
vRm
vRm
vRm
vRm
vRm
vRm
vRm
vRm
vRm
vRm
arG
arG
arG
arG
arG
arG
arG
arG
arG
arG
arG
arG
arG
arG
arG
arG
"}
(8,1,1) = {"
arG
arG
arG
vRm
vRm
vRm
vRm
tgD
vRm
vRm
vRm
vRm
vRm
vRm
vRm
vRm
tgD
tgD
vRm
vRm
vRm
tgD
vRm
vRm
vRm
vRm
vRm
vRm
vRm
vRm
vRm
vRm
vRm
vRm
arG
arG
arG
arG
arG
arG
arG
arG
arG
arG
arG
arG
arG
arG
arG
arG
"}
(9,1,1) = {"
arG
arG
arG
vRm
vRm
vRm
vRm
tgD
vRm
vRm
vRm
tgD
tgD
vRm
vRm
vRm
tgD
vRm
vRm
tgD
vRm
tgD
vRm
vRm
tgD
tgD
tgD
tgD
tgD
tgD
tgD
tgD
vRm
vRm
arG
arG
arG
arG
arG
arG
arG
arG
arG
arG
arG
arG
arG
arG
arG
arG
"}
(10,1,1) = {"
arG
arG
arG
vRm
vRm
vRm
tgD
tgD
tgD
tgD
tgD
tgD
tgD
vRm
tgD
vRm
tgD
tgD
tgD
tgD
tgD
tgD
tgD
tgD
tgD
tgD
tgD
tgD
tgD
tgD
tgD
tgD
vRm
vRm
arG
arG
arG
arG
arG
arG
arG
arG
arG
arG
arG
arG
arG
arG
arG
arG
"}
(11,1,1) = {"
arG
vRm
vRm
vRm
vRm
vRm
vRm
tgD
tgD
tgD
tgD
tgD
tgD
tgD
tgD
tgD
tgD
tgD
tgD
tgD
tgD
tgD
tgD
tgD
tgD
tgD
tgD
vRm
tgD
tgD
tgD
tgD
vRm
vRm
vRm
vRm
vRm
vRm
vRm
arG
arG
arG
arG
arG
arG
arG
arG
arG
arG
arG
"}
(12,1,1) = {"
arG
vRm
vRm
vRm
vRm
vRm
tgD
tgD
tgD
tgD
tgD
tgD
tgD
tgD
tgD
tgD
tgD
tgD
tgD
tgD
tgD
vRm
tgD
tgD
vRm
vRm
tgD
tgD
vRm
vRm
tgD
vRm
vRm
vRm
vRm
vRm
vRm
vRm
vRm
arG
arG
arG
arG
arG
arG
arG
arG
arG
arG
arG
"}
(13,1,1) = {"
arG
vRm
vRm
vRm
tgD
vRm
tgD
tgD
vRm
tgD
tgD
tgD
tgD
tgD
vRm
tgD
vRm
vRm
vRm
vRm
tgD
vRm
tgD
tgD
vRm
vRm
vRm
tgD
vRm
vRm
tgD
tgD
tgD
tgD
tgD
vRm
vRm
vRm
vRm
arG
arG
arG
arG
arG
arG
arG
arG
arG
arG
arG
"}
(14,1,1) = {"
arG
vRm
vRm
vRm
tgD
vRm
tgD
tgD
tgD
tgD
tgD
tgD
vRm
tgD
vRm
vRm
tgD
tgD
tgD
tgD
tgD
vRm
tgD
vRm
tgD
tgD
tgD
tgD
vRm
vRm
vRm
tgD
tgD
vRm
vRm
vRm
vRm
vRm
tgD
vRm
vRm
vRm
arG
arG
arG
arG
arG
arG
arG
arG
"}
(15,1,1) = {"
vRm
vRm
vRm
vRm
tgD
vRm
tgD
vRm
vRm
vRm
tgD
tgD
vRm
vRm
vRm
vRm
vRm
vRm
vRm
tgD
tgD
vRm
vRm
vRm
tgD
tgD
tgD
tgD
vRm
vRm
tgD
tgD
vRm
tgD
vRm
vRm
tgD
tgD
tgD
vRm
tgD
vRm
arG
arG
arG
arG
arG
arG
arG
arG
"}
(16,1,1) = {"
vRm
vRm
vRm
vRm
tgD
tgD
tgD
tgD
vRm
kNo
kNo
kNo
kNo
kNo
kNo
kNo
kNo
kNo
kNo
kNo
kNo
kNo
kNo
kNo
kNo
kNo
kNo
kNo
kNo
tgD
tgD
tgD
tgD
vRm
vRm
tgD
tgD
tgD
vRm
vRm
tgD
vRm
vRm
vRm
vRm
vRm
vRm
arG
arG
arG
"}
(17,1,1) = {"
vRm
vRm
vRm
tgD
tgD
vRm
vRm
tgD
vRm
kNo
hzD
fDX
xDs
mWi
fDX
fDX
nKv
fDX
bzj
kNo
iIQ
fDX
fDX
fDX
fDX
iIQ
fDX
gcO
kNo
tgD
tgD
tgD
tgD
vRm
vRm
tgD
vRm
vRm
vRm
vRm
tgD
vRm
vRm
tgD
tgD
tgD
vRm
arG
arG
arG
"}
(18,1,1) = {"
vRm
vRm
vRm
tgD
tgD
vRm
vRm
tgD
vRm
kNo
wcI
fDX
fDX
koB
aVk
fDX
fDX
fDX
fDX
kNo
fDX
fDX
tqz
fDX
fDX
fDX
fDX
fDX
kNo
tgD
tgD
tgD
tgD
tgD
tgD
tgD
tgD
tgD
tgD
tgD
tgD
tgD
vRm
vRm
tgD
tgD
vRm
arG
arG
arG
"}
(19,1,1) = {"
vRm
vRm
vRm
vRm
tgD
vRm
vRm
tgD
vRm
kNo
bFn
fDX
dBV
lFW
sUq
fDX
dfU
kzs
rMM
kNo
loq
fDX
tqz
lFW
kzs
iIQ
fDX
gcO
kNo
tgD
vRm
tgD
tgD
tgD
tgD
tgD
tgD
tgD
tgD
tgD
tgD
tgD
vRm
vRm
tgD
tgD
vRm
arG
arG
arG
"}
(20,1,1) = {"
vRm
vRm
tgD
tgD
tgD
tgD
tgD
tgD
tgD
kNo
fDX
fDX
sVa
hwm
muZ
koB
sTA
fDX
rMM
kNo
tHU
fDX
fDX
lFW
iIQ
fDX
fDX
tqz
kNo
tgD
vRm
tgD
tgD
tgD
vRm
tgD
vRm
vRm
vRm
tgD
tgD
tgD
tgD
tgD
tgD
vRm
vRm
arG
arG
arG
"}
(21,1,1) = {"
vRm
vRm
vRm
vRm
tgD
tgD
vRm
tgD
vRm
kNo
oCP
fDX
fDX
isQ
fDX
fDX
fDX
fDX
qML
kNo
jxv
fDX
iIQ
fDX
lFW
fDX
cMQ
sUq
kNo
tgD
tgD
tgD
vRm
tgD
tgD
tgD
tgD
tgD
vRm
tgD
tgD
tgD
tgD
tgD
tgD
vRm
vRm
vRm
vRm
arG
"}
(22,1,1) = {"
vRm
tgD
vRm
vRm
tgD
tgD
tgD
vRm
vRm
kNo
kNo
kNo
kNo
kNo
vol
kNo
kNo
kNo
kNo
kNo
kNo
kNo
kNo
kNo
kNo
kNo
vol
kNo
kNo
tgD
vRm
tgD
tgD
tgD
tgD
tgD
vRm
tgD
tgD
tgD
tgD
vRm
vRm
tgD
tgD
tgD
vRm
tgD
vRm
arG
"}
(23,1,1) = {"
vRm
tgD
tgD
tgD
tgD
tgD
tgD
tgD
vRm
kNo
fDX
fDX
fDX
fDX
jLP
lFW
fDX
fDX
kNo
fDX
fDX
jLP
kNo
mnH
nCQ
fDX
fDX
bjo
kNo
tgD
tgD
tgD
tgD
kNo
kNo
kNo
kNo
kNo
kNo
kNo
kNo
kNo
vRm
vRm
tgD
tgD
tgD
tgD
vRm
arG
"}
(24,1,1) = {"
vRm
tgD
vRm
tgD
tgD
tgD
tgD
tgD
tgD
kNo
fDX
cMQ
fDX
fDX
fDX
lFW
lFW
lFW
iZy
fPb
psz
fDX
mNk
fDX
fDX
fDX
cMQ
bAF
kNo
tgD
tgD
tgD
vRm
kNo
sUq
sUq
sUq
kNo
sUq
sUq
sUq
kNo
vRm
vRm
tgD
tgD
tgD
tgD
vRm
arG
"}
(25,1,1) = {"
arG
arG
tgD
vRm
tgD
tgD
tgD
tgD
tgD
kNo
fDX
fDX
fDX
fDX
fDX
fDX
fDX
fDX
kNo
fDX
fDX
fDX
kNo
gwk
jXr
fzM
fDX
tqz
kNo
tgD
vRm
tgD
tgD
kNo
fDX
fDX
fDX
kNo
fDX
fDX
fDX
kNo
vRm
vRm
tgD
tgD
vRm
vRm
vRm
arG
"}
(26,1,1) = {"
arG
arG
tgD
vRm
tgD
tgD
tgD
tgD
vRm
kNo
kNo
kNo
kNo
kNo
kNo
kNo
kNo
kNo
kNo
kNo
mNk
kNo
kNo
kNo
kNo
kNo
kNo
kNo
kNo
tgD
tgD
tgD
vRm
kNo
dXm
fDX
kzs
kNo
dXm
fDX
kzs
kNo
vRm
vRm
tgD
tgD
vRm
vRm
vRm
arG
"}
(27,1,1) = {"
arG
arG
tgD
tgD
tgD
tgD
tgD
tgD
vRm
vRm
vRm
vRm
vRm
kNo
fDX
rYe
kNo
fDX
fDX
kNo
fDX
kNo
cMQ
mNk
fDX
fDX
mNk
opi
kNo
tgD
tgD
kNo
kNo
kNo
kNo
vol
kNo
kNo
kNo
eNR
kNo
kNo
vRm
vRm
tgD
tgD
tgD
tgD
vRm
arG
"}
(28,1,1) = {"
arG
arG
tgD
tgD
tgD
tgD
tgD
kNo
kNo
kNo
kNo
kNo
kNo
kNo
fDX
fDX
kNo
rYe
rYe
kNo
fDX
kNo
hnS
kNo
fDX
fDX
kNo
hnS
kNo
vRm
tgD
kNo
fDX
mNk
fDX
fDX
fDX
fDX
fDX
fDX
koB
kNo
tgD
tgD
tgD
tgD
tgD
tgD
vRm
arG
"}
(29,1,1) = {"
arG
arG
arG
arG
tgD
tgD
tgD
kNo
tSZ
tSZ
fDX
tqz
tqz
kNo
rYe
fDX
kNo
fDX
fDX
kNo
fDX
kNo
kNo
kNo
fDX
fDX
kNo
kNo
kNo
vRm
vRm
kNo
fDX
kNo
kNo
kNo
kNo
eNR
kNo
kNo
kNo
kNo
vRm
vRm
vRm
tgD
vRm
vRm
vRm
arG
"}
(30,1,1) = {"
arG
arG
kNo
kNo
kNo
kNo
kNo
kNo
fDX
fDX
fDX
fDX
fDX
kNo
kNo
mNk
kNo
mNk
kNo
kNo
rYe
kNo
fDX
mNk
fDX
fDX
mNk
fDX
kNo
vRm
vRm
kNo
fDX
kNo
sUq
fDX
fDX
fDX
fDX
fDX
sUq
kNo
vRm
vRm
tgD
tgD
vRm
vRm
vRm
arG
"}
(31,1,1) = {"
arG
arG
kNo
tqz
sUq
sUq
tqz
kNo
tqz
fDX
fDX
beQ
okv
kNo
dlo
fDX
kNo
fDX
dlo
kNo
fDX
kNo
oTp
kNo
fDX
fDX
kNo
hnS
kNo
vRm
vRm
kNo
fDX
kNo
fcp
fDX
sUq
qkU
kzs
fDX
fDX
kNo
tgD
tgD
tgD
tgD
tgD
vRm
vRm
arG
"}
(32,1,1) = {"
arG
kNo
kNo
fDX
fDX
fDX
fDX
kNo
kNo
kNo
vol
kNo
kNo
kNo
fDX
fDX
fDX
fDX
fDX
fDX
fDX
kNo
kNo
kNo
fDX
fDX
kNo
kNo
kNo
vRm
tgD
kNo
fDX
kNo
fDX
koB
fDX
fDX
fDX
fDX
ulq
kNo
vRm
vRm
tgD
tgD
vRm
vRm
vRm
arG
"}
(33,1,1) = {"
arG
kNo
xrM
fDX
fDX
rYe
rxp
kNo
mgV
fDX
fDX
fDX
fDX
kNo
fDX
kNo
nYW
tsH
spC
wGm
fDX
kNo
qzs
qzs
fDX
fDX
fDX
tqz
kNo
vRm
tgD
kNo
fDX
kNo
sUq
sUq
xZX
jEL
sUq
fDX
xIk
kNo
vRm
tgD
tgD
tgD
vRm
vRm
vRm
arG
"}
(34,1,1) = {"
arG
kNo
xrM
fDX
fDX
fDX
fDX
vol
fDX
fDX
fDX
fDX
fDX
mNk
fDX
kNo
ctq
cMQ
qsR
tdZ
fDX
mNk
fDX
fDX
fDX
fDX
hnS
xUI
kNo
kNo
kNo
kNo
mNk
kNo
kNo
kNo
kNo
kNo
kNo
kNo
kNo
kNo
vRm
tgD
tgD
tgD
vRm
vRm
vRm
arG
"}
(35,1,1) = {"
arG
kNo
sUq
fDX
fDX
fDX
fDX
kNo
mgV
fDX
fDX
fDX
fDX
kNo
fDX
kNo
qJU
fDX
vWJ
ejc
fDX
kNo
fDX
fDX
fDX
fDX
fDX
tSZ
kNo
fDX
jLP
fDX
fDX
jLP
fDX
fDX
kNo
vRm
vRm
tgD
vRm
vRm
vRm
tgD
tgD
tgD
vRm
vRm
vRm
arG
"}
(36,1,1) = {"
arG
kNo
kNo
fDX
rxp
fDX
fDX
kNo
kNo
kNo
mNk
kNo
kNo
kNo
fDX
fDX
fDX
fDX
fDX
fDX
fDX
kNo
kNo
kNo
fDX
fDX
kNo
kNo
kNo
fDX
tOw
tOw
tOw
tOw
tOw
koB
kNo
vRm
vRm
tgD
vRm
vRm
vRm
tgD
tgD
vRm
vRm
vRm
vRm
arG
"}
(37,1,1) = {"
arG
arG
kNo
vsT
qwG
wvB
tSZ
kNo
hnS
hnS
fDX
hnS
hnS
kNo
dlo
fDX
kNo
fDX
dlo
kNo
fDX
kNo
hFZ
mNk
fDX
fDX
mNk
cMQ
kNo
fDX
tOw
wYS
fDX
cMQ
tOw
fDX
kNo
tgD
vRm
vRm
tgD
vRm
vRm
tgD
tgD
vRm
vRm
vRm
vRm
arG
"}
(38,1,1) = {"
arG
arG
kNo
kNo
kNo
kNo
kNo
kNo
fDX
fDX
fDX
fDX
fDX
kNo
kNo
mNk
kNo
mNk
kNo
kNo
fDX
kNo
gsX
kNo
fDX
fDX
kNo
nox
kNo
fDX
tOw
oVz
mda
fDX
tOw
lFW
kNo
vRm
vRm
vRm
tgD
vRm
vRm
tgD
tgD
vRm
vRm
vRm
vRm
arG
"}
(39,1,1) = {"
arG
arG
arG
arG
arG
arG
arG
kNo
hnS
hnS
hnS
hnS
hnS
kNo
fDX
fDX
kNo
dLs
cMQ
kNo
fDX
kNo
kNo
kNo
fDX
fDX
kNo
kNo
kNo
fDX
tOw
tgx
fDX
fDX
tOw
fDX
kNo
tgD
tgD
tgD
tgD
vRm
vRm
tgD
tgD
tgD
vRm
vRm
vRm
arG
"}
(40,1,1) = {"
arG
arG
arG
arG
arG
arG
arG
kNo
kNo
kNo
kNo
kNo
kNo
kNo
rYe
fDX
kNo
fDX
cMQ
kNo
fDX
kNo
opi
mNk
fDX
fDX
mNk
fDX
kNo
fDX
tOw
tOw
nPk
tOw
tOw
lFW
kNo
tgD
tgD
tgD
tgD
vRm
vRm
tgD
tgD
vRm
vRm
vRm
vRm
arG
"}
(41,1,1) = {"
arG
arG
arG
arG
arG
arG
arG
tgD
tgD
tgD
tgD
tgD
tgD
kNo
fDX
rYe
kNo
jsI
dLs
kNo
fDX
kNo
hnS
kNo
fDX
fDX
kNo
hnS
kNo
koB
fDX
fDX
koB
jLP
lFW
lFW
kNo
tgD
tgD
tgD
tgD
tgD
tgD
tgD
tgD
tgD
tgD
tgD
vRm
arG
"}
(42,1,1) = {"
arG
arG
arG
arG
arG
arG
tgD
tgD
tgD
tgD
tgD
tgD
tgD
kNo
kNo
kNo
kNo
kNo
kNo
kNo
mNk
kNo
kNo
kNo
kNo
kNo
kNo
kNo
kNo
kNo
mNk
kNo
kNo
kNo
kNo
kNo
kNo
tgD
tgD
tgD
tgD
tgD
tgD
tgD
tgD
vRm
vRm
vRm
vRm
arG
"}
(43,1,1) = {"
arG
arG
arG
arG
arG
arG
vRm
tgD
tgD
tgD
tgD
tgD
tgD
tgD
tgD
tgD
kNo
oTg
fDX
lec
fDX
fDX
fDX
kNo
npY
fDX
npY
fDX
npY
kNo
lFW
kNo
vRm
tgD
tgD
tgD
tgD
tgD
tgD
vRm
tgD
vRm
vRm
tgD
vRm
vRm
arG
arG
arG
arG
"}
(44,1,1) = {"
arG
arG
arG
arG
arG
arG
vRm
vRm
vRm
tgD
tgD
tgD
tgD
tgD
tgD
tgD
kNo
fDX
fDX
fDX
fDX
fDX
fDX
kNo
fDX
fDX
npY
fDX
qUM
kNo
fDX
kNo
tgD
tgD
tgD
tgD
tgD
tgD
tgD
vRm
tgD
vRm
vRm
vRm
vRm
vRm
arG
arG
arG
arG
"}
(45,1,1) = {"
arG
arG
arG
arG
arG
arG
vRm
vRm
tgD
tgD
tgD
tgD
tgD
tgD
tgD
tgD
kNo
ygm
fDX
deo
fDX
fDX
fDX
kNo
upI
upI
upI
upI
upI
kNo
lFW
kNo
vRm
vRm
vRm
vRm
tgD
tgD
tgD
vRm
vRm
vRm
arG
arG
arG
arG
arG
arG
arG
arG
"}
(46,1,1) = {"
arG
arG
arG
arG
arG
arG
vRm
vRm
tgD
vRm
vRm
tgD
tgD
tgD
tgD
tgD
kNo
fDX
rYe
fDX
fDX
rYe
fDX
mNk
fDX
fDX
fDX
fDX
fDX
mNk
koB
kNo
vRm
vRm
vRm
vRm
tgD
tgD
tgD
vRm
vRm
vRm
arG
arG
arG
arG
arG
arG
arG
arG
"}
(47,1,1) = {"
arG
arG
arG
arG
arG
arG
vRm
vRm
tgD
vRm
tgD
tgD
tgD
tgD
tgD
tgD
kNo
dWU
fDX
qxY
fDX
fDX
fDX
kNo
upI
upI
upI
upI
upI
kNo
kNo
kNo
vRm
arG
arG
vRm
vRm
vRm
tgD
vRm
arG
arG
arG
arG
arG
arG
arG
arG
arG
arG
"}
(48,1,1) = {"
arG
arG
arG
arG
arG
arG
vRm
vRm
vRm
vRm
vRm
vRm
tgD
tgD
tgD
tgD
kNo
fDX
fDX
fDX
fDX
fDX
tqz
kNo
npY
qUM
fDX
npY
fDX
kNo
vRm
vRm
vRm
arG
arG
vRm
vRm
vRm
vRm
vRm
arG
arG
arG
arG
arG
arG
arG
arG
arG
arG
"}
(49,1,1) = {"
arG
arG
arG
arG
arG
arG
vRm
vRm
vRm
vRm
vRm
tgD
tgD
tgD
tgD
tgD
kNo
iRl
fDX
fwy
fDX
fDX
tqz
kNo
npY
fDX
npY
fDX
npY
kNo
vRm
vRm
vRm
arG
arG
arG
arG
arG
arG
arG
arG
arG
arG
arG
arG
arG
arG
arG
arG
arG
"}
(50,1,1) = {"
arG
arG
arG
arG
arG
arG
vRm
vRm
vRm
vRm
vRm
vRm
vRm
tgD
tgD
tgD
kNo
fDX
fDX
fDX
fDX
rYe
tqz
kNo
kNo
kNo
kNo
kNo
kNo
kNo
vRm
vRm
vRm
arG
arG
arG
arG
arG
arG
arG
arG
arG
arG
arG
arG
arG
arG
arG
arG
arG
"}
(51,1,1) = {"
arG
arG
arG
arG
arG
arG
vRm
vRm
vRm
vRm
vRm
vRm
vRm
tgD
tgD
vRm
kNo
xIk
xIk
xIk
fDX
fDX
tqz
kNo
vRm
vRm
vRm
vRm
vRm
vRm
vRm
vRm
vRm
arG
arG
arG
arG
arG
arG
arG
arG
arG
arG
arG
arG
arG
arG
arG
arG
arG
"}
(52,1,1) = {"
arG
arG
arG
arG
arG
arG
arG
arG
arG
arG
arG
arG
vRm
vRm
tgD
vRm
kNo
kNo
kNo
kNo
mNk
kNo
kNo
kNo
vRm
vRm
vRm
arG
arG
arG
arG
arG
arG
arG
arG
arG
arG
arG
arG
arG
arG
arG
arG
arG
arG
arG
arG
arG
arG
arG
"}
(53,1,1) = {"
arG
arG
arG
arG
arG
arG
arG
arG
arG
arG
arG
arG
vRm
vRm
vRm
vRm
fsM
fsM
fsM
fsM
fsM
fsM
fsM
fsM
fsM
vRm
vRm
arG
arG
arG
arG
arG
arG
arG
arG
arG
arG
arG
arG
arG
arG
arG
arG
arG
arG
arG
arG
arG
arG
arG
"}
(54,1,1) = {"
arG
arG
arG
arG
arG
arG
arG
arG
arG
arG
arG
arG
vRm
vRm
vRm
vRm
vRm
fsM
fsM
fsM
fsM
fsM
fsM
fsM
vRm
vRm
vRm
arG
arG
arG
arG
arG
arG
arG
arG
arG
arG
arG
arG
arG
arG
arG
arG
arG
arG
arG
arG
arG
arG
arG
"}
(55,1,1) = {"
arG
arG
arG
arG
arG
arG
arG
arG
arG
arG
arG
arG
vRm
vRm
vRm
vRm
vRm
vRm
ygK
fsM
fsM
fsM
ygK
vRm
vRm
vRm
vRm
arG
arG
arG
arG
arG
arG
arG
arG
arG
arG
arG
arG
arG
arG
arG
arG
arG
arG
arG
arG
arG
arG
arG
"}
