// This map has been converted using maphash
"dRg" = (/obj/structure/table/wood/poker,/obj/item/coin/diamond,/turf/open/floor/carpet{icon_state = "carpetsymbol"},/area/ruin/powered/greed)
"eqQ" = (/obj/structure/table/wood/poker,/obj/item/coin/mythril,/obj/machinery/light/small{dir = 1},/turf/open/floor/carpet{icon_state = "carpetsymbol"},/area/ruin/powered/greed)
"eOr" = (/turf/open/floor/engine/cult,/area/ruin/powered/greed)
"gDH" = (/obj/machinery/door/airlock/gold,/obj/structure/fans/tiny/invisible,/turf/open/floor/engine/cult,/area/ruin/powered/greed)
"gTr" = (/turf/closed/wall/mineral/cult,/area/ruin/powered/greed)
"hfe" = (/obj/structure/table/wood/poker,/obj/item/stack/spacecash/c1000,/turf/open/floor/engine/cult,/area/ruin/powered/greed)
"hmI" = (/turf/open/lava/smooth/lava_land_surface,/area/lavaland/surface/outdoors)
"ikU" = (/turf/closed/mineral/volcanic/lava_land_surface,/area/lavaland/surface/outdoors)
"jhj" = (/obj/structure/table/wood/poker,/obj/item/gun/ballistic/revolver/russian/soul,/obj/machinery/light/small{dir = 1},/turf/open/floor/carpet{icon_state = "carpetsymbol"},/area/ruin/powered/greed)
"kBL" = (/obj/structure/cursed_slot_machine,/turf/open/floor/carpet{icon_state = "carpetsymbol"},/area/ruin/powered/greed)
"lfG" = (/obj/item/coin/gold,/obj/machinery/light/small,/turf/open/floor/engine/cult,/area/ruin/powered/greed)
"lqv" = (/obj/item/storage/bag/money,/turf/open/floor/engine/cult,/area/ruin/powered/greed)
"lSq" = (/obj/structure/table/wood/poker,/obj/item/stack/ore/gold,/turf/open/floor/engine/cult,/area/ruin/powered/greed)
"mvZ" = (/obj/item/storage/bag/money,/obj/machinery/light/small,/turf/open/floor/engine/cult,/area/ruin/powered/greed)
"prR" = (/turf/open/floor/carpet{icon_state = "carpetsymbol"},/area/ruin/powered/greed)
"rLZ" = (/obj/machinery/computer/arcade/battle{set_obj_flags = "EMAGGED"},/turf/open/floor/engine/cult,/area/ruin/powered/greed)
"tVr" = (/obj/structure/table/wood/poker,/obj/item/coin/adamantine,/turf/open/floor/carpet{icon_state = "carpetsymbol"},/area/ruin/powered/greed)
"ube" = (/obj/structure/table/wood/poker,/obj/item/stack/spacecash/c20,/obj/item/stack/spacecash/c50,/obj/machinery/light/small{brightness = 3; dir = 8},/turf/open/floor/engine/cult,/area/ruin/powered/greed)
"uwO" = (/obj/structure/table/wood/poker,/obj/item/stack/spacecash/c500,/obj/item/stack/spacecash/c100,/obj/item/stack/spacecash/c1000,/turf/open/floor/engine/cult,/area/ruin/powered/greed)
"vEh" = (/obj/structure/table/wood/poker,/obj/item/stack/spacecash/c500,/obj/item/stack/spacecash/c100,/obj/item/stack/spacecash/c1000,/obj/machinery/light/small{dir = 4},/turf/open/floor/engine/cult,/area/ruin/powered/greed)
"wmY" = (/obj/item/coin/gold,/turf/open/floor/engine/cult,/area/ruin/powered/greed)
"wue" = (/obj/structure/table/wood/poker,/obj/item/stack/spacecash/c200,/turf/open/floor/engine/cult,/area/ruin/powered/greed)
"wUl" = (/turf/open/floor/plating/asteroid/basalt/lava_land_surface,/area/lavaland/surface/outdoors)

(1,1,1) = {"
wUl
wUl
wUl
wUl
wUl
wUl
wUl
wUl
wUl
ikU
ikU
wUl
wUl
wUl
wUl
wUl
wUl
wUl
wUl
ikU
"}
(2,1,1) = {"
wUl
ikU
ikU
wUl
wUl
wUl
wUl
wUl
wUl
ikU
ikU
ikU
wUl
wUl
wUl
wUl
wUl
ikU
ikU
ikU
"}
(3,1,1) = {"
wUl
ikU
ikU
ikU
ikU
ikU
wUl
wUl
wUl
ikU
wUl
wUl
wUl
wUl
wUl
wUl
ikU
ikU
ikU
ikU
"}
(4,1,1) = {"
wUl
wUl
ikU
ikU
ikU
wUl
wUl
wUl
wUl
wUl
wUl
wUl
wUl
wUl
wUl
wUl
ikU
ikU
ikU
ikU
"}
(5,1,1) = {"
wUl
wUl
wUl
ikU
ikU
wUl
wUl
hmI
hmI
hmI
hmI
hmI
hmI
hmI
wUl
wUl
wUl
wUl
ikU
wUl
"}
(6,1,1) = {"
ikU
wUl
wUl
wUl
wUl
wUl
hmI
hmI
gTr
gTr
gTr
gTr
gTr
hmI
wUl
wUl
wUl
wUl
ikU
wUl
"}
(7,1,1) = {"
ikU
wUl
wUl
wUl
hmI
hmI
hmI
gTr
gTr
hfe
ube
wue
gTr
hmI
hmI
hmI
hmI
wUl
wUl
wUl
"}
(8,1,1) = {"
wUl
wUl
wUl
wUl
hmI
gTr
gTr
gTr
rLZ
lqv
wmY
eOr
gTr
gTr
gTr
gTr
hmI
wUl
wUl
wUl
"}
(9,1,1) = {"
wUl
wUl
ikU
wUl
hmI
gTr
jhj
dRg
wmY
eOr
eOr
eOr
wmY
eOr
lfG
gTr
gTr
wUl
wUl
wUl
"}
(10,1,1) = {"
ikU
ikU
ikU
wUl
hmI
gTr
kBL
prR
eOr
wmY
eOr
lqv
eOr
eOr
eOr
eOr
gDH
wUl
wUl
wUl
"}
(11,1,1) = {"
wUl
wUl
ikU
wUl
hmI
gTr
eqQ
tVr
wmY
eOr
eOr
wmY
eOr
wmY
mvZ
gTr
gTr
wUl
wUl
wUl
"}
(12,1,1) = {"
wUl
wUl
wUl
wUl
hmI
gTr
gTr
gTr
rLZ
lqv
eOr
wmY
gTr
gTr
gTr
gTr
hmI
wUl
wUl
wUl
"}
(13,1,1) = {"
wUl
wUl
wUl
wUl
hmI
hmI
hmI
gTr
gTr
lSq
vEh
uwO
gTr
hmI
hmI
hmI
hmI
wUl
wUl
wUl
"}
(14,1,1) = {"
ikU
ikU
wUl
wUl
wUl
wUl
hmI
hmI
gTr
gTr
gTr
gTr
gTr
hmI
wUl
wUl
wUl
wUl
wUl
wUl
"}
(15,1,1) = {"
ikU
ikU
wUl
wUl
wUl
wUl
wUl
hmI
hmI
hmI
hmI
hmI
hmI
hmI
wUl
wUl
wUl
wUl
wUl
wUl
"}
(16,1,1) = {"
ikU
ikU
ikU
ikU
wUl
wUl
wUl
wUl
wUl
wUl
wUl
wUl
wUl
wUl
wUl
wUl
wUl
wUl
ikU
ikU
"}
(17,1,1) = {"
wUl
wUl
ikU
ikU
wUl
wUl
wUl
wUl
wUl
wUl
wUl
wUl
wUl
wUl
wUl
wUl
wUl
wUl
ikU
ikU
"}
(18,1,1) = {"
wUl
wUl
wUl
ikU
ikU
ikU
ikU
ikU
ikU
ikU
ikU
ikU
ikU
wUl
wUl
ikU
ikU
ikU
ikU
ikU
"}
(19,1,1) = {"
wUl
wUl
wUl
ikU
ikU
ikU
ikU
wUl
wUl
wUl
ikU
ikU
ikU
ikU
wUl
ikU
ikU
ikU
ikU
ikU
"}
(20,1,1) = {"
wUl
wUl
wUl
wUl
ikU
ikU
wUl
wUl
wUl
wUl
wUl
wUl
ikU
ikU
ikU
ikU
ikU
ikU
ikU
ikU
"}
