// This map has been converted using maphash
"awt" = (/obj/structure/table,/obj/item/instrument/violin,/obj/item/ship_in_a_bottle,/turf/open/floor/wood,/area/ruin/powered)
"axx" = (/obj/structure/table,/obj/item/reagent_containers/pill/stimulant{pixel_x = 3; pixel_y = 4},/obj/item/reagent_containers/pill/stimulant,/obj/item/survivalcapsule{pixel_x = -7; pixel_y = 8},/obj/item/survivalcapsule{pixel_x = -6; pixel_y = 7},/turf/open/floor/wood,/area/ruin/powered)
"bGw" = (/obj/structure/shuttle/engine/heater{dir = 8},/turf/closed/wall/mineral/titanium,/area/ruin/powered)
"bOD" = (/turf/closed/wall/mineral/titanium,/area/ruin/powered)
"cCs" = (/obj/structure/shuttle/engine/propulsion{dir = 4; icon_state = "propulsion_l"},/turf/open/floor/plating/asteroid/basalt/lava_land_surface,/area/lavaland/surface/outdoors)
"fPZ" = (/turf/closed/wall/mineral/titanium/nodiagonal,/area/ruin/powered)
"geh" = (/obj/machinery/light,/turf/open/floor/wood,/area/ruin/powered)
"gze" = (/obj/machinery/vending/wallmed,/turf/closed/wall/mineral/titanium,/area/ruin/powered)
"hoU" = (/obj/machinery/newscaster,/turf/closed/wall/mineral/titanium,/area/ruin/powered)
"hEI" = (/obj/structure/mirror{pixel_y = -6},/turf/closed/wall/mineral/titanium,/area/ruin/powered)
"jLE" = (/obj/machinery/light/small,/obj/effect/mob_spawn/human/travelling_bard,/turf/open/floor/vault,/area/ruin/powered)
"kAz" = (/obj/structure/table,/obj/item/reagent_containers/food/drinks/coffee,/obj/item/reagent_containers/food/drinks/coffee{pixel_x = 9; pixel_y = 7},/obj/item/reagent_containers/food/drinks/coffee{pixel_x = 7},/obj/item/reagent_containers/food/drinks/coffee{pixel_x = 8; pixel_y = 4},/obj/item/reagent_containers/food/snacks/burger/bigbite{pixel_x = -3},/turf/open/floor/wood,/area/ruin/powered)
"nRY" = (/obj/structure/table,/obj/item/tank/internals/emergency_oxygen/double,/obj/item/clothing/mask/breath,/obj/item/flashlight/lantern{pixel_x = -7},/obj/item/gps/mining{pixel_x = 6},/obj/machinery/light{dir = 8; icon_state = "tube1"},/turf/open/floor/wood,/area/ruin/powered)
"oqQ" = (/obj/machinery/door/airlock/external,/obj/structure/fans/tiny/invisible,/turf/open/floor/vault,/area/ruin/powered)
"puK" = (/turf/closed/wall/mineral/titanium/interior,/area/ruin/powered)
"qPp" = (/obj/machinery/light,/turf/open/floor/plating/asteroid/basalt/lava_land_surface,/area/lavaland/surface/outdoors)
"rBp" = (/turf/open/floor/wood,/area/ruin/powered)
"ued" = (/obj/structure/table,/obj/item/storage/firstaid/brute{pixel_x = -6; pixel_y = 5},/obj/item/storage/firstaid/fire,/obj/item/storage/firstaid/toxin{pixel_x = 3; pixel_y = 5},/obj/item/storage/backpack/duffelbag/clown,/turf/open/floor/wood,/area/ruin/powered)
"vmb" = (/obj/structure/chair/comfy/teal{dir = 4; icon_state = "comfychair"},/turf/open/floor/wood,/area/ruin/powered)
"wUl" = (/turf/open/floor/plating/asteroid/basalt/lava_land_surface,/area/lavaland/surface/outdoors)
"ygr" = (/obj/machinery/door/airlock/hatch,/turf/open/floor/vault,/area/ruin/powered)

(1,1,1) = {"
wUl
wUl
wUl
cCs
cCs
wUl
wUl
wUl
"}
(2,1,1) = {"
qPp
fPZ
bOD
bGw
bGw
bOD
bOD
wUl
"}
(3,1,1) = {"
wUl
oqQ
rBp
ued
awt
nRY
bOD
wUl
"}
(4,1,1) = {"
qPp
hEI
rBp
rBp
rBp
kAz
bOD
wUl
"}
(5,1,1) = {"
wUl
gze
vmb
geh
fPZ
puK
fPZ
wUl
"}
(6,1,1) = {"
wUl
hoU
axx
rBp
ygr
jLE
bOD
wUl
"}
(7,1,1) = {"
wUl
bOD
bOD
bOD
fPZ
bOD
bOD
wUl
"}
(8,1,1) = {"
wUl
wUl
wUl
wUl
wUl
wUl
wUl
wUl
"}
