//MAP CONVERTED BY dmm2tgm.py THIS HEADER COMMENT PREVENTS RECONVERSION, DO NOT REMOVE
"ab" = (
/obj/machinery/door/poddoor/multi_tile/three_tile_hor,
/turf/open/floor/plasteel/dark/lavaland,
/area/ruin/unpowered)
"ae" = (
/mob/living/simple_animal/hostile/construct/harvester,
/turf/open/floor/plasteel/dark/lavaland,
/area/ruin/unpowered)
"ag" = (
/turf/open/lava,
/area/lavaland/surface/outdoors)
"au" = (
/turf/template_noop,
/area/lavaland/surface/outdoors)
"aw" = (
/obj/machinery/suit_storage_unit,
/turf/open/floor/plasteel/dark/lavaland,
/area/ruin/unpowered)
"az" = (
/turf/open/floor/plasteel/dark/lavaland,
/area/ruin/unpowered)
"aF" = (
/obj/machinery/suit_storage_unit/open,
/turf/open/floor/plasteel/dark/lavaland,
/area/ruin/unpowered)
"aP" = (
/turf/closed/wall/r_wall/syndicate,
/area/ruin/unpowered)
"aS" = (
/obj/structure/window/plastitanium,
/obj/structure/window/plastitanium,
/turf/open/floor/plasteel/dark/lavaland,
/area/ruin/unpowered)
"aX" = (
/obj/structure/window/plastitanium,
/turf/open/floor/plasteel/dark/lavaland,
/area/ruin/unpowered)
"ct" = (
/mob/living/simple_animal/hostile/construct/wraith/noncult,
/turf/open/floor/plasteel/dark/lavaland,
/area/ruin/unpowered)
"eI" = (
/obj/structure/table,
/obj/item/clothing/suit/space/hardsuit/powerarmor_advanced,
/turf/open/floor/plasteel/dark/lavaland,
/area/ruin/unpowered)
"fe" = (
/turf/open/floor/engine/cult,
/area/ruin/unpowered)
"fL" = (
/obj/structure/table/reinforced,
/obj/machinery/power/tesla_coil,
/turf/open/floor/plasteel/dark/lavaland,
/area/ruin/unpowered)
"fZ" = (
/obj/effect/decal/cleanable/blood/tracks,
/turf/open/floor/plasteel/dark/lavaland,
/area/ruin/unpowered)
"gg" = (
/obj/effect/decal/cleanable/blood/drip,
/obj/effect/rune,
/turf/open/floor/plasteel/dark/lavaland,
/area/ruin/unpowered)
"gW" = (
/obj/effect/decal/cleanable/blood/gibs/old,
/obj/item/ammo_casing/shotgun/pulseslug,
/turf/open/floor/plasteel/dark/lavaland,
/area/ruin/unpowered)
"hB" = (
/obj/effect/decal/cleanable/blood/splatter,
/turf/open/floor/plating/asteroid/basalt/lava_land_surface,
/area/lavaland/surface/outdoors)
"hF" = (
/obj/effect/decal/cleanable/blood/innards,
/turf/open/floor/plasteel/dark/lavaland,
/area/ruin/unpowered)
"iE" = (
/mob/living/carbon/human/cult_ghost,
/turf/open/floor/plasteel/dark/lavaland,
/area/ruin/unpowered)
"iK" = (
/obj/machinery/power/tesla_coil,
/turf/open/floor/plasteel/cult,
/area/ruin/unpowered)
"kP" = (
/obj/effect/mob_spawn/human/corpse,
/turf/open/floor/engine/cult,
/area/ruin/unpowered)
"nt" = (
/mob/living/simple_animal/hostile/construct/builder/noncult,
/obj/effect/decal/cleanable/blood/gibs/body,
/turf/open/floor/plasteel/dark/lavaland,
/area/ruin/unpowered)
"oq" = (
/obj/structure/table/reinforced,
/turf/open/floor/plasteel/dark/lavaland,
/area/ruin/unpowered)
"pq" = (
/obj/effect/mob_spawn/human/corpse,
/turf/open/floor/plating/asteroid/basalt/lava_land_surface,
/area/lavaland/surface/outdoors)
"qs" = (
/obj/effect/decal/cleanable/blood/gibs/core,
/turf/open/floor/plasteel/dark/lavaland,
/area/ruin/unpowered)
"rw" = (
/obj/effect/decal/cleanable/blood/tracks,
/obj/machinery/door/airlock/cult/glass,
/turf/open/floor/plasteel/dark/lavaland,
/area/ruin/unpowered)
"sp" = (
/obj/effect/decal/cleanable/blood/tracks,
/obj/item/ammo_casing/shotgun/pulseslug,
/turf/open/floor/engine/cult,
/area/ruin/unpowered)
"ux" = (
/mob/living/simple_animal/hostile/construct/wraith/hostile,
/turf/open/floor/plasteel/cult,
/area/ruin/unpowered)
"uI" = (
/obj/effect/rune,
/turf/open/floor/engine/cult,
/area/ruin/unpowered)
"vt" = (
/obj/effect/decal/cleanable/blood/gibs,
/obj/structure/table/reinforced,
/turf/open/floor/plasteel/dark/lavaland,
/area/ruin/unpowered)
"wq" = (
/turf/open/floor/plasteel/cult,
/area/ruin/unpowered)
"wH" = (
/obj/machinery/door/airlock/highsecurity,
/turf/open/floor/plasteel/dark/lavaland,
/area/ruin/unpowered)
"wS" = (
/obj/effect/decal/cleanable/blood/splatter,
/turf/open/floor/plasteel/dark/lavaland,
/area/ruin/unpowered)
"ys" = (
/mob/living/simple_animal/hostile/construct/armored/hostile,
/turf/open/floor/plasteel/dark/lavaland,
/area/ruin/unpowered)
"zk" = (
/obj/effect/decal/cleanable/blood/drip,
/turf/open/floor/plasteel/cult,
/area/ruin/unpowered)
"AE" = (
/obj/machinery/door/airlock/centcom,
/turf/open/floor/plasteel/dark/lavaland,
/area/ruin/unpowered)
"CP" = (
/obj/structure/table/reinforced,
/obj/item/gun/ballistic/shotgun/automatic/dual_tube,
/turf/open/floor/plasteel/dark/lavaland,
/area/ruin/unpowered)
"Dr" = (
/obj/item/ammo_casing/shotgun/pulseslug,
/turf/open/floor/engine/cult,
/area/ruin/unpowered)
"DS" = (
/obj/structure/destructible/cult/pylon,
/turf/open/floor/plasteel/dark/lavaland,
/area/ruin/unpowered)
"HF" = (
/obj/effect/rune,
/turf/open/floor/plasteel/dark/lavaland,
/area/ruin/unpowered)
"HL" = (
/obj/effect/decal/cleanable/blood/gibs/up,
/turf/open/floor/plasteel/dark/lavaland,
/area/ruin/unpowered)
"IN" = (
/obj/effect/decal/cleanable/blood/gibs/core,
/obj/effect/decal/cleanable/blood/gibs/torso,
/obj/item/ammo_casing/shotgun/pulseslug,
/turf/open/floor/engine/cult,
/area/ruin/unpowered)
"Ly" = (
/obj/effect/mob_spawn/human/corpse,
/turf/open/floor/plasteel/dark/lavaland,
/area/ruin/unpowered)
"Pq" = (
/obj/machinery/door/airlock/vault{
	name = "Armory"
	},
/turf/open/floor/plasteel/dark/lavaland,
/area/ruin/unpowered)
"QG" = (
/obj/structure/table/reinforced,
/mob/living/carbon/human/cult_ghost,
/turf/open/floor/plasteel/dark/lavaland,
/area/ruin/unpowered)
"Rx" = (
/obj/effect/decal/cleanable/blood/drip,
/turf/open/floor/plasteel/dark/lavaland,
/area/ruin/unpowered)
"Tw" = (
/obj/effect/decal/cleanable/blood/gibs,
/turf/closed/wall/r_wall/syndicate,
/area/ruin/unpowered)
"Uu" = (
/obj/effect/decal/cleanable/blood/old,
/turf/open/floor/engine/cult,
/area/ruin/unpowered)
"VN" = (
/obj/structure/table/reinforced,
/turf/open/floor/plasteel/cult,
/area/ruin/unpowered)
"Wd" = (
/obj/item/soulstone,
/turf/open/floor/plasteel/dark/lavaland,
/area/ruin/unpowered)
"WF" = (
/obj/effect/decal/cleanable/blood/gibs/limb,
/turf/open/floor/plasteel/cult,
/area/ruin/unpowered)
"WH" = (
/obj/machinery/the_singularitygen/tesla,
/turf/open/floor/plasteel/dark/lavaland,
/area/ruin/unpowered)
"WI" = (
/obj/effect/decal/cleanable/blood/gibs/core,
/turf/open/floor/plasteel/cult,
/area/ruin/unpowered)
"ZB" = (
/turf/open/floor/plating/asteroid/basalt/lava_land_surface,
/area/lavaland/surface/outdoors)

(1,1,1) = {"
au
au
au
au
au
au
au
au
au
au
au
au
au
au
au
au
au
au
au
au
au
au
au
au
au
au
au
au
au
au
"}
(2,1,1) = {"
au
au
au
au
au
au
au
au
au
au
au
au
au
au
au
au
au
au
au
au
au
au
au
au
au
au
au
au
au
au
"}
(3,1,1) = {"
au
au
au
au
au
au
au
au
au
au
au
au
au
au
au
au
au
au
au
au
au
au
au
au
au
au
au
au
au
au
"}
(4,1,1) = {"
au
au
au
au
au
au
au
au
au
au
au
au
ag
au
au
au
au
au
au
au
au
au
au
au
au
au
au
au
au
au
"}
(5,1,1) = {"
au
au
au
au
au
au
au
ag
ag
ag
ag
ag
ag
au
au
au
au
au
au
au
au
au
ZB
au
au
au
au
au
au
au
"}
(6,1,1) = {"
au
au
au
au
au
au
au
au
ag
ag
ag
ag
ag
au
au
au
au
ag
ag
ag
ag
ag
ZB
au
au
au
au
au
au
au
"}
(7,1,1) = {"
au
au
au
au
au
au
au
au
au
ag
ag
ag
ag
au
au
au
ag
ag
ag
ag
ag
ZB
ZB
ZB
au
au
au
au
au
au
"}
(8,1,1) = {"
au
au
au
au
au
au
au
au
aP
aP
aP
aP
aP
aP
aP
aP
ag
ag
ag
ag
ag
ZB
ZB
ZB
ZB
au
au
au
au
au
"}
(9,1,1) = {"
au
au
au
au
au
au
au
au
aP
eI
ab
WH
QG
oq
oq
aP
ag
ag
ag
ag
ag
ZB
ZB
ZB
ZB
au
au
au
au
au
"}
(10,1,1) = {"
au
au
au
au
au
au
au
au
aP
aF
az
ae
az
az
az
aP
ZB
ag
ZB
ag
ag
ZB
ZB
ZB
ZB
ZB
au
au
au
au
"}
(11,1,1) = {"
au
au
au
au
au
au
au
ag
aP
aw
az
az
oq
CP
oq
aP
aP
aP
aP
aP
aP
aP
ZB
ZB
ZB
ZB
au
au
au
au
"}
(12,1,1) = {"
au
au
au
au
ag
ag
au
ag
aP
aP
aP
Pq
aP
aP
aP
aP
iE
az
az
kP
fe
aP
ZB
ZB
ZB
ZB
au
au
au
au
"}
(13,1,1) = {"
au
au
au
au
ag
ag
ag
ag
aP
wq
fe
wq
aP
HF
wq
az
az
ys
az
wq
fe
aP
ag
ag
ZB
ZB
ZB
ZB
ZB
ZB
"}
(14,1,1) = {"
au
au
au
ag
ag
ag
ag
au
aP
HF
ux
fe
aX
az
ys
Dr
az
gg
az
wq
fe
aP
ZB
ag
ag
ZB
ZB
ZB
ZB
ZB
"}
(15,1,1) = {"
au
au
au
au
au
ag
ag
au
aP
HL
WI
az
aX
wq
az
fe
Dr
wq
az
Rx
az
aP
ag
ag
ag
ag
ZB
ZB
ZB
ZB
"}
(16,1,1) = {"
au
au
au
au
au
ag
ag
au
aP
qs
Dr
IN
aX
az
gW
DS
az
az
aP
AE
AE
aP
ZB
ag
ag
ZB
ZB
ZB
ZB
ZB
"}
(17,1,1) = {"
au
au
au
au
au
au
au
au
aP
Wd
nt
sp
rw
fZ
fZ
wS
ct
az
aX
zk
az
aP
ZB
ZB
ag
ZB
ZB
ZB
ZB
ZB
"}
(18,1,1) = {"
au
au
au
au
au
au
au
au
aP
iK
qs
Ly
aX
az
ux
WF
wq
az
aX
Uu
wS
wH
ZB
ZB
ag
ZB
ZB
ZB
ZB
ZB
"}
(19,1,1) = {"
au
au
au
au
au
au
au
au
aP
fL
vt
oq
aP
fe
uI
aP
oq
fL
aS
hF
az
aP
hB
ZB
ZB
hB
ZB
ZB
ZB
ZB
"}
(20,1,1) = {"
au
au
au
au
au
au
ag
ag
aP
aP
Tw
aP
aP
iE
wq
aP
aP
aP
aP
aP
aP
aP
ZB
pq
ZB
ZB
ZB
ZB
ZB
ZB
"}
(21,1,1) = {"
au
au
au
au
au
ag
ag
ag
ag
ag
ZB
ZB
aP
VN
oq
aP
ag
ag
ZB
ZB
ZB
ZB
ZB
hB
ZB
ZB
ZB
ZB
ZB
ZB
"}
(22,1,1) = {"
au
au
au
au
au
au
ag
ag
ag
ag
ag
ag
aP
aP
aP
aP
ag
ag
ag
ZB
ZB
ZB
ZB
ZB
ZB
ZB
ZB
ZB
ZB
ZB
"}
(23,1,1) = {"
au
au
au
au
au
au
ag
ag
ag
ag
ag
ag
ag
au
au
au
au
ag
ag
ag
ZB
ZB
ZB
ZB
ZB
ZB
ZB
ZB
ZB
ZB
"}
(24,1,1) = {"
au
au
au
au
au
ag
ag
ag
ag
ag
ag
ag
ag
au
au
au
au
ag
ag
ag
ag
ZB
ZB
ZB
ZB
ZB
ZB
ZB
ZB
ZB
"}
(25,1,1) = {"
au
au
au
au
au
au
au
au
ag
ag
ag
au
au
au
au
au
ag
ag
ag
ag
au
au
ZB
ZB
ZB
ZB
ZB
ZB
ZB
ZB
"}
(26,1,1) = {"
au
au
au
au
au
au
au
au
ag
ag
au
au
au
au
au
au
au
ag
ag
ag
au
au
ZB
ZB
ZB
ZB
ZB
ZB
ZB
ZB
"}
(27,1,1) = {"
au
au
au
au
au
au
au
au
ag
au
au
au
au
au
au
au
au
au
au
au
au
au
au
ZB
ZB
ZB
ZB
ZB
ZB
ZB
"}
(28,1,1) = {"
au
au
au
au
au
au
au
au
au
au
au
au
au
au
au
au
au
au
au
au
au
au
au
au
au
au
au
au
au
au
"}
(29,1,1) = {"
au
au
au
au
au
au
au
au
au
au
au
au
au
au
au
au
au
au
au
au
au
au
au
au
au
au
au
au
au
au
"}
(30,1,1) = {"
au
au
au
au
au
au
au
au
au
au
au
au
au
au
au
au
au
au
au
au
au
au
au
au
au
au
au
au
au
au
"}
