//MAP CONVERTED BY dmm2tgm.py THIS HEADER COMMENT PREVENTS RECONVERSION, DO NOT REMOVE
"b" = (
/obj/machinery/door/poddoor/multi_tile/three_tile_hor,
/turf/open/floor/plasteel/dark/lavaland,
/area/ruin/unpowered)
"g" = (
/turf/open/lava,
/area/lavaland/surface/outdoors)
"o" = (
/obj/structure/table,
/turf/open/floor/plasteel/dark/lavaland,
/area/ruin/unpowered)
"u" = (
/turf/template_noop,
/area/lavaland/surface/outdoors)
"w" = (
/obj/machinery/suit_storage_unit,
/turf/open/floor/plasteel/dark/lavaland,
/area/ruin/unpowered)
"z" = (
/turf/open/floor/plasteel/dark/lavaland,
/area/ruin/unpowered)
"F" = (
/obj/machinery/suit_storage_unit/open,
/turf/open/floor/plasteel/dark/lavaland,
/area/ruin/unpowered)
"P" = (
/turf/closed/wall/r_wall/syndicate,
/area/ruin/unpowered)
"S" = (
/obj/structure/window/plastitanium,
/obj/structure/window/plastitanium,
/turf/open/floor/plasteel/dark/lavaland,
/area/ruin/unpowered)
"X" = (
/obj/structure/window/plastitanium,
/turf/open/floor/plasteel/dark/lavaland,
/area/ruin/unpowered)

(1,1,1) = {"
u
u
u
u
u
u
u
u
u
u
u
u
u
u
u
u
u
u
u
u
u
u
u
u
u
u
u
u
u
u
"}
(2,1,1) = {"
u
u
u
u
u
u
u
u
u
u
u
u
u
u
u
u
u
u
u
u
u
u
u
u
u
u
u
u
u
u
"}
(3,1,1) = {"
u
u
u
u
u
u
u
u
u
u
u
u
u
u
u
u
u
u
u
u
u
u
u
u
u
u
u
u
u
u
"}
(4,1,1) = {"
u
u
u
u
u
u
u
u
u
u
u
u
g
u
u
u
u
u
u
u
u
u
u
u
u
u
u
u
u
u
"}
(5,1,1) = {"
u
u
u
u
u
u
u
g
g
g
g
g
g
u
u
u
u
u
u
u
u
u
u
u
u
u
u
u
u
u
"}
(6,1,1) = {"
u
u
u
u
u
u
u
u
g
g
g
g
g
u
u
u
u
g
g
g
g
g
u
u
u
u
u
u
u
u
"}
(7,1,1) = {"
u
u
u
u
u
u
u
u
u
g
g
g
g
u
u
u
g
g
g
g
g
u
u
u
u
u
u
u
u
u
"}
(8,1,1) = {"
u
u
u
u
u
u
u
u
P
P
P
P
P
P
P
P
g
g
g
g
g
u
u
u
u
u
u
u
u
u
"}
(9,1,1) = {"
u
u
u
u
u
u
u
u
P
o
b
z
z
z
o
P
g
g
g
g
g
u
u
u
u
u
u
u
u
u
"}
(10,1,1) = {"
u
u
u
u
u
u
u
u
P
F
z
z
z
z
o
P
u
g
u
g
g
u
u
u
u
u
u
u
u
u
"}
(11,1,1) = {"
u
u
u
u
u
u
u
g
P
w
z
z
z
z
o
P
P
P
P
P
P
P
u
u
u
u
u
u
u
u
"}
(12,1,1) = {"
u
u
u
u
g
g
u
g
P
P
P
z
P
P
P
P
z
z
z
z
z
P
u
u
u
u
u
u
u
u
"}
(13,1,1) = {"
u
u
u
u
g
g
g
g
P
z
z
z
P
z
z
z
z
z
z
z
z
P
g
g
u
u
u
u
u
u
"}
(14,1,1) = {"
u
u
u
g
g
g
g
u
P
z
z
z
X
z
z
z
z
z
z
z
z
P
u
g
g
u
u
u
u
u
"}
(15,1,1) = {"
u
u
u
u
u
g
g
u
P
z
z
z
X
z
z
z
z
z
z
z
z
P
g
g
g
g
u
u
u
u
"}
(16,1,1) = {"
u
u
u
u
u
g
g
u
P
z
z
z
X
z
z
z
z
z
P
z
z
P
u
g
g
u
u
u
u
u
"}
(17,1,1) = {"
u
u
u
u
u
u
u
u
P
z
z
z
z
z
z
z
z
z
X
z
z
P
u
u
g
u
u
u
u
u
"}
(18,1,1) = {"
u
u
u
u
u
u
u
u
P
z
z
z
X
z
z
z
z
z
X
z
z
z
u
u
g
u
u
u
u
u
"}
(19,1,1) = {"
u
u
u
u
u
u
u
u
P
z
z
z
P
z
z
P
z
z
S
z
z
P
u
u
u
u
u
u
u
u
"}
(20,1,1) = {"
u
u
u
u
u
u
g
g
P
P
P
P
P
z
z
P
P
P
P
P
P
P
u
u
u
u
u
u
u
u
"}
(21,1,1) = {"
u
u
u
u
u
g
g
g
g
g
u
u
P
z
z
P
g
g
u
u
u
u
u
u
u
u
u
u
u
u
"}
(22,1,1) = {"
u
u
u
u
u
u
g
g
g
g
g
g
P
P
P
P
g
g
g
u
u
u
u
u
u
u
u
u
u
u
"}
(23,1,1) = {"
u
u
u
u
u
u
g
g
g
g
g
g
g
u
u
u
u
g
g
g
u
u
u
u
u
u
u
u
u
u
"}
(24,1,1) = {"
u
u
u
u
u
g
g
g
g
g
g
g
g
u
u
u
u
g
g
g
g
u
u
u
u
u
u
u
u
u
"}
(25,1,1) = {"
u
u
u
u
u
u
u
u
g
g
g
u
u
u
u
u
g
g
g
g
u
u
u
u
u
u
u
u
u
u
"}
(26,1,1) = {"
u
u
u
u
u
u
u
u
g
g
u
u
u
u
u
u
u
g
g
g
u
u
u
u
u
u
u
u
u
u
"}
(27,1,1) = {"
u
u
u
u
u
u
u
u
g
u
u
u
u
u
u
u
u
u
u
u
u
u
u
u
u
u
u
u
u
u
"}
(28,1,1) = {"
u
u
u
u
u
u
u
u
u
u
u
u
u
u
u
u
u
u
u
u
u
u
u
u
u
u
u
u
u
u
"}
(29,1,1) = {"
u
u
u
u
u
u
u
u
u
u
u
u
u
u
u
u
u
u
u
u
u
u
u
u
u
u
u
u
u
u
"}
(30,1,1) = {"
u
u
u
u
u
u
u
u
u
u
u
u
u
u
u
u
u
u
u
u
u
u
u
u
u
u
u
u
u
u
"}
