// This map has been converted using maphash
"aBT" = (/mob/living/simple_animal/hostile/megafauna/hierophant,/turf/open/indestructible/hierophant/two,/area/ruin/unpowered/hierophant)
"dli" = (/turf/open/indestructible/hierophant,/area/ruin/unpowered/hierophant)
"pNz" = (/turf/closed/indestructible/riveted/hierophant,/area/ruin/unpowered/hierophant)
"rAS" = (/obj/effect/light_emitter{set_cap = 3; set_luminosity = 5},/turf/open/indestructible/hierophant/two,/area/ruin/unpowered/hierophant)
"sam" = (/obj/effect/light_emitter{set_cap = 3; set_luminosity = 5},/turf/open/indestructible/hierophant,/area/ruin/unpowered/hierophant)
"vGs" = (/turf/open/indestructible/hierophant/two,/area/ruin/unpowered/hierophant)

(1,1,1) = {"
pNz
pNz
pNz
dli
dli
dli
dli
pNz
pNz
pNz
pNz
pNz
pNz
pNz
pNz
pNz
dli
dli
dli
dli
pNz
pNz
pNz
"}
(2,1,1) = {"
pNz
dli
dli
dli
dli
dli
dli
dli
dli
dli
dli
sam
dli
dli
dli
dli
dli
dli
dli
dli
dli
dli
pNz
"}
(3,1,1) = {"
pNz
dli
dli
dli
sam
sam
dli
dli
dli
pNz
dli
dli
dli
pNz
dli
dli
dli
sam
sam
dli
dli
dli
pNz
"}
(4,1,1) = {"
dli
dli
dli
dli
dli
dli
dli
dli
dli
dli
dli
dli
dli
dli
dli
dli
dli
dli
dli
dli
dli
dli
dli
"}
(5,1,1) = {"
dli
dli
sam
dli
pNz
pNz
dli
sam
dli
dli
dli
sam
dli
dli
dli
sam
dli
pNz
pNz
dli
sam
dli
dli
"}
(6,1,1) = {"
dli
dli
sam
dli
pNz
pNz
dli
sam
dli
dli
dli
sam
dli
dli
dli
sam
dli
pNz
pNz
dli
sam
dli
dli
"}
(7,1,1) = {"
dli
dli
dli
dli
dli
dli
vGs
vGs
vGs
vGs
vGs
vGs
vGs
vGs
vGs
vGs
vGs
dli
dli
dli
dli
dli
dli
"}
(8,1,1) = {"
pNz
dli
dli
dli
sam
sam
vGs
vGs
vGs
pNz
vGs
vGs
vGs
pNz
vGs
vGs
vGs
sam
sam
dli
dli
dli
pNz
"}
(9,1,1) = {"
pNz
dli
dli
dli
dli
dli
vGs
vGs
vGs
vGs
vGs
rAS
vGs
vGs
vGs
vGs
vGs
dli
dli
dli
dli
dli
pNz
"}
(10,1,1) = {"
pNz
dli
pNz
dli
dli
dli
vGs
pNz
vGs
vGs
vGs
vGs
vGs
vGs
vGs
pNz
vGs
dli
dli
dli
pNz
dli
pNz
"}
(11,1,1) = {"
pNz
dli
dli
dli
dli
dli
vGs
vGs
vGs
vGs
vGs
vGs
vGs
vGs
vGs
vGs
vGs
dli
dli
dli
dli
dli
pNz
"}
(12,1,1) = {"
pNz
sam
dli
dli
sam
sam
vGs
vGs
rAS
vGs
vGs
aBT
vGs
vGs
rAS
vGs
vGs
sam
sam
dli
dli
sam
pNz
"}
(13,1,1) = {"
pNz
dli
dli
dli
dli
dli
vGs
vGs
vGs
vGs
vGs
vGs
vGs
vGs
vGs
vGs
vGs
dli
dli
dli
dli
dli
pNz
"}
(14,1,1) = {"
pNz
dli
pNz
dli
dli
dli
vGs
pNz
vGs
vGs
vGs
vGs
vGs
vGs
vGs
pNz
vGs
dli
dli
dli
pNz
dli
pNz
"}
(15,1,1) = {"
pNz
dli
dli
dli
dli
dli
vGs
vGs
vGs
vGs
vGs
rAS
vGs
vGs
vGs
vGs
vGs
dli
dli
dli
dli
dli
pNz
"}
(16,1,1) = {"
pNz
dli
dli
dli
sam
sam
vGs
vGs
vGs
pNz
vGs
vGs
vGs
pNz
vGs
vGs
vGs
sam
sam
dli
dli
dli
pNz
"}
(17,1,1) = {"
dli
dli
dli
dli
dli
dli
vGs
vGs
vGs
vGs
vGs
vGs
vGs
vGs
vGs
vGs
vGs
dli
dli
dli
dli
dli
dli
"}
(18,1,1) = {"
dli
dli
sam
dli
pNz
pNz
dli
sam
dli
dli
dli
sam
dli
dli
dli
sam
dli
pNz
pNz
dli
sam
dli
dli
"}
(19,1,1) = {"
dli
dli
sam
dli
pNz
pNz
dli
sam
dli
dli
dli
sam
dli
dli
dli
sam
dli
pNz
pNz
dli
sam
dli
dli
"}
(20,1,1) = {"
dli
dli
dli
dli
dli
dli
dli
dli
dli
dli
dli
dli
dli
dli
dli
dli
dli
dli
dli
dli
dli
dli
dli
"}
(21,1,1) = {"
pNz
dli
dli
dli
sam
sam
dli
dli
dli
pNz
dli
dli
dli
pNz
dli
dli
dli
sam
sam
dli
dli
dli
pNz
"}
(22,1,1) = {"
pNz
dli
dli
dli
dli
dli
dli
dli
dli
dli
dli
sam
dli
dli
dli
dli
dli
dli
dli
dli
dli
dli
pNz
"}
(23,1,1) = {"
pNz
pNz
pNz
dli
dli
dli
dli
pNz
pNz
pNz
pNz
pNz
pNz
pNz
pNz
pNz
dli
dli
dli
dli
pNz
pNz
pNz
"}
