//MAP CONVERTED BY dmm2tgm.py THIS HEADER COMMENT PREVENTS RECONVERSION, DO NOT REMOVE
"a" = (
/obj/structure/closet/secure_closet/personal/cabinet,
/obj/item/clothing/suit/jacket{
	desc = "All the class of a trenchcoat without the security fibers.";
	icon_state = "greydet";
	name = "trenchcoat"
	},
/obj/item/clothing/suit/jacket{
	desc = "All the class of a trenchcoat without the security fibers.";
	icon_state = "detective";
	name = "trenchcoat"
	},
/obj/item/clothing/head/fedora,
/obj/item/clothing/head/fedora{
	icon_state = "detective"
	},
/obj/effect/turf_decal/tile/neutral,
/obj/effect/turf_decal/tile/neutral{
	dir = 4
	},
/obj/effect/decal/cleanable/dirt,
/turf/open/floor/plasteel/dark,
/area/template_noop)
"b" = (
/turf/open/floor/wood,
/area/template_noop)
"c" = (
/obj/effect/turf_decal/tile/neutral{
	dir = 4
	},
/obj/structure/table/wood,
/obj/item/storage/box/evidence{
	pixel_y = 4
	},
/obj/item/taperecorder{
	pixel_x = 4;
	pixel_y = 4
	},
/obj/effect/decal/cleanable/dirt,
/turf/open/floor/plasteel/dark,
/area/template_noop)
"e" = (
/obj/effect/turf_decal/tile/neutral,
/obj/effect/turf_decal/tile/neutral{
	dir = 4
	},
/obj/effect/turf_decal/bot_white,
/obj/effect/decal/cleanable/dirt,
/turf/open/floor/plasteel/dark,
/area/template_noop)
"f" = (
/obj/structure/chair/office{
	dir = 8
	},
/turf/open/floor/carpet/green,
/area/template_noop)
"i" = (
/obj/effect/decal/cleanable/blood/old,
/obj/effect/decal/remains/human,
/obj/item/clothing/neck/tie/detective,
/turf/open/floor/carpet/green,
/area/template_noop)
"m" = (
/obj/effect/turf_decal/tile/neutral{
	dir = 4
	},
/obj/effect/turf_decal/tile/neutral{
	dir = 1
	},
/obj/structure/filingcabinet,
/obj/effect/turf_decal/bot_white,
/obj/effect/decal/cleanable/dirt,
/turf/open/floor/plasteel/dark,
/area/template_noop)
"q" = (
/obj/effect/decal/cleanable/cobweb/cobweb2,
/obj/machinery/photocopier,
/obj/item/newspaper{
	pixel_x = 4;
	pixel_y = 4
	},
/obj/item/newspaper,
/turf/open/floor/wood{
	icon_state = "wood-broken6"
	},
/area/template_noop)
"r" = (
/obj/effect/turf_decal/stripes/corner,
/turf/open/floor/wood,
/area/template_noop)
"y" = (
/obj/effect/turf_decal/stripes/line{
	dir = 4
	},
/obj/effect/decal/cleanable/blood/old,
/turf/open/floor/carpet/green,
/area/template_noop)
"A" = (
/obj/effect/turf_decal/tile/neutral{
	dir = 4
	},
/obj/effect/turf_decal/tile/neutral{
	dir = 1
	},
/obj/item/book/manual/wiki/detective{
	pixel_y = 4
	},
/obj/item/camera,
/obj/effect/decal/cleanable/dirt,
/obj/structure/table_frame/wood,
/turf/open/floor/plasteel/dark,
/area/template_noop)
"C" = (
/obj/effect/turf_decal/tile/neutral,
/obj/effect/turf_decal/tile/neutral{
	dir = 4
	},
/obj/structure/frame/computer{
	anchored = 1;
	dir = 4;
	icon_state = "0"
	},
/obj/effect/turf_decal/bot_white,
/obj/effect/decal/cleanable/dirt,
/turf/open/floor/plasteel/dark,
/area/template_noop)
"P" = (
/obj/effect/turf_decal/stripes/corner{
	dir = 4
	},
/obj/machinery/light/small{
	dir = 4
	},
/obj/item/stack/sheet/mineral/wood,
/obj/item/stack/sheet/mineral/wood,
/obj/item/stack/sheet/mineral/wood,
/turf/open/floor/carpet/green,
/area/template_noop)

(1,1,1) = {"
a
C
e
C
c
"}
(2,1,1) = {"
b
b
f
i
A
"}
(3,1,1) = {"
q
r
y
P
m
"}
