//MAP CONVERTED BY dmm2tgm.py THIS HEADER COMMENT PREVENTS RECONVERSION, DO NOT REMOVE
"aw" = (
/mob/living/simple_animal/hostile/abomination/altform4,
/turf/open/floor/plating/abductor,
/area/ruin/powered/alien_lab)
"bd" = (
/obj/machinery/clonepod/experimental,
/turf/open/floor/plating/abductor,
/area/ruin/powered/alien_lab)
"be" = (
/obj/machinery/clonepod,
/turf/open/floor/plating/abductor,
/area/ruin/powered/alien_lab)
"eK" = (
/obj/effect/decal/cleanable/blood/footprints{
	dir = 8
	},
/turf/open/floor/plating/abductor,
/area/ruin/powered/alien_lab)
"fP" = (
/mob/living/simple_animal/hostile/asteroid/ambusher,
/turf/open/indestructible/grass/snow,
/area/ruin/powered/alien_lab)
"fW" = (
/turf/template_noop,
/area/template_noop)
"gc" = (
/mob/living/carbon/human/moja,
/turf/open/floor/plating/abductor,
/area/ruin/powered/alien_lab)
"iW" = (
/obj/structure/flora/tree/dead,
/turf/open/floor/grass/snow,
/area/icemoon/underground/explored)
"kT" = (
/obj/effect/decal/cleanable/blood/gibs/old,
/obj/effect/decal/cleanable/blood/gibs/down,
/turf/open/floor/plating/abductor,
/area/ruin/powered/alien_lab)
"ln" = (
/obj/effect/decal/cleanable/blood/drip,
/turf/open/floor/plating/abductor,
/area/ruin/powered/alien_lab)
"lN" = (
/obj/effect/decal/cleanable/blood/drip,
/turf/open/floor/grass/snow,
/area/icemoon/underground/explored)
"mS" = (
/obj/effect/decal/cleanable/blood/gibs/up,
/obj/structure/bed/abductor,
/mob/living/carbon/human/moja,
/obj/item/organ/heart/gland/heals,
/turf/open/floor/plating/abductor,
/area/ruin/powered/alien_lab)
"nJ" = (
/obj/effect/decal/cleanable/blood/tracks,
/turf/open/floor/plating/abductor,
/area/ruin/powered/alien_lab)
"rg" = (
/obj/structure/flora/tree/pine,
/turf/open/floor/grass/snow,
/area/icemoon/underground/explored)
"rY" = (
/obj/machinery/light/small,
/turf/open/floor/plating/abductor,
/area/ruin/powered/alien_lab)
"uW" = (
/obj/effect/decal/cleanable/blood/gibs/body{
	dir = 1
	},
/obj/effect/decal/cleanable/blood/gibs/limb{
	dir = 1
	},
/obj/machinery/light/broken{
	dir = 1
	},
/turf/open/floor/plating/abductor,
/area/ruin/powered/alien_lab)
"vi" = (
/obj/effect/decal/cleanable/blood/gibs/down,
/obj/effect/decal/cleanable/blood/gibs/down,
/turf/open/floor/plating/abductor,
/area/ruin/powered/alien_lab)
"wa" = (
/turf/open/floor/grass/snow,
/area/icemoon/underground/explored)
"wD" = (
/mob/living/simple_animal/hostile/abomination/altform2,
/turf/open/floor/plating/abductor,
/area/ruin/powered/alien_lab)
"wQ" = (
/obj/effect/decal/cleanable/blood/gibs,
/turf/open/floor/plating/abductor,
/area/ruin/powered/alien_lab)
"xi" = (
/obj/effect/decal/cleanable/blood/gibs/torso,
/turf/open/floor/plating/abductor,
/area/ruin/powered/alien_lab)
"xI" = (
/mob/living/simple_animal/hostile/abomination,
/turf/open/floor/plating/abductor,
/area/ruin/powered/alien_lab)
"yj" = (
/mob/living/carbon/human/moja,
/turf/open/lava/plasma,
/area/ruin/powered/alien_lab)
"yO" = (
/mob/living/simple_animal/hostile/asteroid/wolf,
/obj/item/reagent_containers/food/snacks/meat/slab/human,
/turf/open/indestructible/grass/snow,
/area/ruin/powered/alien_lab)
"Af" = (
/obj/structure/table/abductor,
/obj/item/abductor/baton,
/turf/open/floor/plating/abductor,
/area/ruin/powered/alien_lab)
"AM" = (
/mob/living/simple_animal/hostile/skeleton/plasmaminer/jackhammer,
/turf/open/floor/plating/abductor,
/area/ruin/powered/alien_lab)
"AR" = (
/obj/machinery/light/broken,
/turf/open/floor/plating/abductor,
/area/ruin/powered/alien_lab)
"AZ" = (
/obj/effect/spawner/structure/window,
/turf/open/floor/plating,
/area/ruin/powered/alien_lab)
"Be" = (
/mob/living/simple_animal/hostile/asteroid/wolf,
/turf/open/indestructible/grass/snow,
/area/ruin/powered/alien_lab)
"Bk" = (
/mob/living/simple_animal/hostile/asteroid/ambusher,
/turf/open/floor/plating/abductor,
/area/ruin/powered/alien_lab)
"CZ" = (
/obj/item/reagent_containers/food/snacks/meat/slab/human,
/mob/living/simple_animal/hostile/asteroid/wolf,
/turf/open/indestructible/grass/snow,
/area/ruin/powered/alien_lab)
"Dd" = (
/obj/machinery/light/broken{
	dir = 8
	},
/turf/open/floor/plating/abductor,
/area/ruin/powered/alien_lab)
"Di" = (
/mob/living/simple_animal/hostile/abomination/altform1,
/turf/open/floor/plating/abductor,
/area/ruin/powered/alien_lab)
"DD" = (
/obj/effect/decal/cleanable/blood/gibs/up,
/turf/open/floor/plating/abductor,
/area/ruin/powered/alien_lab)
"DP" = (
/obj/effect/decal/cleanable/blood/gibs,
/obj/effect/decal/cleanable/blood/tracks,
/turf/open/floor/plating/abductor,
/area/ruin/powered/alien_lab)
"GC" = (
/turf/open/lava/plasma,
/area/ruin/powered/alien_lab)
"GI" = (
/obj/effect/decal/cleanable/blood/gibs/up,
/obj/effect/decal/cleanable/blood/gibs/body,
/turf/open/floor/plating/abductor,
/area/ruin/powered/alien_lab)
"GL" = (
/mob/living/simple_animal/hostile/abomination/super,
/turf/open/floor/plating/abductor,
/area/ruin/powered/alien_lab)
"Hl" = (
/obj/machinery/light/small{
	dir = 4
	},
/turf/open/floor/plating/abductor,
/area/ruin/powered/alien_lab)
"Jn" = (
/turf/closed/indestructible/abductor,
/area/ruin/powered/alien_lab)
"Ls" = (
/obj/machinery/mindmachine_pod,
/turf/open/floor/plating/abductor,
/area/ruin/powered/alien_lab)
"LQ" = (
/obj/effect/decal/cleanable/blood/gibs/core,
/obj/effect/decal/cleanable/blood/gibs/body,
/turf/open/floor/plating/abductor,
/area/ruin/powered/alien_lab)
"Mw" = (
/obj/machinery/abductor/experiment,
/turf/open/floor/plating/abductor,
/area/ruin/powered/alien_lab)
"Mz" = (
/obj/item/card/id{
	access = list("ruins_science")
	},
/mob/living/simple_animal/hostile/abomination/super,
/turf/open/floor/plating/abductor,
/area/ruin/powered/alien_lab)
"Nf" = (
/obj/machinery/light/broken{
	dir = 1
	},
/obj/effect/decal/cleanable/blood/drip,
/turf/open/floor/plating/abductor,
/area/ruin/powered/alien_lab)
"Nv" = (
/turf/open/floor/plating/abductor,
/area/ruin/powered/alien_lab)
"Nw" = (
/obj/machinery/dna_scannernew,
/turf/open/floor/plating/abductor,
/area/ruin/powered/alien_lab)
"NG" = (
/obj/machinery/door/airlock/abductor{
	req_access = list("ruins_science")
	},
/turf/open/floor/plating/abductor,
/area/ruin/powered/alien_lab)
"NN" = (
/obj/machinery/abductor/pad,
/turf/open/floor/plating/abductor,
/area/ruin/powered/alien_lab)
"Qd" = (
/obj/structure/table/abductor,
/obj/item/organ/heart/ghetto,
/turf/open/floor/plating/abductor,
/area/ruin/powered/alien_lab)
"QC" = (
/obj/structure/flora/tree/dead/jungle,
/turf/open/floor/grass/snow,
/area/icemoon/underground/explored)
"TX" = (
/obj/machinery/clonepod{
	icon_state = "pod_g"
	},
/turf/open/floor/plating/abductor,
/area/ruin/powered/alien_lab)
"Uc" = (
/obj/machinery/door/airlock/abductor,
/turf/open/floor/plating/abductor,
/area/ruin/powered/alien_lab)
"Uw" = (
/obj/machinery/computer/prototype_cloning,
/turf/open/floor/plating/abductor,
/area/ruin/powered/alien_lab)
"UM" = (
/obj/effect/decal/cleanable/blood/tracks{
	dir = 8
	},
/turf/open/floor/plating/abductor,
/area/ruin/powered/alien_lab)
"Vn" = (
/obj/item/reagent_containers/food/snacks/meat/slab/human,
/turf/open/indestructible/grass/snow,
/area/ruin/powered/alien_lab)
"Ww" = (
/turf/open/indestructible/grass/snow,
/area/ruin/powered/alien_lab)
"WT" = (
/obj/effect/decal/cleanable/blood/gibs/body,
/obj/effect/decal/remains/human,
/turf/open/floor/plating/abductor,
/area/ruin/powered/alien_lab)
"Xj" = (
/mob/living/simple_animal/hostile/asteroid/ambusher,
/obj/item/reagent_containers/food/snacks/meat/slab/human,
/obj/effect/decal/remains/human,
/turf/open/indestructible/grass/snow,
/area/ruin/powered/alien_lab)
"Xn" = (
/obj/effect/decal/cleanable/blood/gibs/down,
/turf/open/floor/plating/abductor,
/area/ruin/powered/alien_lab)
"XE" = (
/obj/effect/decal/remains/human,
/obj/machinery/light/small,
/turf/open/indestructible/grass/snow,
/area/ruin/powered/alien_lab)
"Ya" = (
/obj/machinery/abductor/console,
/turf/open/floor/plating/abductor,
/area/ruin/powered/alien_lab)
"Yw" = (
/obj/effect/decal/cleanable/blood/gibs/core,
/turf/open/floor/plating/abductor,
/area/ruin/powered/alien_lab)
"YY" = (
/obj/machinery/light/broken{
	dir = 1
	},
/turf/open/floor/plating/abductor,
/area/ruin/powered/alien_lab)
"YZ" = (
/obj/structure/door_assembly/door_assembly_abductor,
/turf/open/floor/grass/snow,
/area/icemoon/underground/explored)

(1,1,1) = {"
fW
fW
fW
fW
fW
fW
fW
fW
fW
fW
fW
fW
fW
fW
fW
fW
fW
fW
fW
fW
fW
fW
fW
fW
fW
fW
fW
fW
fW
fW
"}
(2,1,1) = {"
fW
fW
fW
fW
fW
fW
fW
fW
fW
fW
fW
fW
fW
fW
fW
fW
fW
fW
fW
fW
fW
fW
fW
fW
fW
fW
fW
fW
fW
fW
"}
(3,1,1) = {"
fW
fW
fW
fW
fW
fW
fW
fW
fW
fW
fW
fW
fW
Jn
Jn
Jn
Jn
Jn
Jn
Jn
wa
fW
fW
fW
fW
fW
fW
fW
fW
fW
"}
(4,1,1) = {"
fW
fW
fW
fW
fW
fW
fW
fW
fW
fW
fW
fW
fW
Jn
Nv
Nv
Nv
Yw
aw
Jn
wa
fW
fW
fW
fW
fW
fW
fW
fW
fW
"}
(5,1,1) = {"
fW
fW
fW
fW
fW
fW
fW
fW
fW
fW
fW
fW
fW
Jn
Nv
GL
Nv
Nv
Nv
Jn
wa
fW
fW
fW
fW
fW
fW
fW
fW
fW
"}
(6,1,1) = {"
fW
fW
fW
fW
fW
fW
fW
fW
fW
fW
fW
fW
fW
Jn
Nv
Nv
mS
Nv
Nv
Jn
iW
fW
fW
fW
fW
fW
fW
fW
fW
fW
"}
(7,1,1) = {"
fW
fW
fW
fW
fW
fW
fW
fW
fW
fW
fW
fW
fW
Jn
Qd
Nv
Nv
xi
Nv
Jn
wa
fW
fW
fW
fW
fW
fW
fW
fW
fW
"}
(8,1,1) = {"
fW
fW
fW
fW
fW
fW
fW
fW
fW
fW
fW
fW
fW
Jn
Ls
wQ
Nv
Mw
vi
Jn
wa
fW
fW
fW
fW
fW
fW
fW
fW
fW
"}
(9,1,1) = {"
fW
fW
fW
fW
fW
fW
fW
fW
fW
fW
fW
fW
fW
Jn
Jn
Jn
NG
Jn
Jn
Jn
wa
fW
fW
fW
fW
fW
fW
fW
fW
fW
"}
(10,1,1) = {"
fW
fW
fW
fW
fW
fW
fW
fW
fW
fW
fW
fW
fW
Jn
Be
AZ
Nv
AZ
CZ
Jn
fW
fW
fW
fW
fW
fW
fW
fW
fW
fW
"}
(11,1,1) = {"
fW
fW
fW
fW
fW
Jn
Jn
Jn
Jn
Jn
Jn
Jn
Jn
Jn
Vn
AZ
Nv
AZ
XE
Jn
fW
fW
fW
fW
fW
fW
fW
fW
fW
fW
"}
(12,1,1) = {"
fW
fW
fW
fW
fW
Jn
AM
Nv
AM
Jn
Nv
Bk
Nv
Jn
CZ
AZ
Nv
AZ
fP
Jn
fW
fW
fW
fW
fW
fW
fW
fW
fW
fW
"}
(13,1,1) = {"
fW
fW
fW
fW
fW
Jn
Nv
Nv
Nv
Jn
Nv
Nv
gc
Jn
Ww
AZ
Nv
AZ
Vn
Jn
fW
Jn
Jn
Jn
Jn
fW
fW
fW
fW
fW
"}
(14,1,1) = {"
fW
Jn
Jn
Jn
Jn
Jn
Nv
Nv
AM
Jn
Nv
Nv
Bk
Jn
Xj
AZ
Nv
AZ
yO
Jn
fW
Jn
Nv
WT
Jn
fW
fW
fW
fW
fW
"}
(15,1,1) = {"
fW
Jn
Ya
Nv
Nv
Jn
Uc
Jn
Jn
Jn
Uc
Jn
Jn
Jn
Jn
Jn
Uc
Jn
Jn
Jn
Jn
Jn
GI
Nv
Jn
fW
fW
fW
fW
fW
"}
(16,1,1) = {"
fW
Jn
Uw
Nv
Af
Jn
Nv
Nv
Nv
Dd
LQ
Nv
Nv
Nv
Nv
Dd
eK
Dd
Nv
Nv
Nv
Jn
YY
aw
Jn
fW
fW
fW
fW
fW
"}
(17,1,1) = {"
fW
Jn
Nw
Nv
Nv
Uc
Nv
Nv
Nv
Nv
Nv
Nv
Nv
Nv
Nv
Nv
Nv
Nv
Nv
nJ
DP
Uc
Nv
Nv
Jn
fW
fW
fW
fW
fW
"}
(18,1,1) = {"
fW
Jn
bd
Nv
Nv
Jn
Nv
Nv
kT
Nv
Hl
Nv
Nv
Nv
Nv
Nv
Nv
Nv
UM
Nv
rY
Jn
uW
wQ
Jn
fW
fW
fW
fW
fW
"}
(19,1,1) = {"
fW
Jn
NN
Nv
Nv
Jn
Jn
Jn
Uc
Jn
Jn
Jn
Uc
Jn
Nv
be
Nv
be
Nv
Jn
Jn
Jn
wD
DD
Jn
fW
fW
fW
fW
fW
"}
(20,1,1) = {"
fW
Jn
Jn
Jn
Jn
Jn
Di
Nv
Nv
Jn
GC
yj
Nv
Jn
Nv
Nv
Nv
Nv
Nv
Jn
wa
Jn
Xn
Mz
Jn
wa
fW
fW
fW
fW
"}
(21,1,1) = {"
fW
fW
fW
fW
fW
Jn
Nv
Nv
Nv
Jn
GC
GC
yj
Jn
Nf
Nv
Nv
Nv
AR
Jn
wa
Jn
Jn
Jn
Jn
wa
fW
fW
fW
fW
"}
(22,1,1) = {"
fW
fW
fW
fW
fW
Jn
xI
Nv
gc
Jn
GC
GC
GC
Jn
Nv
TX
Nv
be
Nv
Jn
wa
wa
wa
wa
wa
QC
fW
fW
fW
fW
"}
(23,1,1) = {"
fW
fW
fW
fW
fW
Jn
Jn
Jn
Jn
Jn
Jn
Jn
Jn
Jn
Nv
Nv
Nv
Nv
Nv
Jn
wa
fW
fW
fW
fW
fW
fW
fW
fW
fW
"}
(24,1,1) = {"
fW
fW
fW
fW
fW
fW
fW
fW
fW
fW
fW
fW
fW
Jn
Nv
ln
Nv
Nv
Nv
Jn
wa
fW
fW
fW
fW
fW
fW
fW
fW
fW
"}
(25,1,1) = {"
fW
fW
fW
fW
fW
fW
fW
fW
fW
fW
fW
fW
fW
Jn
YY
TX
Nv
TX
Nv
Jn
wa
wa
fW
fW
fW
fW
fW
fW
fW
fW
"}
(26,1,1) = {"
fW
fW
fW
fW
fW
fW
fW
fW
fW
fW
fW
fW
fW
Jn
Nv
Nv
lN
Nv
rY
Jn
wa
wa
fW
fW
fW
fW
fW
fW
fW
fW
"}
(27,1,1) = {"
fW
fW
fW
fW
fW
fW
fW
fW
fW
fW
fW
fW
fW
Jn
Jn
wa
wa
wa
Jn
Jn
wa
rg
fW
fW
fW
fW
fW
fW
fW
fW
"}
(28,1,1) = {"
fW
fW
fW
fW
fW
fW
fW
fW
fW
fW
wa
wa
fW
wa
wa
wa
YZ
wa
wa
wa
wa
fW
fW
fW
fW
fW
fW
fW
fW
fW
"}
(29,1,1) = {"
fW
fW
fW
fW
fW
fW
fW
fW
fW
fW
rg
wa
wa
wa
wa
wa
wa
wa
wa
QC
wa
fW
fW
fW
fW
fW
fW
fW
fW
fW
"}
(30,1,1) = {"
fW
fW
fW
fW
fW
fW
fW
fW
fW
fW
fW
fW
fW
fW
fW
fW
fW
fW
fW
fW
fW
fW
fW
fW
fW
fW
fW
fW
fW
fW
"}
(31,1,1) = {"
fW
fW
fW
fW
fW
fW
fW
fW
fW
fW
fW
fW
fW
fW
fW
fW
fW
fW
fW
fW
fW
fW
fW
fW
fW
fW
fW
fW
fW
fW
"}
(32,1,1) = {"
fW
fW
fW
fW
fW
fW
fW
fW
fW
fW
fW
fW
fW
fW
fW
fW
fW
fW
fW
fW
fW
fW
fW
fW
fW
fW
fW
fW
fW
fW
"}
