//MAP CONVERTED BY dmm2tgm.py THIS HEADER COMMENT PREVENTS RECONVERSION, DO NOT REMOVE
"a" = (
/turf/open/floor/wood,
/area/space)
"b" = (
/obj/effect/decal/cleanable/dirt,
/obj/machinery/smartfridge/food,
/turf/open/floor/wood,
/area/space)
"c" = (
/obj/structure/flora/tree/pine,
/turf/open/floor/plating/asteroid/snow/icemoon,
/area/icemoon/underground/explored)
"d" = (
/obj/effect/decal/cleanable/dirt,
/turf/open/floor/carpet,
/area/space)
"h" = (
/obj/structure/table/wood,
/obj/machinery/reagentgrinder/kitchen,
/turf/open/floor/wood,
/area/space)
"i" = (
/obj/structure/mineral_door/wood,
/obj/structure/fans/tiny,
/turf/open/floor/plating/snowed/smoothed/icemoon,
/area/space)
"j" = (
/obj/structure/closet/crate/wooden,
/obj/item/reagent_containers/glass/woodmug,
/obj/item/reagent_containers/glass/woodmug,
/obj/item/reagent_containers/glass/woodmug,
/turf/open/floor/wood,
/area/space)
"k" = (
/obj/machinery/chem_dispenser/mutagensaltpeter,
/turf/open/floor/plating/snowed/smoothed/icemoon,
/area/space)
"l" = (
/obj/structure/fireplace{
	fuel_added = 1000;
	lit = 1
	},
/obj/effect/decal/cleanable/dirt,
/turf/open/floor/carpet,
/area/space)
"m" = (
/obj/effect/decal/cleanable/dirt,
/turf/open/floor/plasteel/cafeteria,
/area/space)
"n" = (
/turf/open/floor/carpet,
/area/space)
"o" = (
/obj/structure/table/wood,
/obj/item/kitchen/rollingpin,
/turf/open/floor/plasteel/cafeteria,
/area/space)
"p" = (
/obj/structure/flora/tree/dead,
/turf/open/floor/plating/asteroid/snow/icemoon,
/area/icemoon/underground/explored)
"q" = (
/obj/machinery/griddle,
/obj/effect/decal/cleanable/dirt,
/turf/open/floor/plasteel/cafeteria,
/area/space)
"r" = (
/obj/structure/table/wood,
/obj/item/kitchen/knife/combat/bone,
/turf/open/floor/plasteel/cafeteria,
/area/space)
"s" = (
/obj/effect/decal/cleanable/dirt,
/turf/open/floor/wood,
/area/space)
"t" = (
/obj/item/bedsheet,
/obj/structure/bed,
/turf/open/floor/wood,
/area/space)
"u" = (
/obj/machinery/hydroponics/soil,
/turf/open/floor/plating/asteroid/snow/icemoon,
/area/icemoon/underground/explored)
"x" = (
/obj/structure/mineral_door/wood,
/turf/open/floor/plating/snowed/smoothed/icemoon,
/area/space)
"A" = (
/turf/open/floor/plating/snowed/smoothed/icemoon,
/area/space)
"B" = (
/obj/machinery/hydroponics/soil,
/obj/item/storage/bag/plants/portaseeder,
/turf/open/floor/plating/asteroid/snow/icemoon,
/area/icemoon/underground/explored)
"C" = (
/turf/open/floor/plasteel/cafeteria,
/area/space)
"D" = (
/obj/structure/table/wood,
/turf/open/floor/plasteel/cafeteria,
/area/space)
"E" = (
/obj/machinery/vending/hydronutrients{
	onstation = 0
	},
/turf/open/floor/plating/snowed/smoothed/icemoon,
/area/space)
"F" = (
/obj/machinery/biogenerator,
/turf/open/floor/plating/snowed/smoothed/icemoon,
/area/space)
"H" = (
/obj/effect/decal/cleanable/dirt,
/obj/machinery/processor,
/turf/open/floor/wood,
/area/space)
"I" = (
/turf/open/floor/plating/snowed/smoothed/icemoon,
/area/icemoon/underground/explored)
"K" = (
/turf/closed/wall/mineral/wood,
/area/space)
"L" = (
/turf/template_noop,
/area/template_noop)
"O" = (
/obj/structure/curtain,
/turf/open/floor/wood,
/area/space)
"Q" = (
/turf/open/floor/wood{
	icon_state = "wood-broken6"
	},
/area/space)
"R" = (
/obj/structure/rack,
/turf/open/floor/plating/snowed/smoothed/icemoon,
/area/space)
"S" = (
/obj/machinery/vending/hydroseeds{
	onstation = 0
	},
/turf/open/floor/plating/snowed/smoothed/icemoon,
/area/space)
"T" = (
/turf/open/floor/plating/asteroid/snow/icemoon,
/area/icemoon/underground/explored)
"U" = (
/obj/machinery/oven,
/obj/effect/decal/cleanable/dirt,
/turf/open/floor/plasteel/cafeteria,
/area/space)
"W" = (
/turf/open/floor/wood{
	icon_state = "wood-broken"
	},
/area/space)
"X" = (
/obj/structure/fans/tiny,
/obj/machinery/door/airlock/wood,
/turf/open/floor/wood,
/area/space)
"Z" = (
/obj/structure/sink/kitchen{
	pixel_y = 30
	},
/obj/structure/table/wood,
/obj/effect/decal/cleanable/dirt,
/turf/open/floor/plasteel/cafeteria,
/area/space)

(1,1,1) = {"
L
L
L
L
L
L
L
L
L
L
L
L
L
L
L
L
L
L
"}
(2,1,1) = {"
L
L
T
T
T
T
T
T
c
T
T
T
T
T
T
T
L
L
"}
(3,1,1) = {"
L
T
T
T
T
T
T
T
T
T
T
T
T
T
T
c
T
L
"}
(4,1,1) = {"
L
T
c
u
u
K
x
K
K
K
K
K
K
T
T
T
T
L
"}
(5,1,1) = {"
L
T
T
T
T
K
A
A
K
a
a
a
K
T
T
T
T
L
"}
(6,1,1) = {"
L
T
u
T
u
K
R
R
K
Q
s
t
K
T
T
T
T
L
"}
(7,1,1) = {"
L
T
u
T
B
K
K
K
K
K
O
K
K
T
T
T
T
L
"}
(8,1,1) = {"
L
T
u
T
u
K
n
d
s
a
W
a
K
T
T
T
T
L
"}
(9,1,1) = {"
L
T
K
K
K
K
l
d
a
a
a
a
K
I
I
T
T
L
"}
(10,1,1) = {"
L
T
K
S
E
K
n
d
W
a
s
a
X
I
T
T
T
L
"}
(11,1,1) = {"
L
T
K
A
A
K
j
a
a
a
s
s
K
I
I
I
T
L
"}
(12,1,1) = {"
L
T
i
A
A
K
D
o
r
a
a
K
K
I
I
T
T
L
"}
(13,1,1) = {"
L
T
K
F
k
K
q
C
m
a
H
K
T
I
T
T
T
L
"}
(14,1,1) = {"
L
T
K
K
K
K
U
m
C
a
h
K
T
T
T
T
T
L
"}
(15,1,1) = {"
L
T
T
T
T
K
Z
C
C
s
b
K
T
T
T
p
T
L
"}
(16,1,1) = {"
L
T
T
T
T
K
K
K
K
K
K
K
T
T
c
T
T
L
"}
(17,1,1) = {"
L
T
T
c
T
T
T
T
T
T
T
T
T
T
T
T
T
L
"}
(18,1,1) = {"
L
L
T
T
T
T
T
T
T
p
T
T
T
T
T
T
L
L
"}
(19,1,1) = {"
L
L
L
L
L
L
L
L
L
L
L
L
L
L
L
L
L
L
"}
