//MAP CONVERTED BY dmm2tgm.py THIS HEADER COMMENT PREVENTS RECONVERSION, DO NOT REMOVE
"at" = (
/obj/structure/table/wood,
/obj/item/storage/belt/quiver/weaver/ashwalker{
	pixel_y = 2
	},
/obj/item/storage/belt/quiver/weaver/ashwalker{
	pixel_y = -2
	},
/obj/item/gun/ballistic/bow/ashen{
	pixel_x = 1;
	pixel_y = 1
	},
/obj/item/gun/ballistic/bow/ashen{
	pixel_x = -1;
	pixel_y = -1
	},
/turf/open/floor/wood,
/area/ruin/powered/walker_village)
"aR" = (
/obj/structure/table/optable,
/turf/open/floor/wood,
/area/ruin/powered/walker_village)
"bW" = (
/obj/structure/fence/corner{
	dir = 4
	},
/turf/open/floor/plating/asteroid/snow/icemoon,
/area/ruin/powered/walker_village)
"ce" = (
/obj/effect/mob_spawn/human/corpse/damaged,
/turf/open/floor/wood,
/area/ruin/powered/walker_village)
"dd" = (
/obj/machinery/light/small{
	dir = 1
	},
/turf/open/floor/wood,
/area/ruin/powered/walker_village)
"dI" = (
/turf/template_noop,
/area/template_noop)
"eR" = (
/obj/item/pickaxe/bonepickaxe,
/turf/open/floor/plating/asteroid/snow/icemoon,
/area/ruin/powered/walker_village)
"fk" = (
/obj/effect/decal/cleanable/dirt,
/obj/machinery/light/small{
	dir = 1
	},
/turf/open/floor/wood,
/area/ruin/powered/walker_village)
"fI" = (
/obj/structure/flora/stump,
/turf/open/floor/plating/asteroid/snow/icemoon,
/area/icemoon/underground/explored)
"gU" = (
/obj/item/organ/liver,
/turf/open/floor/wood,
/area/ruin/powered/walker_village)
"iu" = (
/obj/item/organ/lungs,
/turf/open/floor/carpet/purple,
/area/ruin/powered/walker_village)
"jQ" = (
/obj/structure/flora/bush,
/turf/open/floor/plating/asteroid/snow/icemoon,
/area/ruin/powered/walker_village)
"kv" = (
/turf/open/floor/wood,
/area/ruin/powered/walker_village)
"le" = (
/obj/machinery/hydroponics/soil,
/turf/open/floor/plating/asteroid/snow/icemoon,
/area/ruin/powered/walker_village)
"lh" = (
/turf/open/floor/plating/snowed/smoothed/icemoon,
/area/ruin/powered/walker_village)
"mw" = (
/turf/open/floor/plating/asteroid/snow/icemoon,
/area/icemoon/underground/explored)
"mx" = (
/obj/structure/fence,
/turf/open/floor/plating/asteroid/snow/icemoon,
/area/ruin/powered/walker_village)
"nn" = (
/obj/effect/decal/cleanable/dirt,
/obj/item/clothing/head/helmet/skull,
/obj/structure/table/wood,
/turf/open/floor/wood,
/area/ruin/powered/walker_village)
"pD" = (
/obj/machinery/hydroponics/soil,
/obj/item/cultivator/rake,
/turf/open/floor/plating/asteroid/snow/icemoon,
/area/ruin/powered/walker_village)
"pS" = (
/obj/structure/table/wood,
/obj/item/melee/spear/bonespear,
/obj/item/melee/spear/bonespear{
	pixel_x = 3;
	pixel_y = -3
	},
/obj/item/melee/spear/bonespear{
	pixel_x = -3;
	pixel_y = 3
	},
/turf/open/floor/wood,
/area/ruin/powered/walker_village)
"pV" = (
/obj/structure/flora/ausbushes/fullgrass,
/turf/open/floor/plating/asteroid/snow/icemoon,
/area/icemoon/underground/explored)
"qm" = (
/turf/open/floor/plating/asteroid/snow/ice/icemoon,
/area/ruin/powered/walker_village)
"rp" = (
/obj/effect/mob_spawn/human/icemoon_walker/chieftain,
/turf/open/floor/plating/asteroid/snow/icemoon,
/area/ruin/powered/walker_village)
"rY" = (
/obj/effect/decal/cleanable/blood,
/turf/open/floor/wood,
/area/ruin/powered/walker_village)
"sO" = (
/turf/open/floor/plating/snowed/smoothed/icemoon,
/area/icemoon/underground/explored)
"tl" = (
/obj/effect/decal/cleanable/blood/gibs/old,
/obj/machinery/light/small{
	dir = 1
	},
/turf/open/floor/wood,
/area/ruin/powered/walker_village)
"tD" = (
/obj/machinery/light/small{
	dir = 1
	},
/turf/open/floor/plating/asteroid/snow/icemoon,
/area/ruin/powered/walker_village)
"un" = (
/obj/item/fishingrod,
/obj/structure/rack,
/obj/item/fishingrod,
/obj/item/fishingrod,
/obj/item/reagent_containers/food/snacks/bait/master,
/obj/item/reagent_containers/food/snacks/bait/master,
/obj/item/reagent_containers/food/snacks/bait/master,
/turf/open/floor/plating/asteroid/snow/icemoon,
/area/ruin/powered/walker_village)
"uO" = (
/obj/structure/flora/tree/pine,
/turf/open/floor/plating/asteroid/snow/icemoon,
/area/icemoon/underground/explored)
"vc" = (
/obj/effect/decal/cleanable/blood/old,
/turf/open/floor/wood,
/area/ruin/powered/walker_village)
"vU" = (
/obj/item/storage/toolbox/syndicate,
/obj/structure/table/wood,
/turf/open/floor/wood,
/area/ruin/powered/walker_village)
"wl" = (
/obj/structure/fence/door{
	dir = 4
	},
/turf/open/floor/plating/snowed/smoothed/icemoon,
/area/ruin/powered/walker_village)
"wF" = (
/obj/machinery/hydroponics/soil,
/obj/item/seeds/bamboo,
/turf/open/floor/plating/asteroid/snow/icemoon,
/area/ruin/powered/walker_village)
"wI" = (
/obj/structure/railing/corner{
	dir = 1
	},
/turf/closed/wall/mineral/wood,
/area/ruin/powered/walker_village)
"xs" = (
/turf/open/floor/plasteel/stairs/goon/wood_stairs_middle{
	dir = 1
	},
/area/ruin/powered/walker_village)
"xz" = (
/obj/structure/fence{
	dir = 8
	},
/turf/open/floor/plating/asteroid/snow/icemoon,
/area/ruin/powered/walker_village)
"xA" = (
/obj/structure/chair/bronze{
	desc = "An ornate throne made of bronze.";
	name = "chieftain's throne"
	},
/turf/open/floor/carpet/purple,
/area/ruin/powered/walker_village)
"xX" = (
/obj/effect/decal/cleanable/blood/gibs,
/obj/item/fireaxe/boneaxe,
/obj/structure/table/wood,
/turf/open/floor/wood,
/area/ruin/powered/walker_village)
"xY" = (
/obj/structure/bonfire/dense,
/turf/open/floor/plating/asteroid/snow/icemoon,
/area/ruin/powered/walker_village)
"yi" = (
/turf/closed/wall/mineral/wood,
/area/ruin/powered/walker_village)
"AI" = (
/obj/machinery/hydroponics/soil,
/obj/item/seeds/cotton,
/turf/open/floor/plating/asteroid/snow/icemoon,
/area/ruin/powered/walker_village)
"Bj" = (
/obj/structure/railing{
	dir = 4
	},
/turf/open/floor/plating/ice/icemoon,
/area/ruin/powered/walker_village)
"Bm" = (
/obj/effect/decal/cleanable/blood/gibs,
/turf/open/floor/wood,
/area/ruin/powered/walker_village)
"Bq" = (
/obj/machinery/hydroponics/soil,
/obj/item/shovel/spade/bone,
/turf/open/floor/plating/asteroid/snow/icemoon,
/area/ruin/powered/walker_village)
"Cp" = (
/obj/effect/mob_spawn/human/icemoon_walker,
/turf/open/floor/plating/asteroid/snow/icemoon,
/area/ruin/powered/walker_village)
"Dz" = (
/turf/open/floor/plating/ice/icemoon,
/area/ruin/powered/walker_village)
"Gz" = (
/turf/open/water/safe,
/area/ruin/powered/walker_village)
"Io" = (
/obj/structure/railing/corner,
/turf/closed/wall/mineral/wood,
/area/ruin/powered/walker_village)
"IE" = (
/turf/open/floor/carpet/purple,
/area/ruin/powered/walker_village)
"Jc" = (
/turf/template_noop,
/area)
"LT" = (
/obj/effect/decal/cleanable/blood/gibs/torso,
/turf/open/floor/carpet/purple,
/area/ruin/powered/walker_village)
"Mi" = (
/obj/structure/flora/ausbushes/sparsegrass,
/turf/open/floor/plating/asteroid/snow/icemoon,
/area/icemoon/underground/explored)
"Mm" = (
/obj/effect/decal/cleanable/dirt,
/turf/open/floor/wood,
/area/ruin/powered/walker_village)
"MF" = (
/obj/machinery/hydroponics/soil,
/obj/item/storage/bag/plants/portaseeder,
/turf/open/floor/plating/asteroid/snow/icemoon,
/area/ruin/powered/walker_village)
"Nb" = (
/obj/structure/ore_box,
/turf/open/floor/plating/asteroid/snow/icemoon,
/area/ruin/powered/walker_village)
"Ng" = (
/turf/open/floor/plating/asteroid/snow/icemoon,
/area/ruin/powered/walker_village)
"OA" = (
/obj/structure/railing,
/turf/closed/wall/mineral/wood,
/area/ruin/powered/walker_village)
"Py" = (
/turf/closed/mineral/snowmountain/cavern/icemoon,
/area/ruin/powered/walker_village)
"PI" = (
/obj/structure/mineral_door/iron,
/turf/open/floor/plating/snowed/smoothed/icemoon,
/area/ruin/powered/walker_village)
"Qe" = (
/obj/structure/reagent_dispensers/watertank,
/turf/open/floor/plating/asteroid/snow/icemoon,
/area/ruin/powered/walker_village)
"Qz" = (
/obj/effect/decal/cleanable/dirt,
/obj/item/storage/firstaid/regular,
/obj/structure/table/wood,
/turf/open/floor/wood,
/area/ruin/powered/walker_village)
"Rd" = (
/obj/machinery/hydroponics/soil,
/obj/item/reagent_containers/glass/bucket/wooden,
/turf/open/floor/plating/asteroid/snow/icemoon,
/area/ruin/powered/walker_village)
"Tu" = (
/obj/structure/flora/ausbushes/fullgrass,
/turf/open/floor/plating/asteroid/snow/icemoon,
/area/ruin/powered/walker_village)
"TY" = (
/obj/item/scalpel/bone,
/obj/item/retractor/bone,
/obj/item/hemostat/bone,
/obj/item/cautery/bone,
/obj/item/bonesetter/bone,
/obj/item/circular_saw/bone,
/obj/structure/table/wood,
/turf/open/floor/wood,
/area/ruin/powered/walker_village)
"Ul" = (
/obj/structure/table/wood,
/obj/item/kitchen/knife/combat/bone{
	pixel_x = -3;
	pixel_y = 3
	},
/obj/item/kitchen/knife/combat/bone,
/obj/item/kitchen/knife/combat/bone{
	pixel_x = 3;
	pixel_y = -3
	},
/obj/machinery/light/small{
	dir = 1
	},
/turf/open/floor/wood,
/area/ruin/powered/walker_village)
"UN" = (
/obj/machinery/light/small{
	dir = 8
	},
/turf/open/floor/wood,
/area/ruin/powered/walker_village)
"Vo" = (
/obj/item/flashlight/lantern,
/obj/item/flashlight/lantern,
/obj/item/flashlight/lantern,
/obj/structure/table/wood,
/turf/open/floor/wood,
/area/ruin/powered/walker_village)
"Vp" = (
/obj/structure/mineral_door/wood,
/turf/open/floor/wood,
/area/ruin/powered/walker_village)
"VK" = (
/turf/open/floor/plasteel/stairs/goon/wood_stairs_wide2{
	dir = 1
	},
/area/ruin/powered/walker_village)
"VV" = (
/obj/structure/flora/ausbushes/stalkybush,
/turf/open/floor/plating/asteroid/snow/icemoon,
/area/ruin/powered/walker_village)
"XD" = (
/obj/structure/fence/corner,
/turf/open/floor/plating/asteroid/snow/icemoon,
/area/ruin/powered/walker_village)
"XK" = (
/obj/effect/decal/cleanable/blood/gibs/up,
/obj/machinery/light/small{
	dir = 4
	},
/turf/open/floor/wood,
/area/ruin/powered/walker_village)
"YN" = (
/obj/structure/flora/tree/pine,
/turf/open/floor/plating/asteroid/snow/icemoon,
/area/ruin/powered/walker_village)
"YO" = (
/obj/structure/flora/ausbushes/fernybush,
/turf/open/floor/plating/asteroid/snow/icemoon,
/area/ruin/powered/walker_village)
"ZL" = (
/obj/structure/window/reinforced/fulltile/ice,
/obj/structure/barricade/wooden/crude/snow,
/turf/open/floor/plating,
/area/ruin/powered/walker_village)
"ZM" = (
/turf/open/floor/plasteel/stairs/goon/wood_stairs_wide{
	dir = 1
	},
/area/ruin/powered/walker_village)

(1,1,1) = {"
Jc
dI
Jc
Jc
Jc
Jc
Jc
Jc
Jc
Jc
Jc
Jc
Jc
Jc
Jc
Jc
Jc
Jc
Jc
Jc
Jc
Jc
Jc
Jc
Jc
Jc
"}
(2,1,1) = {"
Jc
mw
mw
mw
mw
mw
mw
mw
mw
mw
mw
mw
mw
mw
pV
mw
mw
mw
Mi
mw
mw
mw
mw
mw
mw
Jc
"}
(3,1,1) = {"
Jc
mw
mw
mw
uO
mw
Py
Py
Py
Py
Py
mw
sO
sO
mw
sO
sO
mw
mw
mw
mw
mw
uO
mw
mw
Jc
"}
(4,1,1) = {"
Jc
mw
mw
mw
Py
Py
Py
Py
Py
Py
Py
Py
sO
sO
sO
sO
Py
Py
Py
Py
Py
mw
mw
mw
mw
Jc
"}
(5,1,1) = {"
Jc
mw
mw
Py
Py
Py
Py
Cp
Ng
Ng
Py
Py
Py
sO
sO
Py
Py
Py
Py
Py
Py
Py
Py
fI
mw
Jc
"}
(6,1,1) = {"
Jc
mw
Py
Py
Py
Ng
xz
rp
lh
Cp
xz
Py
Py
PI
PI
Py
Py
Nb
YO
Ng
Py
Py
Py
Py
mw
Jc
"}
(7,1,1) = {"
Jc
mw
Py
Py
Ng
Ng
xz
Cp
lh
Cp
xz
Ng
VV
lh
lh
eR
Ng
Ng
Ng
Ng
Ng
Ng
Py
Py
mw
Jc
"}
(8,1,1) = {"
Jc
mw
Py
Py
Ng
Ng
bW
mx
wl
mx
XD
Ng
Ng
YN
lh
Ng
jQ
yi
yi
yi
yi
yi
Py
Py
mw
Jc
"}
(9,1,1) = {"
Jc
fI
Py
Py
eR
Ng
Ng
Tu
lh
lh
lh
lh
lh
lh
lh
Ng
Ng
yi
ce
vc
kv
yi
Py
Py
mw
Jc
"}
(10,1,1) = {"
Jc
mw
Py
Py
Ng
yi
yi
ZL
ZL
yi
yi
yi
yi
yi
lh
lh
lh
Vp
kv
Mm
TY
yi
Py
Py
mw
Jc
"}
(11,1,1) = {"
Jc
mw
Py
Py
Ng
Io
UN
kv
kv
xX
yi
dd
Mm
yi
Ng
lh
Ng
yi
tl
Mm
aR
yi
Py
Py
mw
Jc
"}
(12,1,1) = {"
Jc
pV
Py
Py
Ng
OA
IE
IE
iu
rY
ZM
Mm
Mm
yi
tD
lh
xY
yi
yi
yi
yi
yi
Py
Py
mw
Jc
"}
(13,1,1) = {"
Jc
mw
Py
Py
Ng
OA
xA
IE
IE
kv
xs
Bm
kv
Vp
lh
lh
Tu
Ng
Ng
Ng
Ng
Ng
Py
Py
mw
Jc
"}
(14,1,1) = {"
Jc
mw
Py
Py
Ng
OA
IE
IE
LT
gU
VK
rY
kv
yi
tD
lh
lh
lh
lh
Ng
YN
Ng
Py
Py
mw
Jc
"}
(15,1,1) = {"
Jc
mw
Py
Py
Tu
wI
XK
kv
kv
nn
yi
fk
kv
yi
Ng
lh
yi
yi
Vp
yi
yi
Ng
Py
Py
mw
Jc
"}
(16,1,1) = {"
Jc
mw
Py
Py
Ng
yi
yi
ZL
ZL
yi
yi
yi
yi
yi
un
lh
yi
at
kv
Vo
yi
Ng
Py
Py
mw
Jc
"}
(17,1,1) = {"
Jc
mw
Py
Py
Ng
YN
Ng
Ng
lh
lh
lh
lh
lh
lh
lh
lh
yi
pS
kv
vU
yi
Ng
Py
Py
mw
Jc
"}
(18,1,1) = {"
Jc
mw
Py
Py
Ng
Ng
Ng
lh
lh
lh
qm
qm
qm
qm
lh
Ng
yi
Ul
Mm
Qz
yi
Ng
Py
Py
mw
Jc
"}
(19,1,1) = {"
Jc
mw
Py
Py
Ng
Ng
MF
lh
pD
qm
Dz
Gz
Bj
qm
lh
Ng
yi
Mm
Mm
Mm
yi
Ng
Py
Py
mw
Jc
"}
(20,1,1) = {"
Jc
mw
Py
Py
Ng
Ng
Bq
lh
Rd
qm
Dz
Gz
Gz
Dz
qm
Ng
yi
yi
yi
yi
yi
Ng
Py
Py
mw
Jc
"}
(21,1,1) = {"
Jc
mw
Py
Py
Py
Qe
wF
lh
le
qm
Gz
Gz
Dz
Dz
qm
Tu
Ng
Ng
Ng
Ng
Ng
Py
Py
Py
mw
Jc
"}
(22,1,1) = {"
Jc
mw
fI
Py
Py
Py
AI
lh
le
qm
Gz
Gz
Dz
Dz
qm
Ng
Ng
eR
Ng
Py
Py
Py
Py
Py
mw
Jc
"}
(23,1,1) = {"
Jc
mw
mw
Py
Py
Py
Py
Py
Py
Py
Py
Py
Py
Py
Py
Py
Py
Py
Py
Py
Py
Py
Py
mw
mw
Jc
"}
(24,1,1) = {"
Jc
mw
uO
mw
Py
Py
Py
Py
Py
Py
Py
Py
Py
Py
Py
Py
Py
Py
Py
Py
mw
mw
mw
pV
mw
Jc
"}
(25,1,1) = {"
Jc
mw
mw
mw
mw
mw
mw
mw
mw
mw
Mi
mw
mw
mw
mw
mw
mw
mw
mw
mw
mw
uO
mw
mw
mw
Jc
"}
(26,1,1) = {"
Jc
Jc
Jc
Jc
Jc
Jc
Jc
Jc
Jc
Jc
Jc
Jc
Jc
Jc
Jc
Jc
Jc
Jc
Jc
Jc
Jc
Jc
Jc
Jc
Jc
Jc
"}
