//MAP CONVERTED BY dmm2tgm.py THIS HEADER COMMENT PREVENTS RECONVERSION, DO NOT REMOVE
"ap" = (
/obj/item/fishingrod,
/obj/structure/rack,
/obj/item/fishingrod,
/obj/item/fishingrod,
/obj/item/reagent_containers/food/snacks/bait/master,
/obj/item/reagent_containers/food/snacks/bait/master,
/obj/item/reagent_containers/food/snacks/bait/master,
/turf/open/floor/plating/asteroid/snow/icemoon,
/area/ruin/powered/walker_village)
"aA" = (
/obj/effect/decal/cleanable/blood/gibs/old,
/obj/machinery/light/small{
	dir = 1
	},
/turf/open/floor/wood,
/area/ruin/powered/walker_village)
"bw" = (
/obj/structure/railing,
/turf/closed/wall/mineral/wood,
/area/ruin/powered/walker_village)
"dr" = (
/obj/structure/flora/grass/both,
/turf/open/floor/plating/asteroid/snow/icemoon,
/area/icemoon/underground/explored)
"dv" = (
/obj/structure/fence,
/turf/open/floor/plating/asteroid/snow/icemoon,
/area/ruin/powered/walker_village)
"dW" = (
/obj/structure/flora/rock/icy,
/turf/open/floor/plating/asteroid/snow/icemoon,
/area/icemoon/underground/explored)
"en" = (
/obj/effect/decal/cleanable/dirt,
/obj/item/clothing/head/helmet/skull,
/obj/structure/table/wood,
/turf/open/floor/wood,
/area/ruin/powered/walker_village)
"fl" = (
/obj/machinery/light/small{
	dir = 1
	},
/turf/open/floor/wood,
/area/ruin/powered/walker_village)
"fC" = (
/obj/effect/mob_spawn/human/corpse/damaged,
/turf/open/floor/wood,
/area/ruin/powered/walker_village)
"fI" = (
/obj/structure/flora/stump,
/turf/open/floor/plating/asteroid/snow/icemoon,
/area/icemoon/underground/explored)
"fQ" = (
/turf/open/floor/plasteel/stairs/goon/wood_stairs_wide2{
	dir = 1
	},
/area/ruin/powered/walker_village)
"fV" = (
/obj/structure/fence/door{
	dir = 4
	},
/turf/open/floor/plating/snowed/smoothed/icemoon,
/area/ruin/powered/walker_village)
"ge" = (
/obj/structure/flora/bush,
/turf/open/floor/plating/asteroid/snow/icemoon,
/area/ruin/powered/walker_village)
"gf" = (
/obj/effect/decal/cleanable/dirt,
/obj/item/storage/firstaid/regular,
/obj/structure/table/wood,
/turf/open/floor/wood,
/area/ruin/powered/walker_village)
"hl" = (
/obj/effect/decal/cleanable/blood/gibs,
/turf/open/floor/wood,
/area/ruin/powered/walker_village)
"hy" = (
/obj/item/pickaxe/bonepickaxe,
/turf/open/floor/plating/asteroid/snow/icemoon,
/area/ruin/powered/walker_village)
"iD" = (
/obj/machinery/light/small{
	dir = 8
	},
/turf/open/floor/wood,
/area/ruin/powered/walker_village)
"iL" = (
/turf/closed/mineral/snowmountain/cavern/icemoon,
/area/ruin/powered/walker_village)
"iP" = (
/obj/effect/decal/cleanable/blood/gibs,
/obj/item/fireaxe/boneaxe,
/obj/structure/table/wood,
/turf/open/floor/wood,
/area/ruin/powered/walker_village)
"iX" = (
/obj/structure/flora/tree/pine,
/turf/open/floor/plating/asteroid/snow/icemoon,
/area/ruin/powered/walker_village)
"jn" = (
/obj/structure/window/reinforced/fulltile/ice,
/obj/structure/barricade/wooden/crude/snow,
/turf/open/floor/plating,
/area/ruin/powered/walker_village)
"kt" = (
/turf/closed/mineral/random/snow,
/area/icemoon/underground/explored)
"lB" = (
/obj/machinery/hydroponics/soil,
/obj/item/seeds/bamboo,
/turf/open/floor/plating/asteroid/snow/icemoon,
/area/ruin/powered/walker_village)
"lN" = (
/obj/item/organ/liver,
/turf/open/floor/wood,
/area/ruin/powered/walker_village)
"lP" = (
/obj/machinery/hydroponics/soil,
/obj/item/reagent_containers/glass/bucket/wooden,
/turf/open/floor/plating/asteroid/snow/icemoon,
/area/ruin/powered/walker_village)
"mw" = (
/turf/open/floor/plating/asteroid/snow/icemoon,
/area/icemoon/underground/explored)
"mJ" = (
/obj/structure/table/wood,
/obj/item/storage/belt/quiver/weaver/ashwalker{
	pixel_y = 2
	},
/obj/item/storage/belt/quiver/weaver/ashwalker{
	pixel_y = -2
	},
/obj/item/gun/ballistic/bow/ashen{
	pixel_x = 1;
	pixel_y = 1
	},
/obj/item/gun/ballistic/bow/ashen{
	pixel_x = -1;
	pixel_y = -1
	},
/turf/open/floor/wood,
/area/ruin/powered/walker_village)
"mW" = (
/obj/structure/reagent_dispensers/watertank,
/turf/open/floor/plating/asteroid/snow/icemoon,
/area/ruin/powered/walker_village)
"on" = (
/turf/open/floor/wood,
/area/ruin/powered/walker_village)
"oI" = (
/obj/machinery/hydroponics/soil,
/obj/item/seeds/cotton,
/turf/open/floor/plating/asteroid/snow/icemoon,
/area/ruin/powered/walker_village)
"oV" = (
/obj/effect/decal/cleanable/blood/gibs/up,
/obj/machinery/light/small{
	dir = 4
	},
/turf/open/floor/wood,
/area/ruin/powered/walker_village)
"pe" = (
/obj/machinery/hydroponics/soil,
/obj/item/shovel/spade/bone,
/turf/open/floor/plating/asteroid/snow/icemoon,
/area/ruin/powered/walker_village)
"ph" = (
/obj/machinery/hydroponics/soil,
/obj/item/storage/bag/plants/portaseeder,
/turf/open/floor/plating/asteroid/snow/icemoon,
/area/ruin/powered/walker_village)
"pJ" = (
/obj/structure/bonfire/dense,
/turf/open/floor/plating/asteroid/snow/icemoon,
/area/ruin/powered/walker_village)
"pK" = (
/turf/open/floor/carpet/purple,
/area/ruin/powered/walker_village)
"pV" = (
/obj/structure/flora/ausbushes/fullgrass,
/turf/open/floor/plating/asteroid/snow/icemoon,
/area/icemoon/underground/explored)
"pZ" = (
/obj/structure/sign/warning/biohazard{
	pixel_x = 30
	},
/turf/open/floor/plating/snowed/smoothed/icemoon,
/area/icemoon/underground/explored)
"qB" = (
/obj/structure/fluff/fokoff_sign,
/turf/open/floor/plating/asteroid/snow/icemoon,
/area/icemoon/underground/explored)
"qN" = (
/obj/item/scalpel/bone,
/obj/item/retractor/bone,
/obj/item/hemostat/bone,
/obj/item/cautery/bone,
/obj/item/bonesetter/bone,
/obj/item/circular_saw/bone,
/obj/structure/table/wood,
/turf/open/floor/wood,
/area/ruin/powered/walker_village)
"qW" = (
/obj/structure/flora/ausbushes/fullgrass,
/turf/open/floor/plating/asteroid/snow/icemoon,
/area/ruin/powered/walker_village)
"rp" = (
/turf/open/floor/plating/asteroid/snow/icemoon,
/area/ruin/powered/walker_village)
"sq" = (
/turf/open/floor/plating/asteroid/snow/ice/icemoon,
/area/ruin/powered/walker_village)
"sO" = (
/turf/open/floor/plating/snowed/smoothed/icemoon,
/area/icemoon/underground/explored)
"ux" = (
/turf/open/floor/plasteel/stairs/goon/wood_stairs_wide{
	dir = 1
	},
/area/ruin/powered/walker_village)
"uC" = (
/obj/structure/table/wood,
/obj/item/melee/spear/bonespear,
/obj/item/melee/spear/bonespear{
	pixel_x = 3;
	pixel_y = -3
	},
/obj/item/melee/spear/bonespear{
	pixel_x = -3;
	pixel_y = 3
	},
/turf/open/floor/wood,
/area/ruin/powered/walker_village)
"uO" = (
/obj/structure/flora/tree/pine,
/turf/open/floor/plating/asteroid/snow/icemoon,
/area/icemoon/underground/explored)
"vf" = (
/obj/machinery/hydroponics/soil,
/turf/open/floor/plating/asteroid/snow/icemoon,
/area/ruin/powered/walker_village)
"vB" = (
/obj/structure/flora/ausbushes/stalkybush,
/turf/open/floor/plating/asteroid/snow/icemoon,
/area/ruin/powered/walker_village)
"wo" = (
/obj/structure/flora/rock/pile/icy,
/turf/open/floor/plating/asteroid/snow/icemoon,
/area/icemoon/underground/explored)
"wZ" = (
/obj/machinery/hydroponics/soil,
/obj/item/cultivator/rake,
/turf/open/floor/plating/asteroid/snow/icemoon,
/area/ruin/powered/walker_village)
"xI" = (
/obj/structure/table/optable,
/turf/open/floor/wood,
/area/ruin/powered/walker_village)
"xJ" = (
/obj/item/storage/toolbox/syndicate,
/obj/structure/table/wood,
/turf/open/floor/wood,
/area/ruin/powered/walker_village)
"zN" = (
/turf/closed/wall/rust,
/area/ruin/powered/walker_village)
"Ai" = (
/obj/effect/decal/cleanable/blood/gibs/torso,
/turf/open/floor/carpet/purple,
/area/ruin/powered/walker_village)
"AC" = (
/obj/structure/chair/bronze{
	desc = "An ornate throne made of bronze.";
	name = "chieftain's throne"
	},
/turf/open/floor/carpet/purple,
/area/ruin/powered/walker_village)
"AZ" = (
/obj/item/flashlight/lantern,
/obj/item/flashlight/lantern,
/obj/item/flashlight/lantern,
/obj/structure/table/wood,
/turf/open/floor/wood,
/area/ruin/powered/walker_village)
"Bi" = (
/obj/structure/mineral_door/iron,
/turf/open/floor/plating/snowed/smoothed/icemoon,
/area/ruin/powered/walker_village)
"Bj" = (
/turf/closed/wall/mineral/wood,
/area/ruin/powered/walker_village)
"CX" = (
/turf/open/water/safe,
/area/ruin/powered/walker_village)
"DO" = (
/turf/open/floor/plating/ice/icemoon,
/area/ruin/powered/walker_village)
"Ek" = (
/obj/structure/fence{
	dir = 8
	},
/turf/open/floor/plating/asteroid/snow/icemoon,
/area/ruin/powered/walker_village)
"Gs" = (
/obj/item/organ/lungs,
/turf/open/floor/carpet/purple,
/area/ruin/powered/walker_village)
"Ke" = (
/obj/machinery/light/small{
	dir = 1
	},
/turf/open/floor/plating/asteroid/snow/icemoon,
/area/ruin/powered/walker_village)
"Kh" = (
/obj/effect/mob_spawn/human/icemoon_walker/chieftain,
/turf/open/floor/plating/asteroid/snow/icemoon,
/area/ruin/powered/walker_village)
"Mi" = (
/obj/structure/flora/ausbushes/sparsegrass,
/turf/open/floor/plating/asteroid/snow/icemoon,
/area/icemoon/underground/explored)
"Np" = (
/obj/structure/table/wood,
/obj/item/kitchen/knife/combat/bone{
	pixel_x = -3;
	pixel_y = 3
	},
/obj/item/kitchen/knife/combat/bone,
/obj/item/kitchen/knife/combat/bone{
	pixel_x = 3;
	pixel_y = -3
	},
/obj/machinery/light/small{
	dir = 1
	},
/turf/open/floor/wood,
/area/ruin/powered/walker_village)
"Of" = (
/obj/effect/decal/cleanable/dirt,
/turf/open/floor/wood,
/area/ruin/powered/walker_village)
"Ou" = (
/obj/structure/flora/ausbushes/fernybush,
/turf/open/floor/plating/asteroid/snow/icemoon,
/area/ruin/powered/walker_village)
"OV" = (
/obj/effect/decal/cleanable/dirt,
/obj/machinery/light/small{
	dir = 1
	},
/turf/open/floor/wood,
/area/ruin/powered/walker_village)
"Pz" = (
/obj/effect/mob_spawn/human/icemoon_walker,
/turf/open/floor/plating/asteroid/snow/icemoon,
/area/ruin/powered/walker_village)
"Qe" = (
/obj/structure/mineral_door/wood,
/turf/open/floor/wood,
/area/ruin/powered/walker_village)
"Qh" = (
/turf/open/floor/plasteel/stairs/goon/wood_stairs_middle{
	dir = 1
	},
/area/ruin/powered/walker_village)
"QI" = (
/obj/effect/decal/cleanable/blood,
/turf/open/floor/wood,
/area/ruin/powered/walker_village)
"QT" = (
/obj/structure/fence/corner,
/turf/open/floor/plating/asteroid/snow/icemoon,
/area/ruin/powered/walker_village)
"RX" = (
/obj/effect/decal/cleanable/blood/old,
/turf/open/floor/plating/snowed/smoothed/icemoon,
/area/icemoon/underground/explored)
"Ta" = (
/obj/structure/ore_box,
/turf/open/floor/plating/asteroid/snow/icemoon,
/area/ruin/powered/walker_village)
"UI" = (
/turf/open/floor/plating/snowed/smoothed/icemoon,
/area/ruin/powered/walker_village)
"UQ" = (
/obj/structure/railing/corner,
/turf/closed/wall/mineral/wood,
/area/ruin/powered/walker_village)
"Wi" = (
/obj/effect/decal/cleanable/blood/old,
/turf/open/floor/wood,
/area/ruin/powered/walker_village)
"WJ" = (
/obj/structure/railing/corner{
	dir = 1
	},
/turf/closed/wall/mineral/wood,
/area/ruin/powered/walker_village)
"XB" = (
/obj/structure/fence/corner{
	dir = 4
	},
/turf/open/floor/plating/asteroid/snow/icemoon,
/area/ruin/powered/walker_village)
"XD" = (
/obj/effect/decal/cleanable/blood/gibs/old,
/turf/open/floor/plating/snowed/smoothed/icemoon,
/area/icemoon/underground/explored)
"Zb" = (
/obj/effect/mob_spawn/human/corpse/damaged,
/turf/open/floor/plating/asteroid/snow/icemoon,
/area/icemoon/underground/explored)

(1,1,1) = {"
kt
kt
kt
kt
kt
kt
kt
kt
kt
kt
kt
kt
kt
mw
mw
mw
mw
mw
mw
mw
mw
mw
mw
mw
mw
mw
kt
kt
kt
kt
"}
(2,1,1) = {"
kt
kt
kt
kt
mw
mw
mw
mw
mw
mw
wo
mw
wo
mw
mw
mw
mw
mw
mw
mw
mw
mw
mw
mw
mw
mw
mw
mw
kt
kt
"}
(3,1,1) = {"
kt
kt
mw
mw
mw
Mi
mw
mw
mw
mw
mw
mw
mw
mw
Zb
mw
mw
mw
mw
mw
mw
mw
mw
mw
mw
mw
mw
mw
kt
kt
"}
(4,1,1) = {"
kt
mw
mw
mw
mw
mw
uO
mw
mw
mw
mw
mw
mw
mw
mw
mw
pV
mw
mw
mw
Mi
mw
mw
mw
mw
mw
uO
mw
kt
kt
"}
(5,1,1) = {"
kt
mw
mw
mw
mw
mw
mw
mw
iL
zN
iL
iL
iL
qB
sO
sO
mw
XD
pZ
Zb
mw
mw
mw
mw
mw
mw
mw
mw
mw
kt
"}
(6,1,1) = {"
kt
mw
mw
mw
mw
mw
zN
iL
iL
iL
iL
iL
iL
iL
XD
sO
RX
sO
zN
zN
iL
iL
iL
mw
mw
mw
mw
mw
mw
kt
"}
(7,1,1) = {"
kt
mw
mw
mw
mw
zN
zN
iL
iL
Pz
rp
rp
iL
iL
iL
sO
sO
iL
iL
zN
iL
iL
iL
iL
iL
fI
mw
dr
mw
kt
"}
(8,1,1) = {"
kt
mw
mw
mw
iL
iL
zN
rp
Ek
Kh
UI
Pz
Ek
iL
iL
Bi
Bi
iL
iL
Ta
Ou
rp
iL
iL
iL
iL
mw
mw
mw
kt
"}
(9,1,1) = {"
kt
kt
mw
mw
iL
iL
rp
rp
Ek
Pz
UI
Pz
Ek
rp
vB
UI
UI
hy
rp
rp
rp
rp
rp
rp
iL
iL
mw
mw
mw
mw
"}
(10,1,1) = {"
kt
kt
mw
mw
iL
iL
rp
rp
XB
dv
fV
dv
QT
rp
rp
iX
UI
rp
ge
Bj
Bj
Bj
Bj
Bj
iL
iL
mw
mw
mw
mw
"}
(11,1,1) = {"
kt
kt
mw
fI
iL
iL
hy
rp
rp
qW
UI
UI
UI
UI
UI
UI
UI
rp
rp
Bj
fC
Wi
on
Bj
iL
zN
mw
mw
mw
dW
"}
(12,1,1) = {"
kt
kt
mw
mw
iL
iL
rp
Bj
Bj
jn
jn
Bj
Bj
Bj
Bj
Bj
UI
UI
UI
Qe
on
Of
qN
Bj
iL
zN
mw
mw
mw
mw
"}
(13,1,1) = {"
kt
mw
mw
mw
iL
iL
rp
UQ
iD
on
on
iP
Bj
fl
Of
Bj
rp
UI
rp
Bj
aA
Of
xI
Bj
iL
iL
mw
mw
mw
mw
"}
(14,1,1) = {"
kt
wo
mw
pV
iL
iL
rp
bw
pK
pK
Gs
QI
ux
Of
Of
Bj
Ke
UI
pJ
Bj
Bj
Bj
Bj
Bj
iL
iL
mw
Mi
mw
mw
"}
(15,1,1) = {"
kt
mw
mw
mw
iL
iL
rp
bw
AC
pK
pK
on
Qh
hl
on
Qe
UI
UI
qW
rp
rp
rp
rp
rp
iL
iL
mw
mw
mw
mw
"}
(16,1,1) = {"
mw
mw
mw
mw
iL
iL
rp
bw
pK
pK
Ai
lN
fQ
QI
on
Bj
Ke
UI
UI
UI
UI
rp
iX
rp
zN
zN
mw
mw
mw
mw
"}
(17,1,1) = {"
mw
mw
mw
mw
iL
iL
qW
WJ
oV
on
on
en
Bj
OV
on
Bj
rp
UI
Bj
Bj
Qe
Bj
Bj
rp
iL
iL
mw
mw
mw
mw
"}
(18,1,1) = {"
mw
mw
mw
mw
zN
zN
rp
Bj
Bj
jn
jn
Bj
Bj
Bj
Bj
Bj
ap
UI
Bj
mJ
on
AZ
Bj
rp
iL
iL
mw
mw
Mi
mw
"}
(19,1,1) = {"
mw
mw
uO
mw
zN
iL
rp
iX
rp
rp
UI
UI
UI
UI
UI
UI
UI
UI
Bj
uC
on
xJ
Bj
rp
iL
iL
mw
mw
mw
mw
"}
(20,1,1) = {"
mw
mw
mw
mw
zN
iL
rp
rp
rp
UI
UI
UI
sq
sq
sq
sq
UI
rp
Bj
Np
Of
gf
Bj
rp
iL
iL
mw
mw
mw
mw
"}
(21,1,1) = {"
mw
dr
mw
mw
zN
iL
rp
rp
ph
UI
wZ
sq
DO
CX
DO
sq
UI
rp
Bj
Of
Of
Of
Bj
rp
iL
iL
mw
mw
mw
kt
"}
(22,1,1) = {"
mw
mw
mw
mw
iL
iL
rp
rp
pe
UI
lP
sq
DO
CX
CX
DO
sq
rp
Bj
Bj
Bj
Bj
Bj
rp
iL
iL
mw
mw
mw
kt
"}
(23,1,1) = {"
mw
mw
mw
mw
iL
iL
iL
mW
lB
UI
vf
sq
CX
CX
DO
DO
sq
qW
rp
rp
rp
rp
rp
iL
iL
iL
mw
mw
dr
kt
"}
(24,1,1) = {"
mw
Mi
mw
mw
fI
iL
iL
iL
oI
UI
vf
sq
CX
CX
DO
DO
sq
rp
rp
hy
rp
iL
iL
iL
iL
iL
mw
mw
mw
kt
"}
(25,1,1) = {"
mw
mw
mw
mw
mw
iL
iL
iL
iL
iL
iL
iL
iL
iL
iL
iL
iL
iL
zN
iL
iL
iL
iL
iL
iL
mw
mw
mw
mw
kt
"}
(26,1,1) = {"
mw
mw
mw
mw
mw
mw
iL
iL
iL
iL
iL
iL
iL
iL
iL
iL
iL
zN
zN
iL
iL
iL
mw
mw
mw
pV
mw
mw
mw
kt
"}
(27,1,1) = {"
mw
mw
mw
mw
uO
mw
mw
mw
mw
mw
mw
mw
Mi
mw
mw
mw
mw
mw
mw
mw
mw
mw
mw
mw
mw
mw
mw
mw
kt
kt
"}
(28,1,1) = {"
mw
mw
mw
mw
mw
mw
mw
mw
mw
mw
mw
mw
mw
mw
mw
mw
mw
mw
mw
mw
mw
mw
mw
mw
mw
mw
mw
mw
kt
kt
"}
(29,1,1) = {"
kt
kt
dW
mw
mw
mw
mw
mw
mw
wo
kt
kt
kt
kt
kt
kt
kt
mw
mw
mw
uO
mw
mw
mw
mw
mw
mw
mw
kt
kt
"}
(30,1,1) = {"
kt
kt
kt
kt
kt
mw
mw
mw
kt
kt
kt
kt
kt
kt
kt
kt
kt
kt
mw
mw
mw
mw
mw
mw
mw
mw
mw
mw
kt
kt
"}
