//MAP CONVERTED BY dmm2tgm.py THIS HEADER COMMENT PREVENTS RECONVERSION, DO NOT REMOVE
"W" = (
/turf/open/space/basic,
/area/space)

(1,1,1) = {"
W
W
W
W
W
W
W
W
W
W
"}
(2,1,1) = {"
W
W
W
W
W
W
W
W
W
W
"}
(3,1,1) = {"
W
W
W
W
W
W
W
W
W
W
"}
(4,1,1) = {"
W
W
W
W
W
W
W
W
W
W
"}
(5,1,1) = {"
W
W
W
W
W
W
W
W
W
W
"}
(6,1,1) = {"
W
W
W
W
W
W
W
W
W
W
"}
(7,1,1) = {"
W
W
W
W
W
W
W
W
W
W
"}
(8,1,1) = {"
W
W
W
W
W
W
W
W
W
W
"}
(9,1,1) = {"
W
W
W
W
W
W
W
W
W
W
"}
(10,1,1) = {"
W
W
W
W
W
W
W
W
W
W
"}
