//MAP CONVERTED BY dmm2tgm.py THIS HEADER COMMENT PREVENTS RECONVERSION, DO NOT REMOVE
"ag" = (
/obj/structure/railing{
	dir = 4
	},
/turf/open/floor/holofloor/stairs,
/area/template_noop)
"ah" = (
/obj/effect/decal/cleanable/dirt,
/obj/effect/decal/cleanable/dirt/dust,
/turf/open/floor/plating,
/area/template_noop)
"ak" = (
/obj/effect/decal/cleanable/dirt,
/obj/effect/decal/cleanable/dirt/dust,
/turf/open/floor/carpet/black,
/area/template_noop)
"as" = (
/obj/machinery/power/shuttle_engine/heater{
	dir = 1
	},
/obj/structure/window/reinforced/spawner/directional/south,
/turf/open/floor/plating/airless,
/area/template_noop)
"aW" = (
/obj/structure/lattice/catwalk,
/obj/structure/cable,
/obj/effect/spawner/random/engineering/toolbox,
/turf/template_noop,
/area/template_noop)
"aX" = (
/obj/effect/decal/cleanable/dirt,
/obj/effect/spawner/random/entertainment/wallet_storage,
/turf/open/floor/carpet/black,
/area/template_noop)
"aZ" = (
/obj/effect/decal/cleanable/blood/drip,
/obj/machinery/computer/accounting{
	dir = 1
	},
/obj/effect/turf_decal/bot,
/turf/open/floor/carpet/black,
/area/template_noop)
"bk" = (
/obj/effect/mapping_helpers/broken_floor,
/turf/open/floor/iron/dark/smooth_large/airless,
/area/template_noop)
"bU" = (
/obj/structure/table,
/obj/item/food/hotdog{
	pixel_y = 7;
	pixel_x = -2
	},
/obj/structure/rack,
/obj/item/food/hotdog,
/obj/effect/turf_decal/tile/dark/anticorner{
	dir = 4
	},
/turf/open/floor/mineral/titanium,
/area/template_noop)
"ce" = (
/obj/machinery/griddle,
/obj/item/food/raw_sausage{
	pixel_y = 11
	},
/obj/item/food/raw_sausage{
	pixel_y = 2;
	pixel_x = 2
	},
/obj/effect/turf_decal/tile/dark/half{
	dir = 4
	},
/turf/open/floor/mineral/titanium,
/area/template_noop)
"cD" = (
/obj/effect/decal/cleanable/dirt/dust,
/turf/open/floor/plating,
/area/template_noop)
"cK" = (
/obj/structure/lattice/catwalk,
/obj/machinery/power/tracker,
/obj/structure/cable,
/turf/template_noop,
/area/template_noop)
"cT" = (
/obj/effect/decal/cleanable/dirt,
/obj/effect/mapping_helpers/broken_floor,
/turf/open/floor/mineral/titanium,
/area/template_noop)
"dz" = (
/obj/machinery/light/directional/south,
/obj/effect/turf_decal/tile/dark/half,
/turf/open/floor/mineral/titanium,
/area/template_noop)
"dU" = (
/obj/effect/decal/cleanable/dirt,
/obj/effect/decal/cleanable/garbage,
/turf/open/floor/iron/dark,
/area/template_noop)
"eg" = (
/obj/effect/mapping_helpers/broken_floor,
/obj/effect/spawner/random/trash/grime,
/turf/open/floor/plating,
/area/template_noop)
"er" = (
/turf/open/floor/holofloor/stairs/right,
/area/template_noop)
"fk" = (
/turf/template_noop,
/area/template_noop)
"fB" = (
/obj/effect/decal/cleanable/dirt,
/obj/effect/decal/cleanable/blood/drip,
/obj/structure/sign/poster/contraband/donk_co/directional/north,
/obj/effect/turf_decal/tile/dark/half{
	dir = 1
	},
/turf/open/floor/mineral/titanium,
/area/template_noop)
"fK" = (
/obj/machinery/door/airlock/titanium{
	name = "Storeroom"
	},
/obj/effect/decal/cleanable/dirt/dust,
/turf/open/floor/iron/dark,
/area/template_noop)
"he" = (
/obj/machinery/power/solar{
	id = "forestarboard";
	name = "Fore-Starboard Solar Array"
	},
/obj/structure/cable,
/turf/open/floor/iron/solarpanel,
/area/template_noop)
"ht" = (
/turf/open/space/basic,
/area/template_noop)
"hU" = (
/obj/effect/decal/cleanable/food/tomato_smudge,
/obj/effect/decal/cleanable/dirt,
/obj/effect/decal/cleanable/plastic,
/turf/open/floor/mineral/titanium,
/area/template_noop)
"ic" = (
/turf/open/floor/plating,
/area/template_noop)
"if" = (
/obj/machinery/light/directional/east,
/obj/effect/turf_decal/tile/dark/half{
	dir = 4
	},
/turf/open/floor/mineral/titanium,
/area/template_noop)
"io" = (
/obj/machinery/light/directional/north,
/obj/effect/turf_decal/bot,
/turf/open/floor/mineral/titanium,
/area/template_noop)
"ip" = (
/obj/effect/decal/cleanable/dirt,
/obj/effect/turf_decal/tile/dark/half,
/turf/open/floor/mineral/titanium,
/area/template_noop)
"iz" = (
/obj/structure/cable,
/turf/open/floor/mineral/titanium,
/area/template_noop)
"iG" = (
/obj/effect/decal/cleanable/dirt,
/obj/effect/spawner/random/trash/grime,
/turf/open/floor/iron/dark/smooth_large/airless,
/area/template_noop)
"iL" = (
/obj/machinery/door/airlock/titanium{
	name = "Storeroom"
	},
/obj/effect/decal/cleanable/dirt,
/turf/open/floor/iron/dark,
/area/template_noop)
"iX" = (
/obj/machinery/light/directional/west,
/turf/open/floor/carpet/black,
/area/template_noop)
"jk" = (
/obj/structure/rack/shelf,
/obj/item/food/canned/tomatoes,
/obj/item/food/canned/tomatoes,
/obj/item/food/canned/tomatoes,
/obj/effect/decal/cleanable/dirt,
/obj/effect/turf_decal/bot,
/turf/open/floor/mineral/titanium,
/area/template_noop)
"jW" = (
/obj/structure/table,
/obj/effect/decal/cleanable/glass,
/obj/effect/spawner/random/maintenance/three,
/turf/open/floor/iron/dark,
/area/template_noop)
"jX" = (
/obj/effect/decal/cleanable/dirt,
/turf/open/floor/mineral/titanium,
/area/template_noop)
"kb" = (
/obj/machinery/door/airlock/external{
	name = "Getcher Gas'n'Go"
	},
/obj/structure/cable,
/turf/open/space/basic,
/area/template_noop)
"ki" = (
/obj/structure/rack/shelf,
/obj/item/food/peanuts/random,
/obj/item/food/peanuts/random,
/obj/effect/decal/cleanable/dirt,
/obj/effect/decal/cleanable/dirt/dust,
/obj/effect/turf_decal/bot,
/obj/effect/turf_decal/tile/dark/half{
	dir = 8
	},
/turf/open/floor/mineral/titanium,
/area/template_noop)
"km" = (
/obj/machinery/power/shuttle_engine/propulsion{
	dir = 1
	},
/turf/open/floor/plating/airless,
/area/template_noop)
"kR" = (
/obj/effect/decal/cleanable/dirt,
/obj/effect/decal/cleanable/dirt/dust,
/obj/structure/extinguisher_cabinet/directional/west,
/obj/effect/turf_decal/tile/dark/anticorner{
	dir = 1
	},
/turf/open/floor/mineral/titanium,
/area/template_noop)
"li" = (
/obj/effect/mapping_helpers/broken_floor,
/obj/effect/decal/cleanable/dirt/dust,
/turf/open/floor/plating,
/area/template_noop)
"lx" = (
/obj/effect/mapping_helpers/burnt_floor,
/turf/open/floor/iron/dark,
/area/template_noop)
"lU" = (
/obj/effect/decal/cleanable/dirt/dust,
/obj/effect/spawner/random/structure/crate,
/turf/open/floor/iron/dark,
/area/template_noop)
"mX" = (
/obj/structure/railing{
	dir = 4
	},
/obj/structure/cable,
/obj/effect/decal/cleanable/dirt/dust,
/turf/open/floor/mineral/titanium,
/area/template_noop)
"nn" = (
/obj/effect/decal/cleanable/dirt,
/turf/open/floor/iron/white/textured_large/airless,
/area/template_noop)
"ow" = (
/obj/structure/cable,
/obj/effect/decal/cleanable/dirt,
/turf/open/floor/mineral/titanium,
/area/template_noop)
"oA" = (
/obj/effect/spawner/structure/window/reinforced/shuttle,
/turf/open/floor/plating,
/area/template_noop)
"oD" = (
/obj/machinery/vending/cigarette,
/obj/structure/sign/poster/contraband/have_a_puff/directional/north,
/obj/effect/decal/cleanable/dirt/dust,
/obj/effect/turf_decal/bot,
/obj/effect/turf_decal/tile/dark/half{
	dir = 1
	},
/turf/open/floor/mineral/titanium,
/area/template_noop)
"pI" = (
/obj/structure/rack/shelf,
/obj/item/storage/box/donkpockets,
/obj/item/storage/box/donkpockets/donkpocketberry,
/obj/item/storage/box/donkpockets/donkpocketgondola,
/obj/item/storage/box/donkpockets/donkpockethonk,
/obj/effect/turf_decal/bot,
/obj/effect/turf_decal/tile/dark/half{
	dir = 8
	},
/turf/open/floor/mineral/titanium,
/area/template_noop)
"pY" = (
/obj/structure/lattice/catwalk,
/turf/template_noop,
/area/template_noop)
"qh" = (
/obj/effect/turf_decal/tile/dark{
	dir = 4
	},
/turf/open/floor/mineral/titanium,
/area/template_noop)
"qk" = (
/obj/effect/decal/cleanable/dirt/dust,
/obj/effect/decal/cleanable/glass,
/turf/open/floor/iron/dark,
/area/template_noop)
"qF" = (
/obj/structure/railing{
	dir = 8
	},
/turf/open/floor/holofloor/stairs,
/area/template_noop)
"ra" = (
/turf/open/floor/holofloor/stairs/left,
/area/template_noop)
"rb" = (
/obj/effect/decal/cleanable/dirt,
/obj/machinery/coffeemaker/impressa{
	pixel_y = 5;
	pixel_x = 9
	},
/obj/structure/table,
/obj/item/storage/box/coffeepack{
	pixel_x = -4;
	pixel_y = 3
	},
/obj/effect/turf_decal/tile/dark/half,
/turf/open/floor/mineral/titanium,
/area/template_noop)
"rs" = (
/obj/effect/decal/cleanable/dirt,
/obj/effect/spawner/random/trash/grille_or_waste,
/turf/open/floor/plating,
/area/template_noop)
"rA" = (
/obj/structure/cable,
/obj/effect/decal/cleanable/dirt,
/turf/open/floor/plating,
/area/template_noop)
"rK" = (
/obj/structure/sign/poster/random/directional/east,
/obj/structure/lattice,
/turf/open/space/basic,
/area/template_noop)
"rL" = (
/turf/open/floor/mineral/titanium,
/area/template_noop)
"sn" = (
/obj/effect/mapping_helpers/broken_floor,
/obj/effect/decal/cleanable/dirt/dust,
/obj/effect/spawner/random/trash/hobo_squat{
	atom_integrity = 100
	},
/turf/open/floor/plating,
/area/template_noop)
"tk" = (
/obj/structure/table,
/obj/item/kitchen/fork/plastic{
	pixel_x = 10
	},
/obj/item/kitchen/spoon/plastic{
	pixel_x = 7
	},
/obj/item/kitchen/fork/plastic{
	pixel_x = 10
	},
/obj/item/kitchen/fork/plastic{
	pixel_x = 10
	},
/obj/item/kitchen/fork/plastic{
	pixel_x = 10
	},
/obj/item/kitchen/spoon/plastic{
	pixel_x = 7
	},
/obj/item/kitchen/spoon/plastic{
	pixel_x = 7
	},
/obj/item/kitchen/spoon/plastic{
	pixel_x = 7
	},
/obj/item/knife/plastic{
	pixel_x = -4
	},
/obj/item/knife/plastic{
	pixel_x = -4
	},
/obj/effect/turf_decal/tile/dark/half,
/turf/open/floor/mineral/titanium,
/area/template_noop)
"tn" = (
/obj/effect/mapping_helpers/broken_floor,
/obj/effect/decal/cleanable/ants,
/turf/open/floor/iron/dark,
/area/template_noop)
"tp" = (
/obj/structure/table,
/obj/effect/decal/cleanable/dirt,
/obj/effect/spawner/random/entertainment/money_small,
/turf/open/floor/carpet/black,
/area/template_noop)
"tO" = (
/obj/effect/decal/cleanable/dirt/dust,
/obj/machinery/light/directional/south,
/turf/open/floor/iron/freezer,
/area/template_noop)
"up" = (
/obj/effect/mapping_helpers/broken_floor,
/turf/open/floor/plating,
/area/template_noop)
"uv" = (
/obj/structure/cable,
/obj/effect/decal/cleanable/dirt,
/obj/effect/mapping_helpers/broken_floor,
/obj/effect/decal/cleanable/dirt/dust,
/turf/open/floor/plating,
/area/template_noop)
"uH" = (
/turf/open/floor/iron/dark/smooth_large/airless,
/area/template_noop)
"uL" = (
/obj/structure/rack/shelf,
/obj/effect/spawner/random/food_or_drink/booze,
/obj/effect/spawner/random/food_or_drink/booze,
/obj/effect/spawner/random/food_or_drink/booze,
/obj/effect/spawner/random/food_or_drink/booze,
/obj/effect/decal/cleanable/dirt,
/obj/effect/turf_decal/bot,
/turf/open/floor/mineral/titanium,
/area/template_noop)
"vg" = (
/obj/effect/decal/cleanable/dirt,
/obj/effect/decal/cleanable/plastic,
/obj/effect/turf_decal/tile/dark/half,
/turf/open/floor/mineral/titanium,
/area/template_noop)
"vn" = (
/obj/effect/turf_decal/tile/dark/half{
	dir = 1
	},
/turf/open/floor/mineral/titanium,
/area/template_noop)
"wc" = (
/obj/effect/turf_decal/bot,
/obj/effect/spawner/random/vending/colavend,
/obj/effect/decal/cleanable/dirt,
/turf/open/floor/mineral/titanium,
/area/template_noop)
"wd" = (
/obj/effect/turf_decal/bot,
/obj/effect/spawner/random/vending/snackvend,
/turf/open/floor/mineral/titanium,
/area/template_noop)
"wf" = (
/obj/structure/sink/directional/south,
/obj/structure/mirror{
	pixel_y = 32
	},
/obj/effect/decal/cleanable/dirt,
/obj/effect/decal/cleanable/hair,
/turf/open/floor/iron/freezer,
/area/template_noop)
"xu" = (
/obj/effect/decal/cleanable/dirt,
/obj/effect/spawner/random/trash/moisture,
/turf/open/floor/iron/freezer,
/area/template_noop)
"xP" = (
/turf/open/floor/iron/solarpanel,
/area/template_noop)
"ye" = (
/obj/structure/lattice/catwalk,
/obj/structure/cable,
/turf/template_noop,
/area/template_noop)
"yR" = (
/turf/open/floor/iron/white/textured_large/airless,
/area/template_noop)
"za" = (
/obj/structure/window/reinforced/tinted/spawner/directional/west,
/obj/structure/toilet{
	pixel_y = 16
	},
/obj/machinery/door/window/right/directional/south,
/obj/item/knife/shiv,
/obj/effect/decal/cleanable/dirt,
/turf/open/floor/iron/freezer,
/area/template_noop)
"zQ" = (
/obj/structure/closet/crate/bin,
/obj/effect/decal/cleanable/dirt,
/obj/effect/decal/cleanable/garbage,
/obj/effect/turf_decal/bot,
/obj/machinery/light/small/directional/north,
/turf/open/floor/iron/dark,
/area/template_noop)
"Aa" = (
/obj/structure/closet/crate/cardboard/mothic,
/obj/structure/rack/shelf,
/obj/effect/turf_decal/bot,
/obj/machinery/light/small/directional/north,
/turf/open/floor/iron/dark,
/area/template_noop)
"Ag" = (
/obj/structure/rack/shelf,
/obj/effect/spawner/random/food_or_drink/refreshing_beverage,
/obj/effect/spawner/random/food_or_drink/refreshing_beverage,
/obj/effect/spawner/random/food_or_drink/refreshing_beverage,
/obj/effect/spawner/random/food_or_drink/refreshing_beverage,
/obj/effect/decal/cleanable/dirt,
/obj/effect/decal/cleanable/plastic,
/obj/effect/turf_decal/bot,
/turf/open/floor/mineral/titanium,
/area/template_noop)
"As" = (
/obj/structure/rack/shelf,
/obj/item/food/cnds/random,
/obj/item/food/cnds/random,
/obj/item/food/cnds/random,
/obj/item/food/cnds/random,
/obj/effect/turf_decal/bot,
/turf/open/floor/mineral/titanium,
/area/template_noop)
"AV" = (
/obj/structure/railing{
	dir = 1
	},
/turf/open/floor/iron/white/textured_large/airless,
/area/template_noop)
"BT" = (
/obj/effect/decal/cleanable/dirt,
/obj/effect/turf_decal/tile/dark/anticorner{
	dir = 4
	},
/turf/open/floor/mineral/titanium,
/area/template_noop)
"BY" = (
/obj/effect/decal/cleanable/piss_stain,
/obj/item/food/urinalcake,
/turf/open/floor/iron/freezer,
/area/template_noop)
"DC" = (
/obj/machinery/door/airlock/bathroom{
	name = "Restroom"
	},
/obj/effect/decal/cleanable/dirt,
/obj/effect/decal/cleanable/vomit,
/turf/open/floor/iron/freezer,
/area/template_noop)
"DO" = (
/obj/effect/spawner/random/trash/graffiti,
/obj/structure/cable,
/turf/open/floor/mineral/titanium,
/area/template_noop)
"Ei" = (
/obj/effect/decal/cleanable/dirt,
/turf/open/floor/iron/dark/smooth_large/airless,
/area/template_noop)
"GT" = (
/obj/effect/decal/cleanable/dirt,
/turf/open/floor/plating,
/area/template_noop)
"Ha" = (
/obj/structure/lattice,
/obj/structure/marker_beacon/burgundy,
/turf/template_noop,
/area/template_noop)
"Hx" = (
/obj/structure/rack/shelf,
/obj/item/food/syndicake,
/obj/item/food/syndicake,
/obj/item/food/syndicake,
/obj/effect/turf_decal/bot,
/turf/open/floor/mineral/titanium,
/area/template_noop)
"HC" = (
/obj/structure/sign/poster/random/directional/east,
/turf/open/floor/plating,
/area/template_noop)
"HJ" = (
/obj/structure/lattice,
/turf/template_noop,
/area/template_noop)
"Iv" = (
/obj/effect/decal/cleanable/dirt/dust,
/turf/open/floor/iron/dark/smooth_large/airless,
/area/template_noop)
"Jc" = (
/obj/structure/table,
/obj/item/reagent_containers/condiment/ketchup{
	pixel_y = 18;
	pixel_x = 11
	},
/obj/item/reagent_containers/condiment/hotsauce{
	pixel_y = 15
	},
/obj/item/reagent_containers/condiment/saltshaker{
	pixel_x = -8;
	pixel_y = 5
	},
/obj/item/reagent_containers/condiment/peppermill{
	pixel_x = -8
	},
/obj/effect/turf_decal/tile/dark/half{
	dir = 1
	},
/turf/open/floor/mineral/titanium,
/area/template_noop)
"Je" = (
/obj/structure/railing{
	dir = 1
	},
/obj/structure/reagent_dispensers/fueltank,
/obj/effect/turf_decal/bot,
/turf/open/floor/iron/white/textured_large/airless,
/area/template_noop)
"Ji" = (
/obj/effect/decal/cleanable/dirt,
/obj/effect/spawner/random/trash/food_packaging,
/turf/open/floor/mineral/titanium,
/area/template_noop)
"Jv" = (
/obj/structure/window/reinforced/tinted/spawner/directional/west,
/obj/structure/toilet{
	pixel_y = 16
	},
/obj/machinery/door/window/right/directional/south,
/obj/effect/decal/cleanable/piss_stain,
/obj/effect/decal/cleanable/blood/drip,
/turf/open/floor/iron/freezer,
/area/template_noop)
"JR" = (
/obj/machinery/door/airlock/external{
	name = "Getcher Gas'n'Go"
	},
/obj/effect/decal/cleanable/dirt,
/turf/open/space/basic,
/area/template_noop)
"Kg" = (
/obj/machinery/atm/directional/north,
/obj/effect/mapping_helpers/broken_floor,
/turf/open/floor/plating,
/area/template_noop)
"Kv" = (
/turf/closed/wall/mineral/titanium,
/area/template_noop)
"KH" = (
/obj/effect/spawner/random/vending/snackvend,
/obj/effect/turf_decal/bot,
/obj/effect/decal/cleanable/dirt,
/turf/open/floor/mineral/titanium,
/area/template_noop)
"Ln" = (
/obj/structure/table,
/obj/effect/spawner/random/entertainment/cigarette_pack,
/obj/effect/spawner/random/entertainment/cigarette,
/turf/open/floor/carpet/black,
/area/template_noop)
"Ls" = (
/obj/structure/railing{
	dir = 4
	},
/obj/structure/reagent_dispensers/watertank,
/obj/effect/turf_decal/bot,
/turf/open/floor/mineral/titanium,
/area/template_noop)
"LR" = (
/obj/structure/cable,
/obj/effect/mapping_helpers/broken_floor,
/obj/effect/decal/cleanable/dirt/dust,
/turf/open/floor/plating,
/area/template_noop)
"Mg" = (
/obj/effect/decal/cleanable/dirt,
/obj/effect/spawner/random/trash/cigbutt,
/turf/open/floor/mineral/titanium,
/area/template_noop)
"Nb" = (
/obj/effect/spawner/random/vending/colavend,
/obj/effect/turf_decal/bot,
/obj/effect/decal/cleanable/dirt,
/turf/open/floor/mineral/titanium,
/area/template_noop)
"Nj" = (
/obj/structure/table,
/obj/item/food/syndicake,
/turf/open/floor/carpet/black,
/area/template_noop)
"NL" = (
/obj/effect/decal/cleanable/dirt,
/obj/effect/decal/cleanable/dirt,
/turf/open/floor/iron/dark,
/area/template_noop)
"Om" = (
/obj/effect/turf_decal/tile/dark/anticorner{
	dir = 8
	},
/turf/open/floor/mineral/titanium,
/area/template_noop)
"OJ" = (
/obj/effect/decal/cleanable/dirt,
/obj/effect/decal/cleanable/dirt/dust,
/obj/effect/decal/cleanable/dirt/dust,
/turf/open/floor/mineral/titanium,
/area/template_noop)
"Pd" = (
/obj/structure/closet/crate/bin{
	pixel_y = 13
	},
/obj/effect/turf_decal/bot,
/obj/effect/turf_decal/tile/dark/half{
	dir = 1
	},
/turf/open/floor/mineral/titanium,
/area/template_noop)
"Ps" = (
/obj/machinery/door/window/right/directional/east,
/obj/effect/decal/cleanable/dirt/dust,
/obj/effect/turf_decal/tile/dark/half{
	dir = 1
	},
/turf/open/floor/mineral/titanium,
/area/template_noop)
"QJ" = (
/obj/machinery/light/directional/north,
/obj/effect/turf_decal/bot,
/obj/structure/sign/poster/random/directional/north,
/obj/effect/decal/cleanable/dirt,
/obj/effect/spawner/random/trash/food_packaging,
/turf/open/floor/mineral/titanium,
/area/template_noop)
"QP" = (
/obj/effect/turf_decal/tile/dark/half{
	dir = 4
	},
/turf/open/floor/mineral/titanium,
/area/template_noop)
"Sj" = (
/obj/structure/railing{
	dir = 1
	},
/obj/effect/decal/cleanable/dirt/dust,
/obj/effect/spawner/random/trash/garbage,
/turf/open/floor/iron/white/textured_large/airless,
/area/template_noop)
"Sy" = (
/obj/effect/decal/cleanable/dirt,
/obj/effect/decal/cleanable/dirt/dust,
/obj/structure/sign/poster/contraband/pizza_imperator/directional/north,
/obj/effect/turf_decal/tile/dark/half{
	dir = 1
	},
/turf/open/floor/mineral/titanium,
/area/template_noop)
"TP" = (
/obj/effect/decal/cleanable/dirt/dust,
/turf/open/floor/carpet/black,
/area/template_noop)
"Up" = (
/obj/structure/railing{
	dir = 1
	},
/obj/effect/decal/cleanable/dirt/dust,
/turf/open/floor/iron/white/textured_large/airless,
/area/template_noop)
"Ux" = (
/obj/effect/spawner/random/trash/graffiti,
/obj/effect/decal/cleanable/dirt,
/turf/open/floor/mineral/titanium,
/area/template_noop)
"UR" = (
/obj/structure/railing{
	dir = 8
	},
/obj/effect/turf_decal/bot,
/obj/structure/closet/crate/bin{
	pixel_y = 13
	},
/obj/effect/decal/cleanable/dirt,
/turf/open/floor/mineral/titanium,
/area/template_noop)
"Vx" = (
/obj/effect/decal/cleanable/dirt,
/turf/open/floor/iron/dark,
/area/template_noop)
"VJ" = (
/obj/effect/decal/cleanable/dirt,
/obj/effect/spawner/random/trash/caution_sign,
/turf/open/floor/carpet/black,
/area/template_noop)
"Wc" = (
/obj/structure/rack/shelf,
/obj/item/food/canned/beans,
/obj/item/food/canned/beans,
/obj/item/food/canned/beans,
/obj/effect/decal/cleanable/dirt,
/obj/effect/turf_decal/bot,
/turf/open/floor/mineral/titanium,
/area/template_noop)
"Ws" = (
/obj/effect/mapping_helpers/broken_floor,
/obj/effect/decal/cleanable/dirt/dust,
/turf/open/floor/iron/dark/smooth_large/airless,
/area/template_noop)
"Wy" = (
/obj/effect/spawner/random/trash/grime,
/turf/open/floor/iron/dark/smooth_large/airless,
/area/template_noop)
"WD" = (
/obj/structure/railing{
	dir = 8
	},
/obj/effect/decal/cleanable/dirt,
/obj/effect/decal/cleanable/dirt/dust,
/obj/effect/spawner/random/trash/bacteria,
/turf/open/floor/mineral/titanium,
/area/template_noop)
"XY" = (
/obj/structure/closet/cardboard,
/turf/open/floor/iron/dark,
/area/template_noop)
"Yi" = (
/obj/effect/decal/cleanable/dirt/dust,
/turf/open/floor/iron/white/textured_large/airless,
/area/template_noop)
"YA" = (
/obj/structure/table,
/obj/structure/rack,
/obj/item/food/taco{
	pixel_y = 7;
	pixel_x = 1
	},
/obj/item/food/taco,
/obj/effect/turf_decal/tile/dark/anticorner,
/turf/open/floor/mineral/titanium,
/area/template_noop)
"YP" = (
/obj/structure/rack/shelf,
/obj/structure/closet/crate/cardboard,
/obj/effect/decal/cleanable/cobweb,
/obj/effect/turf_decal/bot,
/turf/open/floor/iron/dark,
/area/template_noop)
"YY" = (
/obj/effect/spawner/random/structure/billboard/roadsigns,
/turf/open/floor/plating,
/area/template_noop)
"Zs" = (
/obj/structure/rack,
/obj/effect/decal/cleanable/garbage,
/obj/effect/turf_decal/bot,
/obj/effect/spawner/random/structure/crate,
/turf/open/floor/iron/dark,
/area/template_noop)
"ZF" = (
/obj/structure/cable,
/turf/open/floor/iron/solarpanel,
/area/template_noop)

(1,1,1) = {"
fk
fk
fk
fk
fk
fk
fk
fk
HJ
HJ
fk
fk
fk
fk
fk
fk
fk
fk
fk
fk
fk
fk
"}
(2,1,1) = {"
fk
fk
fk
HJ
YY
HJ
fk
ht
YY
cD
HJ
fk
fk
fk
fk
fk
fk
fk
fk
fk
fk
fk
"}
(3,1,1) = {"
fk
fk
fk
HJ
up
li
HJ
ht
cD
GT
HJ
fk
fk
fk
fk
fk
fk
fk
fk
fk
fk
fk
"}
(4,1,1) = {"
fk
HJ
HJ
ic
GT
up
HJ
rK
HC
sn
HJ
HJ
HJ
fk
fk
fk
fk
fk
fk
fk
fk
fk
"}
(5,1,1) = {"
HJ
Kv
Kv
Kv
Kv
Kv
Kv
Kv
Kv
oA
oA
oA
Kv
Kg
ah
ah
uH
fk
fk
fk
fk
fk
"}
(6,1,1) = {"
HJ
Kv
YP
lU
XY
Kv
kR
aZ
iX
pI
ki
Om
oA
UR
WD
qF
HJ
uH
Ei
fk
fk
fk
"}
(7,1,1) = {"
HJ
Kv
Aa
tn
Vx
Kv
Sy
tp
TP
As
Hx
ip
oA
Nb
Ux
Je
Yi
Yi
Iv
fk
fk
fk
"}
(8,1,1) = {"
HJ
Kv
Zs
dU
lx
Kv
fB
Ln
aX
Wc
jk
vg
oA
KH
Ji
AV
Ei
Ei
Iv
cD
HJ
fk
"}
(9,1,1) = {"
HJ
Kv
Kv
Kv
iL
Kv
Ps
Nj
ak
uL
Ag
dz
Kv
QJ
cT
Up
nn
HJ
HJ
Iv
uH
bk
"}
(10,1,1) = {"
HJ
ic
Kv
jW
NL
Kv
vn
rL
jX
rL
TP
ak
JR
jX
jX
ra
Wy
Ei
Ei
uH
uH
HJ
"}
(11,1,1) = {"
fk
HJ
Kv
zQ
qk
fK
BT
QP
if
qh
VJ
TP
kb
ow
ow
er
Iv
uH
bk
Iv
eg
fk
"}
(12,1,1) = {"
HJ
HJ
Kv
Kv
Kv
Kv
Kv
DC
Kv
Pd
OJ
dz
Kv
io
ow
Up
nn
Yi
Yi
ic
HJ
fk
"}
(13,1,1) = {"
fk
fk
fk
km
as
Kv
wf
xu
Kv
oD
Mg
rb
oA
wd
iz
AV
Ei
Ws
uH
HJ
fk
fk
"}
(14,1,1) = {"
fk
fk
fk
km
as
Kv
Jv
tO
Kv
Jc
hU
tk
oA
wc
DO
Sj
yR
Iv
uH
fk
fk
fk
"}
(15,1,1) = {"
fk
fk
fk
km
as
Kv
za
BY
Kv
bU
ce
YA
oA
Ls
mX
ag
Iv
Ei
iG
fk
fk
fk
"}
(16,1,1) = {"
fk
fk
fk
km
as
Kv
Kv
Kv
Kv
oA
oA
oA
Kv
rA
uv
ic
Ei
fk
fk
fk
fk
fk
"}
(17,1,1) = {"
fk
fk
fk
fk
HJ
ye
he
he
he
ye
he
xP
pY
ye
cD
fk
fk
fk
fk
fk
fk
fk
"}
(18,1,1) = {"
fk
fk
fk
Ha
HJ
ye
he
he
xP
ye
xP
he
pY
LR
rs
fk
fk
fk
fk
fk
fk
fk
"}
(19,1,1) = {"
fk
fk
cK
aW
ye
ye
ye
ye
ye
ye
ye
ye
ye
ye
HJ
fk
fk
fk
fk
fk
fk
fk
"}
(20,1,1) = {"
fk
fk
fk
Ha
HJ
ye
he
xP
he
ye
xP
xP
pY
pY
HJ
fk
fk
fk
fk
fk
fk
fk
"}
(21,1,1) = {"
fk
fk
fk
fk
HJ
ye
he
he
ZF
ye
he
he
pY
pY
HJ
fk
fk
fk
fk
fk
fk
fk
"}
(22,1,1) = {"
fk
fk
fk
fk
fk
HJ
HJ
HJ
HJ
HJ
HJ
HJ
HJ
HJ
HJ
fk
fk
fk
fk
fk
fk
fk
"}
