//MAP CONVERTED BY dmm2tgm.py THIS HEADER COMMENT PREVENTS RECONVERSION, DO NOT REMOVE
"a" = (
/turf/template_noop,
/area/template_noop)
"c" = (
/turf/closed/wall/mineral/titanium/nodiagonal,
/area/template_noop)
"d" = (
/obj/machinery/door/airlock/highsecurity,
/turf/open/floor/iron/kitchen/small,
/area/template_noop)
"g" = (
/obj/machinery/power/shuttle_engine/heater,
/obj/structure/window/reinforced/tinted/spawner/directional/north,
/turf/open/floor/plating,
/area/template_noop)
"h" = (
/turf/open/floor/iron/kitchen/small,
/area/template_noop)
"j" = (
/obj/machinery/power/shuttle_engine/propulsion,
/turf/open/floor/plating,
/area/template_noop)
"s" = (
/obj/structure/toilet{
	dir = 8
	},
/obj/effect/decal/cleanable/dirt,
/obj/structure/curtain,
/obj/structure/window/reinforced/tinted/spawner/directional/north,
/turf/open/floor/iron/kitchen/small,
/area/template_noop)
"x" = (
/obj/structure/bedsheetbin,
/obj/effect/decal/cleanable/dirt,
/turf/open/floor/iron/kitchen/small,
/area/template_noop)
"y" = (
/obj/effect/decal/cleanable/dirt,
/obj/structure/urinal{
	dir = 4;
	pixel_x = 32
	},
/turf/open/floor/iron/kitchen/small,
/area/template_noop)
"A" = (
/obj/effect/decal/cleanable/dirt,
/turf/open/floor/iron/kitchen/small,
/area/template_noop)
"E" = (
/obj/structure/toilet{
	dir = 8
	},
/obj/effect/decal/cleanable/dirt,
/obj/structure/curtain,
/obj/item/food/urinalcake,
/obj/structure/window/reinforced/tinted/spawner/directional/north,
/turf/open/floor/iron/kitchen/small,
/area/template_noop)
"G" = (
/obj/structure/mirror,
/turf/closed/wall/mineral/titanium/nodiagonal,
/area/template_noop)
"J" = (
/obj/structure/urinal{
	dir = 4;
	pixel_x = 32
	},
/obj/effect/decal/cleanable/dirt,
/obj/structure/window/reinforced/tinted/spawner/directional/north,
/turf/open/floor/iron/kitchen/small,
/area/template_noop)
"K" = (
/obj/effect/decal/cleanable/dirt,
/obj/structure/sink{
	dir = 8;
	pixel_x = -12
	},
/turf/open/floor/iron/kitchen/small,
/area/template_noop)
"O" = (
/obj/item/bikehorn/rubberducky,
/obj/item/soap/deluxe,
/obj/effect/decal/cleanable/dirt,
/turf/open/floor/iron/kitchen/small,
/area/template_noop)
"P" = (
/obj/machinery/shower,
/turf/open/floor/iron/kitchen/small,
/area/template_noop)
"W" = (
/turf/closed/wall/mineral/titanium,
/area/template_noop)
"X" = (
/obj/machinery/shower,
/obj/item/soap,
/turf/open/floor/iron/kitchen/small,
/area/template_noop)
"Z" = (
/obj/machinery/shower,
/obj/item/soap/nanotrasen,
/turf/open/floor/iron/kitchen/small,
/area/template_noop)

(1,1,1) = {"
a
a
a
a
a
a
a
a
a
a
a
a
"}
(2,1,1) = {"
a
a
W
c
c
c
G
c
d
W
a
a
"}
(3,1,1) = {"
a
W
X
P
Z
P
K
x
O
g
j
a
"}
(4,1,1) = {"
a
c
h
h
h
h
A
A
A
g
j
a
"}
(5,1,1) = {"
a
c
h
h
h
h
A
A
A
g
j
a
"}
(6,1,1) = {"
a
W
s
E
s
s
J
y
y
g
j
a
"}
(7,1,1) = {"
a
a
W
c
c
c
c
c
c
W
a
a
"}
(8,1,1) = {"
a
a
a
a
a
a
a
a
a
a
a
a
"}
