//MAP CONVERTED BY dmm2tgm.py THIS HEADER COMMENT PREVENTS RECONVERSION, DO NOT REMOVE
"a" = (
/obj/structure/closet/abductor,
/turf/open/floor/plating/abductor,
/area/abductor_ship)
"b" = (
/turf/closed/indestructible/abductor{
	icon_state = "alien22"
	},
/area/abductor_ship)
"d" = (
/turf/closed/indestructible/abductor{
	icon_state = "alien13"
	},
/area/abductor_ship)
"e" = (
/obj/item/surgical_drapes,
/obj/item/paper/guides/antag/abductor,
/obj/item/scalpel/alien,
/obj/structure/table/abductor,
/obj/item/cautery/alien,
/turf/open/floor/plating/abductor,
/area/abductor_ship)
"g" = (
/obj/machinery/abductor/pad{
	team_number = 4
	},
/turf/open/floor/plating/abductor,
/area/abductor_ship)
"h" = (
/turf/open/floor/plating/abductor,
/area/abductor_ship)
"i" = (
/obj/structure/table/abductor,
/obj/item/storage/box/alienhandcuffs,
/turf/open/floor/plating/abductor,
/area/abductor_ship)
"j" = (
/turf/closed/indestructible/abductor{
	icon_state = "alien20"
	},
/area/abductor_ship)
"k" = (
/turf/closed/indestructible/abductor{
	icon_state = "alien18"
	},
/area/abductor_ship)
"l" = (
/turf/closed/indestructible/abductor{
	icon_state = "alien16"
	},
/area/abductor_ship)
"m" = (
/turf/closed/indestructible/abductor{
	icon_state = "alien21"
	},
/area/abductor_ship)
"n" = (
/turf/closed/indestructible/abductor{
	icon_state = "alien24"
	},
/area/abductor_ship)
"o" = (
/obj/machinery/abductor/experiment{
	team_number = 4
	},
/turf/open/floor/plating/abductor,
/area/abductor_ship)
"p" = (
/turf/closed/indestructible/abductor{
	icon_state = "alien15"
	},
/area/abductor_ship)
"q" = (
/obj/machinery/computer/camera_advanced/abductor{
	team_number = 4
	},
/turf/open/floor/plating/abductor,
/area/abductor_ship)
"r" = (
/turf/closed/indestructible/abductor{
	icon_state = "alien4"
	},
/area/abductor_ship)
"s" = (
/obj/machinery/abductor/console{
	team_number = 4
	},
/turf/open/floor/plating/abductor,
/area/abductor_ship)
"t" = (
/turf/closed/indestructible/abductor{
	icon_state = "alien17"
	},
/area/abductor_ship)
"u" = (
/turf/closed/indestructible/abductor{
	icon_state = "alien5"
	},
/area/abductor_ship)
"v" = (
/turf/closed/indestructible/abductor{
	icon_state = "alien19"
	},
/area/abductor_ship)
"w" = (
/obj/item/retractor/alien,
/obj/item/hemostat/alien,
/obj/structure/table/abductor,
/turf/open/floor/plating/abductor,
/area/abductor_ship)
"A" = (
/turf/closed/indestructible/abductor{
	icon_state = "alien7"
	},
/area/abductor_ship)
"B" = (
/obj/effect/landmark/abductor/agent{
	team_number = 4
	},
/turf/open/floor/plating/abductor,
/area/abductor_ship)
"F" = (
/obj/structure/table/abductor,
/obj/item/surgicaldrill/alien,
/obj/item/circular_saw/alien,
/turf/open/floor/plating/abductor,
/area/abductor_ship)
"G" = (
/turf/closed/indestructible/abductor{
	icon_state = "alien10"
	},
/area/abductor_ship)
"H" = (
/turf/closed/indestructible/abductor{
	icon_state = "alien14"
	},
/area/abductor_ship)
"I" = (
/turf/closed/indestructible/abductor{
	icon_state = "alien11"
	},
/area/abductor_ship)
"L" = (
/obj/structure/table/optable/abductor,
/turf/open/floor/plating/abductor,
/area/abductor_ship)
"M" = (
/turf/closed/indestructible/abductor{
	icon_state = "alien23"
	},
/area/abductor_ship)
"N" = (
/obj/machinery/abductor/gland_dispenser,
/turf/open/floor/plating/abductor,
/area/abductor_ship)
"O" = (
/turf/closed/indestructible/abductor{
	icon_state = "alien8"
	},
/area/abductor_ship)
"P" = (
/obj/effect/landmark/abductor/scientist{
	team_number = 4
	},
/turf/open/floor/plating/abductor,
/area/abductor_ship)
"R" = (
/turf/closed/indestructible/abductor{
	icon_state = "alien2"
	},
/area/abductor_ship)
"S" = (
/turf/closed/indestructible/abductor{
	icon_state = "alien6"
	},
/area/abductor_ship)
"U" = (
/turf/closed/indestructible/abductor{
	icon_state = "alien3"
	},
/area/abductor_ship)
"V" = (
/obj/structure/bed/abductor,
/turf/open/floor/plating/abductor,
/area/abductor_ship)
"W" = (
/turf/cordon,
/area/misc/cordon)
"X" = (
/turf/closed/indestructible/abductor{
	icon_state = "alien12"
	},
/area/abductor_ship)
"Y" = (
/turf/closed/indestructible/abductor,
/area/abductor_ship)
"Z" = (
/turf/closed/indestructible/abductor{
	icon_state = "alien9"
	},
/area/abductor_ship)

(1,1,1) = {"
W
l
H
X
G
S
W
W
W
l
H
X
G
S
W
"}
(2,1,1) = {"
j
t
q
w
e
A
Y
W
j
t
q
w
e
A
Y
"}
(3,1,1) = {"
m
o
h
P
h
N
R
W
m
o
h
P
h
N
R
"}
(4,1,1) = {"
b
s
h
L
h
F
U
W
b
s
h
L
h
F
U
"}
(5,1,1) = {"
M
g
h
B
h
V
r
W
M
g
h
B
h
V
r
"}
(6,1,1) = {"
n
k
a
i
a
O
u
W
n
k
a
i
a
O
u
"}
(7,1,1) = {"
W
v
p
d
I
Z
W
W
W
v
p
d
I
Z
W
"}
(8,1,1) = {"
W
W
W
W
W
W
W
W
W
W
W
W
W
W
W
"}
(9,1,1) = {"
W
l
H
X
G
S
W
W
W
l
H
X
G
S
W
"}
(10,1,1) = {"
j
t
q
w
e
A
Y
W
j
t
q
w
e
A
Y
"}
(11,1,1) = {"
m
o
h
P
h
N
R
W
m
o
h
P
h
N
R
"}
(12,1,1) = {"
b
s
h
L
h
F
U
W
b
s
h
L
h
F
U
"}
(13,1,1) = {"
M
g
h
B
h
V
r
W
M
g
h
B
h
V
r
"}
(14,1,1) = {"
n
k
a
i
a
O
u
W
n
k
a
i
a
O
u
"}
(15,1,1) = {"
W
v
p
d
I
Z
W
W
W
v
p
d
I
Z
W
"}
