//MAP CONVERTED BY dmm2tgm.py THIS HEADER COMMENT PREVENTS RECONVERSION, DO NOT REMOVE
"c" = (
/turf/open/space/basic,
/area/space)
"d" = (
/obj/structure/window/plasma/reinforced/spawner/east{
	dir = 2
	},
/turf/open/floor/plasteel,
/area/space)
"e" = (
/obj/machinery/atmospherics/components/unary/thermomachine/freezer,
/obj/structure/window/plasma/reinforced/spawner/east{
	dir = 1
	},
/turf/open/floor/engine/airless,
/area/space)
"f" = (
/obj/machinery/power/supermatter_crystal/shard/hugbox,
/obj/structure/disposalpipe/segment{
	dir = 4
	},
/turf/open/floor/engine/airless,
/area/space)
"h" = (
/obj/machinery/atmospherics/components/unary/outlet_injector/atmos{
	dir = 4
	},
/obj/structure/window/plasma/reinforced/spawner/east,
/obj/structure/window/plasma/reinforced/spawner/east{
	dir = 1
	},
/obj/structure/window/plasma/reinforced/spawner/east{
	dir = 8
	},
/obj/structure/window/plasma/reinforced/spawner/east{
	dir = 2
	},
/turf/open/space/basic,
/area/space)
"i" = (
/obj/structure/window/plasma/reinforced/spawner/east,
/obj/structure/window/plasma/reinforced/spawner/east{
	dir = 1
	},
/obj/machinery/atmospherics/components/unary/vent_scrubber/on{
	dir = 8
	},
/obj/structure/window/plasma/reinforced/spawner/east{
	dir = 8
	},
/turf/open/floor/engine/airless,
/area/space)
"j" = (
/obj/structure/window/plasma/reinforced/spawner/east{
	dir = 8
	},
/obj/effect/turf_decal/stripes{
	dir = 8
	},
/turf/open/floor/plasteel,
/area/space)
"n" = (
/obj/structure/window/plasma/reinforced/spawner/east{
	dir = 1
	},
/turf/open/floor/plasteel,
/area/space)
"q" = (
/obj/machinery/atmospherics/components/trinary/filter/atmos/o2{
	dir = 4
	},
/turf/open/floor/engine/airless,
/area/space)
"r" = (
/obj/machinery/atmospherics/components/unary/portables_connector/visible,
/obj/machinery/portable_atmospherics/canister/toxins{
	filled = 10
	},
/obj/structure/window/plasma/reinforced/spawner/east{
	dir = 1
	},
/obj/structure/window/plasma/reinforced/spawner/east{
	dir = 8
	},
/turf/open/floor/engine/airless,
/area/space)
"s" = (
/obj/effect/turf_decal/stripes{
	dir = 8
	},
/obj/structure/fans/tiny/invisible,
/obj/structure/disposalpipe/segment{
	dir = 4
	},
/turf/open/floor/plasteel,
/area/space)
"t" = (
/obj/machinery/atmospherics/pipe/manifold/general/visible{
	dir = 8
	},
/obj/structure/window/plasma/reinforced/spawner/east{
	dir = 8
	},
/turf/open/floor/engine/airless,
/area/space)
"x" = (
/obj/structure/window/plasma/reinforced/spawner/east{
	dir = 1
	},
/obj/effect/turf_decal/stripes{
	dir = 1
	},
/turf/open/floor/plasteel,
/area/space)
"F" = (
/obj/structure/fans/tiny/invisible,
/obj/machinery/atmospherics/pipe/manifold/general/visible{
	dir = 4
	},
/obj/structure/disposalpipe/trunk{
	dir = 4
	},
/obj/structure/disposaloutlet{
	dir = 4
	},
/turf/open/floor/engine/airless,
/area/space)
"I" = (
/obj/machinery/atmospherics/components/trinary/filter/atmos/flipped/plasma{
	dir = 8
	},
/obj/structure/window/plasma/reinforced/spawner/east{
	dir = 2
	},
/obj/structure/window/plasma/reinforced/spawner/east,
/turf/open/floor/engine/airless,
/area/space)
"L" = (
/obj/structure/window/plasma/reinforced/spawner/east{
	dir = 2
	},
/obj/effect/turf_decal/stripes,
/turf/open/floor/plasteel,
/area/space)
"N" = (
/obj/structure/disposalpipe/segment{
	dir = 4
	},
/turf/open/floor/plasteel,
/area/space)
"O" = (
/obj/item/pipe/binary/bendable{
	dir = 5
	},
/obj/structure/window/plasma/reinforced/spawner/east{
	dir = 8
	},
/turf/open/floor/engine/airless,
/area/space)
"Q" = (
/obj/item/pipe/binary/bendable{
	dir = 9
	},
/obj/structure/window/plasma/reinforced/spawner/east{
	dir = 2
	},
/turf/open/floor/engine/airless,
/area/space)
"R" = (
/turf/open/floor/plasteel,
/area/space)
"T" = (
/obj/machinery/atmospherics/pipe/manifold/general/visible,
/turf/open/floor/engine/airless,
/area/space)
"U" = (
/obj/structure/window/plasma/reinforced/spawner/east,
/obj/structure/window/plasma/reinforced/spawner/east{
	dir = 2
	},
/obj/machinery/atmospherics/components/unary/outlet_injector/atmos{
	dir = 8
	},
/obj/structure/window/plasma/reinforced/spawner/east{
	dir = 8
	},
/turf/open/floor/engine/airless,
/area/space)
"V" = (
/obj/machinery/door/airlock/atmos/glass,
/obj/structure/window/plasma/reinforced/spawner/east{
	dir = 1
	},
/obj/structure/window/plasma/reinforced/spawner/east{
	dir = 2
	},
/turf/open/floor/engine/airless,
/area/space)
"W" = (
/obj/item/pipe/binary/bendable{
	dir = 6
	},
/obj/structure/window/plasma/reinforced/spawner/east{
	dir = 1
	},
/obj/structure/window/plasma/reinforced/spawner/east,
/turf/open/floor/engine/airless,
/area/space)

(1,1,1) = {"
c
c
c
c
c
c
c
c
c
c
"}
(2,1,1) = {"
c
R
d
r
t
O
h
n
R
c
"}
(3,1,1) = {"
c
R
d
e
T
q
Q
n
R
c
"}
(4,1,1) = {"
c
R
d
W
F
I
V
n
R
c
"}
(5,1,1) = {"
c
R
L
i
f
U
x
R
R
c
"}
(6,1,1) = {"
c
R
R
j
s
j
R
R
R
c
"}
(7,1,1) = {"
c
R
R
R
N
R
R
R
R
c
"}
(8,1,1) = {"
c
R
R
R
N
R
R
R
R
c
"}
(9,1,1) = {"
c
c
c
c
c
c
c
c
c
c
"}
(10,1,1) = {"
c
c
c
c
c
c
c
c
c
c
"}
