//MAP CONVERTED BY dmm2tgm.py THIS HEADER COMMENT PREVENTS RECONVERSION, DO NOT REMOVE
"a" = (
/obj/effect/decal/cleanable/dirt/dust,
/obj/machinery/door/airlock/maintenance_hatch,
/obj/machinery/door/firedoor/border_only{
	dir = 4
	},
/obj/machinery/door/firedoor/border_only{
	dir = 8
	},
/turf/open/floor/plating,
/area/template_noop)
"b" = (
/obj/effect/spawner/lootdrop/crate_spawner,
/obj/effect/spawner/lootdrop/maintenance/seven,
/turf/open/floor/plating,
/area/template_noop)
"i" = (
/obj/machinery/light,
/turf/open/floor/plating,
/area/template_noop)
"l" = (
/obj/structure/transit_tube{
	dir = 8
	},
/turf/open/floor/plating/asteroid/snow/icemoon,
/area/template_noop)
"m" = (
/obj/structure/closet/firecloset/full,
/turf/open/floor/plating,
/area/template_noop)
"o" = (
/obj/item/twohanded/required/kirbyplants/random,
/turf/open/floor/plating,
/area/template_noop)
"p" = (
/obj/structure/transit_tube/station/reverse,
/turf/open/floor/plating,
/area/template_noop)
"v" = (
/turf/open/floor/plating,
/area/template_noop)
"C" = (
/turf/closed/wall/r_wall,
/area/template_noop)
"D" = (
/obj/machinery/pipedispenser/disposal/transit_tube,
/turf/open/floor/plating,
/area/template_noop)
"H" = (
/obj/structure/closet/emcloset,
/turf/open/floor/plating,
/area/template_noop)
"K" = (
/obj/effect/spawner/structure/window/reinforced/shutter,
/turf/open/floor/plating,
/area/template_noop)
"M" = (
/obj/effect/decal/cleanable/dirt/dust,
/obj/item/twohanded/required/kirbyplants/random,
/turf/open/floor/plating,
/area/template_noop)
"P" = (
/obj/structure/transit_tube/station/reverse{
	dir = 1
	},
/obj/structure/transit_tube_pod{
	dir = 4
	},
/obj/effect/decal/cleanable/dirt/dust,
/turf/open/floor/plating,
/area/template_noop)
"S" = (
/obj/effect/decal/cleanable/dirt/dust,
/turf/open/floor/plating,
/area/template_noop)
"U" = (
/obj/machinery/light{
	dir = 1
	},
/turf/open/floor/plating,
/area/template_noop)
"Y" = (
/obj/structure/transit_tube{
	dir = 8
	},
/turf/closed/wall/r_wall,
/area/template_noop)

(1,1,1) = {"
H
v
v
S
D
"}
(2,1,1) = {"
U
M
P
o
i
"}
(3,1,1) = {"
a
C
Y
C
C
"}
(4,1,1) = {"
v
K
l
K
v
"}
(5,1,1) = {"
v
K
l
K
v
"}
(6,1,1) = {"
v
K
l
K
v
"}
(7,1,1) = {"
v
K
l
K
v
"}
(8,1,1) = {"
C
C
Y
C
a
"}
(9,1,1) = {"
U
M
p
o
i
"}
(10,1,1) = {"
b
v
v
S
m
"}
