//MAP CONVERTED BY dmm2tgm.py THIS HEADER COMMENT PREVENTS RECONVERSION, DO NOT REMOVE
"m" = (
/turf/open/floor/wood/broken/four,
/area/template_noop)
"r" = (
/obj/structure/closet/crate/coffin/securecoffin,
/obj/effect/decal/cleanable/blood/footprints,
/obj/item/restraints/handcuffs/cable/zipties,
/turf/open/floor/wood,
/area/template_noop)
"t" = (
/obj/effect/decal/cleanable/blood/splatter,
/turf/open/floor/wood,
/area/template_noop)
"x" = (
/turf/open/floor/wood,
/area/template_noop)
"A" = (
/obj/effect/decal/cleanable/blood/footprints,
/turf/open/floor/wood/broken/six,
/area/template_noop)
"X" = (
/turf/open/floor/wood/broken/three,
/area/template_noop)

(1,1,1) = {"
x
m
t
"}
(2,1,1) = {"
A
r
x
"}
(3,1,1) = {"
x
x
X
"}
