//MAP CONVERTED BY dmm2tgm.py THIS HEADER COMMENT PREVENTS RECONVERSION, DO NOT REMOVE
"a" = (
/obj/structure/table/wood,
/obj/effect/decal/cleanable/dirt,
/obj/effect/decal/cleanable/dirt,
/obj/item/clothing/gloves/color/white,
/obj/item/clothing/head/rabbitears,
/turf/open/floor/plating,
/area/template_noop)
"b" = (
/obj/effect/decal/cleanable/dirt,
/turf/open/floor/plating,
/area/template_noop)
"c" = (
/obj/effect/decal/cleanable/dirt,
/obj/effect/turf_decal/tile/red{
	dir = 1
	},
/obj/effect/turf_decal/tile/blue{
	dir = 8
	},
/turf/open/floor/plasteel,
/area/template_noop)
"d" = (
/turf/open/floor/plating,
/area/template_noop)
"e" = (
/obj/structure/table_frame/wood,
/turf/open/floor/plating,
/area/template_noop)
"f" = (
/obj/effect/turf_decal/tile/red{
	dir = 1
	},
/obj/effect/turf_decal/tile/blue{
	dir = 8
	},
/turf/open/floor/plasteel,
/area/template_noop)
"g" = (
/obj/effect/decal/cleanable/dirt,
/obj/item/melee/skateboard,
/turf/open/floor/plasteel/cafeteria,
/area/template_noop)
"h" = (
/obj/structure/mirror{
	pixel_x = -28
	},
/obj/structure/table/wood,
/obj/effect/decal/cleanable/dirt,
/obj/item/clothing/suit/suspenders,
/obj/effect/spawner/lootdrop/costume,
/obj/effect/turf_decal/tile/red{
	dir = 1
	},
/obj/effect/turf_decal/tile/red,
/obj/effect/turf_decal/tile/blue{
	dir = 4
	},
/obj/effect/turf_decal/tile/blue{
	dir = 8
	},
/turf/open/floor/plasteel,
/area/template_noop)
"i" = (
/obj/effect/turf_decal/tile/red{
	dir = 1
	},
/obj/effect/turf_decal/tile/red,
/obj/effect/turf_decal/tile/blue{
	dir = 4
	},
/obj/effect/turf_decal/tile/blue{
	dir = 8
	},
/turf/open/floor/plasteel,
/area/template_noop)
"k" = (
/obj/structure/table_frame/wood,
/obj/effect/decal/cleanable/dirt,
/obj/effect/turf_decal/tile/red{
	dir = 1
	},
/obj/effect/turf_decal/tile/red,
/obj/effect/turf_decal/tile/blue{
	dir = 4
	},
/obj/effect/turf_decal/tile/blue{
	dir = 8
	},
/turf/open/floor/plasteel,
/area/template_noop)
"l" = (
/obj/machinery/light/small,
/obj/effect/decal/cleanable/dirt,
/obj/machinery/vending/autodrobe/all_access,
/obj/effect/turf_decal/tile/red{
	dir = 1
	},
/obj/effect/turf_decal/tile/blue{
	dir = 8
	},
/obj/effect/turf_decal/tile/red,
/obj/effect/turf_decal/tile/blue{
	dir = 8
	},
/obj/effect/turf_decal/tile/blue{
	dir = 4
	},
/turf/open/floor/plasteel,
/area/template_noop)
"p" = (
/obj/structure/table/wood,
/obj/effect/decal/cleanable/dirt,
/obj/item/clothing/shoes/jackboots,
/obj/effect/spawner/lootdrop/costume,
/turf/open/floor/plasteel/cafeteria,
/area/template_noop)
"A" = (
/obj/structure/dresser,
/turf/open/floor/plating,
/area/template_noop)
"G" = (
/obj/structure/table/wood,
/obj/item/lipstick/random{
	pixel_x = 3;
	pixel_y = 3
	},
/obj/item/lipstick/random{
	pixel_x = -3;
	pixel_y = -3
	},
/obj/item/lipstick/random,
/obj/structure/sign/poster/contraband/random{
	pixel_y = -32
	},
/turf/open/floor/plasteel/cafeteria,
/area/template_noop)
"R" = (
/obj/effect/decal/cleanable/dirt,
/turf/open/floor/plasteel/cafeteria,
/area/template_noop)

(1,1,1) = {"
a
d
h
k
"}
(2,1,1) = {"
b
b
i
l
"}
(3,1,1) = {"
c
f
f
f
"}
(4,1,1) = {"
e
g
d
p
"}
(5,1,1) = {"
A
d
R
G
"}
