"a" = (/turf/closed/wall,/area/science/nanite)
"b" = (/obj/structure/cable{icon_state = "1-2"},/obj/machinery/atmospherics/pipe/simple/scrubbers/hidden/layer3,/obj/structure/disposalpipe/segment{dir = 10},/obj/machinery/atmospherics/pipe/simple/supply/hidden/layer1,/turf/open/floor/plating,/area/maintenance/starboard/aft)
"c" = (/turf/closed/wall,/area/maintenance/starboard/aft)
"d" = (/obj/structure/lattice,/turf/open/floor/plating/asteroid/snow/icemoon,/area/icemoon/surface)
"e" = (/obj/structure/disposalpipe/segment,/turf/open/floor/plating/asteroid/snow/icemoon,/area/icemoon/surface)
"f" = (/turf/open/floor/plating,/area/maintenance/aft)
"g" = (/obj/structure/cable{icon_state = "1-2"},/obj/machinery/atmospherics/pipe/simple/scrubbers/hidden/layer3,/obj/structure/disposalpipe/segment,/obj/machinery/atmospherics/pipe/simple/supply/hidden/layer1,/turf/open/floor/plating,/area/maintenance/starboard/aft)
"h" = (/obj/effect/spawner/structure/window/reinforced/shutter,/turf/open/floor/plating,/area/maintenance/starboard/aft)
"i" = (/obj/structure/disposalpipe/segment,/obj/effect/spawner/structure/window/reinforced/shutter,/turf/open/floor/plating,/area/maintenance/starboard/aft)
"j" = (/obj/structure/cable{icon_state = "1-4"},/obj/machinery/atmospherics/pipe/simple/scrubbers/hidden/layer3{dir = 5},/obj/structure/disposalpipe/segment,/obj/machinery/atmospherics/pipe/simple/supply/hidden/layer1{dir = 5},/turf/open/floor/plating,/area/maintenance/starboard/aft)
"k" = (/obj/structure/cable{icon_state = "4-8"},/obj/machinery/atmospherics/pipe/simple/supply/hidden/layer1{dir = 8},/obj/machinery/atmospherics/pipe/simple/scrubbers/hidden/layer3{dir = 4},/turf/open/floor/plating,/area/maintenance/starboard/aft)
"l" = (/obj/structure/cable{icon_state = "4-8"},/obj/effect/landmark/event_spawn,/obj/machinery/atmospherics/pipe/simple/supply/hidden/layer1{dir = 8},/obj/machinery/atmospherics/pipe/simple/scrubbers/hidden/layer3{dir = 4},/turf/open/floor/plating,/area/maintenance/starboard/aft)
"m" = (/obj/structure/cable{icon_state = "4-8"},/obj/machinery/atmospherics/pipe/simple/scrubbers/hidden/layer3{dir = 4},/obj/structure/disposalpipe/segment,/obj/machinery/atmospherics/pipe/simple/supply/hidden/layer1{dir = 8},/turf/open/floor/plating,/area/maintenance/starboard/aft)
"n" = (/obj/structure/cable{icon_state = "4-8"},/obj/machinery/atmospherics/pipe/simple/scrubbers/hidden/layer3{dir = 4},/obj/structure/disposalpipe/segment{dir = 6},/obj/machinery/atmospherics/pipe/simple/supply/hidden/layer1{dir = 8},/turf/open/floor/plating,/area/maintenance/starboard/aft)
"o" = (/obj/machinery/door/airlock/maintenance{req_access_txt = "12"},/obj/structure/cable{icon_state = "4-8"},/obj/machinery/atmospherics/pipe/simple/supply/hidden/layer1{dir = 8},/obj/machinery/atmospherics/pipe/simple/scrubbers/hidden/layer3{dir = 4},/obj/structure/disposalpipe/segment{dir = 4},/obj/machinery/door/firedoor/border_only{dir = 4},/obj/machinery/door/firedoor/border_only{dir = 8},/turf/open/floor/plating,/area/maintenance/starboard/aft)
"p" = (/obj/structure/disposalpipe/segment{dir = 5},/turf/open/floor/plating,/area/maintenance/starboard/aft)
"q" = (/obj/structure/disposalpipe/segment{dir = 4},/turf/open/floor/plating,/area/maintenance/starboard/aft)
"r" = (/obj/structure/chair,/obj/item/storage/box/fancy/cigarettes,/obj/structure/disposalpipe/segment{dir = 4},/turf/open/floor/plating,/area/maintenance/starboard/aft)
"s" = (/obj/structure/chair,/obj/structure/disposalpipe/junction/flip{dir = 4},/turf/open/floor/plating,/area/maintenance/starboard/aft)
"t" = (/obj/structure/disposalpipe/segment{dir = 9},/turf/open/floor/plating,/area/maintenance/starboard/aft)
"u" = (/turf/open/floor/plating/asteroid/snow/icemoon,/area/icemoon/surface)
"v" = (/obj/effect/spawner/structure/window/reinforced/shutter,/turf/open/floor/plating,/area/maintenance/aft)
"w" = (/obj/machinery/door/airlock/external{name = "Solar Maintenance"; req_access_txt = "10; 13"},/obj/effect/mapping_helpers/airlock/cyclelink_helper_target{dirx = -1; diry = 2},/turf/open/floor/plating,/area/maintenance/aft)
"x" = (/obj/structure/lattice/catwalk,/turf/open/floor/plating/asteroid/snow/icemoon,/area/icemoon/surface)

(1,1,1) = {"
bcuuuuudeduuuuua
gcchhcchihcchhhc
jkkkkklkmkkkkkno
pqqqqqqrsqqqqqtc
cchhhcchhhcchhhc
fvuuuuuuuuuuuduc
fvuuuuuuuuuuuduc
wvuuuuuuuuuuuduc
xxuuuuuuuuuuuddc
xxuuuuuuuuuuuddc
"}
