//MAP CONVERTED BY dmm2tgm.py THIS HEADER COMMENT PREVENTS RECONVERSION, DO NOT REMOVE
"aa" = (
/turf/template_noop,
/area/template_noop)
"ab" = (
/obj/machinery/door/airlock{
	name = "Theatre Backstage";
	req_access_txt = "46"
	},
/obj/machinery/atmospherics/pipe/simple/supply/hidden/layer2,
/obj/machinery/atmospherics/pipe/simple/scrubbers/hidden/layer4,
/obj/machinery/door/firedoor/border_only{
	dir = 1
	},
/obj/machinery/door/firedoor/border_only,
/turf/open/floor/plasteel,
/area/crew_quarters/theatre)
"ac" = (
/turf/closed/wall,
/area/crew_quarters/theatre)
"ae" = (
/obj/structure/disposalpipe/segment,
/obj/machinery/atmospherics/pipe/simple/scrubbers/hidden/layer4,
/obj/machinery/atmospherics/pipe/simple/supply/hidden/layer2,
/turf/open/floor/wood,
/area/crew_quarters/bar)
"af" = (
/obj/structure/sink/kitchen{
	pixel_y = 28
	},
/turf/open/floor/wood,
/area/crew_quarters/bar)
"ag" = (
/turf/closed/wall,
/area/crew_quarters/bar)
"ai" = (
/obj/machinery/door/airlock/maintenance{
	name = "Kitchen Maintenance";
	req_access_txt = "28"
	},
/obj/structure/disposalpipe/segment,
/obj/machinery/atmospherics/pipe/simple/supply/hidden/layer2,
/obj/machinery/atmospherics/pipe/simple/scrubbers/hidden/layer4,
/obj/machinery/door/firedoor/border_only{
	dir = 1
	},
/obj/machinery/door/firedoor/border_only,
/turf/open/floor/plating,
/area/maintenance/starboard/fore)
"ak" = (
/obj/machinery/door/window/southleft{
	base_state = "left";
	dir = 2;
	icon_state = "left";
	name = "Bar Delivery";
	req_access_txt = "25"
	},
/obj/effect/turf_decal/delivery,
/turf/open/floor/plasteel,
/area/crew_quarters/bar)
"al" = (
/turf/closed/wall,
/area/crew_quarters/kitchen)
"an" = (
/obj/structure/disposalpipe/segment,
/obj/machinery/atmospherics/pipe/simple/supply/hidden/layer2,
/obj/machinery/atmospherics/pipe/simple/scrubbers/hidden/layer4,
/turf/open/floor/plasteel/showroomfloor,
/area/crew_quarters/kitchen)
"ao" = (
/obj/machinery/navbeacon{
	codes_txt = "delivery;dir=2";
	freq = 1400;
	location = "Kitchen"
	},
/obj/structure/plasticflaps{
	opacity = 1
	},
/obj/effect/turf_decal/bot{
	dir = 2
	},
/turf/open/floor/plasteel{
	dir = 2
	},
/area/crew_quarters/kitchen)
"ap" = (
/obj/machinery/camera{
	c_tag = "Kitchen Cold Room"
	},
/obj/structure/reagent_dispensers/cooking_oil,
/turf/open/floor/plasteel/showroomfloor,
/area/crew_quarters/kitchen)
"ar" = (
/obj/effect/landmark/start/assistant,
/turf/open/floor/eighties,
/area/crew_quarters/bar)
"ay" = (
/obj/machinery/reagentgrinder,
/obj/structure/table/wood,
/turf/open/floor/wood,
/area/crew_quarters/bar)
"aA" = (
/obj/machinery/camera{
	c_tag = "Bar Storage"
	},
/turf/open/floor/wood,
/area/crew_quarters/bar)
"aB" = (
/turf/open/floor/wood,
/area/crew_quarters/bar)
"aE" = (
/obj/machinery/airalarm{
	dir = 4;
	pixel_x = -24
	},
/obj/machinery/light/small{
	dir = 8
	},
/obj/structure/reagent_dispensers/beerkeg,
/obj/machinery/atmospherics/components/unary/vent_scrubber/on/layer4{
	dir = 4;
	icon_state = "scrub_map_on-3"
	},
/turf/open/floor/wood,
/area/crew_quarters/bar)
"aF" = (
/obj/machinery/door/window/southleft{
	base_state = "left";
	dir = 2;
	icon_state = "left";
	name = "Kitchen Delivery";
	req_access_txt = "28"
	},
/obj/effect/turf_decal/delivery,
/obj/structure/window/reinforced{
	dir = 8
	},
/turf/open/floor/plasteel,
/area/crew_quarters/kitchen)
"aG" = (
/obj/structure/disposalpipe/segment,
/obj/effect/landmark/xeno_spawn,
/obj/machinery/atmospherics/pipe/simple/scrubbers/hidden/layer4{
	dir = 9
	},
/obj/machinery/atmospherics/pipe/simple/supply/hidden/layer2{
	dir = 5
	},
/turf/open/floor/wood,
/area/crew_quarters/bar)
"aJ" = (
/obj/machinery/atmospherics/components/unary/vent_pump/on/layer2{
	dir = 8;
	icon_state = "vent_map_on-1"
	},
/turf/open/floor/wood,
/area/crew_quarters/bar)
"aK" = (
/obj/machinery/vending/wardrobe/bar_wardrobe,
/turf/open/floor/wood,
/area/crew_quarters/bar)
"aL" = (
/obj/machinery/chem_master/condimaster{
	name = "CondiMaster Neo"
	},
/turf/open/floor/plasteel/showroomfloor,
/area/crew_quarters/kitchen)
"aR" = (
/obj/machinery/vending/coffee,
/turf/open/floor/wood,
/area/crew_quarters/bar)
"aS" = (
/obj/machinery/icecream_vat,
/turf/open/floor/plasteel/showroomfloor,
/area/crew_quarters/kitchen)
"aT" = (
/obj/structure/disposalpipe/segment,
/turf/open/floor/wood,
/area/crew_quarters/bar)
"aU" = (
/obj/effect/turf_decal/loading_area,
/turf/open/floor/plasteel/showroomfloor,
/area/crew_quarters/kitchen)
"aW" = (
/obj/structure/disposalpipe/segment,
/obj/machinery/atmospherics/pipe/simple/supply/hidden/layer2,
/obj/machinery/atmospherics/pipe/manifold/scrubbers/hidden/layer4{
	dir = 8
	},
/turf/open/floor/plasteel/showroomfloor,
/area/crew_quarters/kitchen)
"aX" = (
/obj/machinery/atmospherics/components/unary/vent_scrubber/on/layer4{
	dir = 8;
	icon_state = "scrub_map_on-3"
	},
/obj/effect/spawner/lootdrop/mob/kitchen_animal,
/turf/open/floor/plasteel/showroomfloor,
/area/crew_quarters/kitchen)
"aY" = (
/obj/machinery/light/small{
	dir = 4
	},
/obj/machinery/airalarm{
	dir = 8;
	pixel_x = 24
	},
/obj/machinery/vending/wardrobe/chef_wardrobe,
/turf/open/floor/plasteel/showroomfloor,
/area/crew_quarters/kitchen)
"aZ" = (
/obj/structure/disposalpipe/segment,
/obj/machinery/atmospherics/pipe/simple/scrubbers/hidden/layer4,
/obj/machinery/atmospherics/pipe/manifold/supply/hidden/layer2{
	dir = 8
	},
/turf/open/floor/plasteel/showroomfloor,
/area/crew_quarters/kitchen)
"ba" = (
/obj/machinery/atmospherics/components/unary/vent_pump/on/layer2{
	dir = 8;
	icon_state = "vent_map_on-1"
	},
/turf/open/floor/plasteel/showroomfloor,
/area/crew_quarters/kitchen)
"bc" = (
/obj/machinery/door/airlock{
	name = "Kitchen cold room";
	req_access_txt = "28"
	},
/obj/structure/disposalpipe/segment,
/obj/machinery/atmospherics/pipe/simple/supply/hidden/layer2,
/obj/machinery/atmospherics/pipe/simple/scrubbers/hidden/layer4,
/obj/machinery/door/firedoor/border_only,
/obj/machinery/door/firedoor/border_only{
	dir = 1
	},
/turf/open/floor/plasteel/showroomfloor,
/area/crew_quarters/kitchen)
"be" = (
/obj/structure/disposalpipe/segment,
/obj/machinery/atmospherics/pipe/simple/supply/hidden/layer2,
/obj/machinery/atmospherics/pipe/simple/scrubbers/hidden/layer4,
/turf/open/floor/plasteel/cafeteria,
/area/crew_quarters/kitchen)
"bf" = (
/obj/item/stack/sheet/metal/fifty,
/obj/item/stack/sheet/glass/fifty,
/obj/item/stack/cable_coil,
/obj/item/flashlight/lamp,
/obj/item/flashlight/lamp/green,
/obj/structure/closet/secure_closet/bartender,
/turf/open/floor/wood,
/area/crew_quarters/bar)
"bg" = (
/obj/structure/kitchenspike,
/obj/machinery/light/small{
	dir = 8
	},
/turf/open/floor/plasteel/showroomfloor,
/area/crew_quarters/kitchen)
"bh" = (
/obj/item/radio/intercom{
	pixel_y = 25
	},
/obj/machinery/camera{
	c_tag = "Kitchen";
	dir = 2
	},
/obj/structure/closet/secure_closet/freezer/fridge,
/turf/open/floor/plasteel/cafeteria,
/area/crew_quarters/kitchen)
"bn" = (
/obj/effect/landmark/start/cook,
/obj/machinery/atmospherics/components/unary/vent_scrubber/on/layer4{
	dir = 4;
	icon_state = "scrub_map_on-3"
	},
/turf/open/floor/plasteel/cafeteria,
/area/crew_quarters/kitchen)
"bo" = (
/obj/machinery/door/airlock{
	name = "Bar Storage";
	req_access_txt = "25"
	},
/obj/structure/disposalpipe/segment,
/obj/machinery/door/firedoor/border_only,
/obj/machinery/door/firedoor/border_only{
	dir = 1
	},
/turf/open/floor/plasteel{
	icon_state = "wood"
	},
/area/crew_quarters/bar)
"bp" = (
/obj/effect/landmark/blobstart,
/obj/item/toy/beach_ball/holoball,
/turf/open/floor/plating,
/area/crew_quarters/bar)
"bq" = (
/obj/structure/kitchenspike,
/turf/open/floor/plasteel/showroomfloor,
/area/crew_quarters/kitchen)
"br" = (
/obj/structure/disposalpipe/segment{
	dir = 5
	},
/obj/machinery/atmospherics/pipe/simple/supply/hidden/layer2{
	dir = 5
	},
/obj/machinery/atmospherics/pipe/simple/scrubbers/hidden/layer4{
	dir = 9
	},
/turf/open/floor/plasteel/cafeteria,
/area/crew_quarters/kitchen)
"bs" = (
/obj/structure/disposalpipe/segment{
	dir = 4
	},
/obj/machinery/atmospherics/components/unary/vent_pump/on/layer2{
	dir = 8;
	icon_state = "vent_map_on-1"
	},
/turf/open/floor/plasteel/cafeteria,
/area/crew_quarters/kitchen)
"bt" = (
/turf/open/floor/plasteel/showroomfloor,
/area/crew_quarters/kitchen)
"bu" = (
/obj/machinery/gibber,
/turf/open/floor/plasteel/showroomfloor,
/area/crew_quarters/kitchen)
"by" = (
/obj/structure/disposalpipe/segment{
	dir = 4
	},
/turf/open/floor/plasteel/cafeteria,
/area/crew_quarters/kitchen)
"bD" = (
/obj/structure/disposalpipe/segment{
	dir = 10
	},
/turf/open/floor/plasteel/cafeteria,
/area/crew_quarters/kitchen)
"bE" = (
/obj/effect/landmark/event_spawn,
/turf/closed/wall,
/area/crew_quarters/bar)
"bL" = (
/obj/machinery/vending/dinnerware,
/turf/open/floor/plasteel/cafeteria,
/area/crew_quarters/kitchen)
"bM" = (
/obj/structure/sink/kitchen{
	pixel_y = 28
	},
/obj/machinery/food_cart,
/turf/open/floor/plasteel/cafeteria,
/area/crew_quarters/kitchen)
"bN" = (
/obj/structure/extinguisher_cabinet{
	pixel_x = -5;
	pixel_y = 30
	},
/turf/open/floor/plasteel/cafeteria,
/area/crew_quarters/kitchen)
"bQ" = (
/obj/structure/table,
/obj/machinery/microwave{
	pixel_x = -3;
	pixel_y = 6
	},
/obj/machinery/airalarm{
	pixel_y = 24
	},
/obj/machinery/light{
	dir = 1
	},
/turf/open/floor/plasteel/cafeteria,
/area/crew_quarters/kitchen)
"bR" = (
/obj/structure/table,
/obj/machinery/microwave{
	pixel_x = -3;
	pixel_y = 6
	},
/turf/open/floor/plasteel/cafeteria,
/area/crew_quarters/kitchen)
"bS" = (
/obj/structure/closet/secure_closet/freezer/kitchen,
/turf/open/floor/plasteel/cafeteria,
/area/crew_quarters/kitchen)
"ce" = (
/turf/open/floor/plasteel/cafeteria,
/area/crew_quarters/kitchen)
"cf" = (
/obj/machinery/light/small{
	dir = 4
	},
/turf/open/floor/wood,
/area/crew_quarters/bar)
"cg" = (
/obj/machinery/processor,
/obj/machinery/firealarm{
	dir = 8;
	pixel_x = 26
	},
/turf/open/floor/plasteel/cafeteria,
/area/crew_quarters/kitchen)
"ck" = (
/obj/structure/table,
/obj/item/book/manual/chef_recipes,
/obj/item/stack/packageWrap,
/turf/open/floor/plasteel/cafeteria,
/area/crew_quarters/kitchen)
"cv" = (
/obj/structure/disposalpipe/segment,
/turf/open/floor/plasteel/cafeteria,
/area/crew_quarters/kitchen)
"cB" = (
/obj/machinery/deepfryer,
/turf/open/floor/plasteel/cafeteria,
/area/crew_quarters/kitchen)
"cI" = (
/obj/effect/landmark/start/cook,
/turf/open/floor/plasteel/cafeteria,
/area/crew_quarters/kitchen)
"cP" = (
/obj/machinery/light_switch{
	pixel_y = -25
	},
/turf/open/floor/plasteel/cafeteria,
/area/crew_quarters/kitchen)
"cQ" = (
/obj/machinery/light,
/turf/open/floor/plasteel/cafeteria,
/area/crew_quarters/kitchen)
"cR" = (
/obj/effect/landmark/event_spawn,
/turf/open/floor/plasteel/cafeteria,
/area/crew_quarters/kitchen)
"cS" = (
/obj/structure/disposalpipe/segment{
	dir = 5
	},
/obj/machinery/button/door{
	id = "kitchen";
	name = "Kitchen Shutters Control";
	pixel_x = -1;
	pixel_y = -24;
	req_access_txt = "28"
	},
/turf/open/floor/plasteel/cafeteria,
/area/crew_quarters/kitchen)
"cT" = (
/obj/machinery/disposal/bin,
/obj/structure/disposalpipe/trunk{
	dir = 8
	},
/turf/open/floor/plasteel/cafeteria,
/area/crew_quarters/kitchen)
"dh" = (
/obj/structure/sign/barsign,
/turf/closed/wall,
/area/crew_quarters/bar)
"dt" = (
/obj/machinery/oven,
/turf/open/floor/plasteel/cafeteria,
/area/crew_quarters/kitchen)
"dC" = (
/obj/structure/table/reinforced,
/obj/machinery/door/poddoor/shutters/preopen{
	id = "barshutters";
	name = "bar shutters"
	},
/turf/open/floor/wood,
/area/crew_quarters/bar)
"dL" = (
/obj/machinery/light{
	dir = 1
	},
/obj/machinery/camera{
	c_tag = "Theatre Stage";
	dir = 2
	},
/turf/open/floor/wood,
/area/crew_quarters/bar)
"ef" = (
/obj/effect/landmark/start/bartender,
/turf/open/floor/wood,
/area/crew_quarters/bar)
"eK" = (
/obj/machinery/computer/arcade{
	dir = 4
	},
/turf/open/floor/eighties,
/area/crew_quarters/bar)
"fy" = (
/obj/machinery/airalarm{
	dir = 2;
	pixel_y = 24
	},
/turf/open/floor/wood,
/area/crew_quarters/bar)
"fH" = (
/obj/machinery/newscaster{
	pixel_y = -28
	},
/turf/open/floor/eighties,
/area/crew_quarters/bar)
"hb" = (
/turf/open/floor/eighties,
/area/crew_quarters/bar)
"hY" = (
/obj/machinery/computer/arcade{
	dir = 4
	},
/obj/machinery/computer/security/telescreen/entertainment{
	pixel_x = -31
	},
/turf/open/floor/eighties,
/area/crew_quarters/bar)
"is" = (
/obj/machinery/atmospherics/pipe/simple/supply/hidden/layer2{
	dir = 4
	},
/turf/open/floor/wood,
/area/crew_quarters/bar)
"iF" = (
/obj/effect/turf_decal/siding/wood,
/turf/open/floor/wood,
/area/crew_quarters/bar)
"jv" = (
/obj/machinery/atmospherics/pipe/simple/supply/hidden/layer2,
/obj/machinery/atmospherics/pipe/simple/scrubbers/hidden/layer4,
/turf/open/floor/wood,
/area/crew_quarters/bar)
"kv" = (
/obj/machinery/light{
	dir = 1
	},
/obj/machinery/computer/security/telescreen/entertainment{
	pixel_y = 32
	},
/obj/structure/disposalpipe/segment{
	dir = 8
	},
/obj/machinery/button/door{
	id = "barshutters";
	name = "Bar Shutters Control";
	pixel_x = -25;
	pixel_y = 24;
	req_access_txt = "25"
	},
/turf/open/floor/wood,
/area/crew_quarters/bar)
"lE" = (
/obj/machinery/door/window/southright{
	name = "Bar Door";
	req_one_access_txt = "25;28"
	},
/turf/open/floor/wood,
/area/crew_quarters/bar)
"lJ" = (
/obj/machinery/holopad,
/turf/open/floor/wood,
/area/crew_quarters/bar)
"nA" = (
/obj/structure/chair{
	dir = 8
	},
/obj/structure/extinguisher_cabinet{
	pixel_y = -30
	},
/turf/open/floor/wood,
/area/crew_quarters/bar)
"oC" = (
/obj/structure/table,
/obj/item/reagent_containers/food/snacks/mint,
/obj/item/storage/box/donkpockets{
	pixel_x = 3;
	pixel_y = 3
	},
/turf/open/floor/plasteel/cafeteria,
/area/crew_quarters/kitchen)
"pw" = (
/obj/item/twohanded/required/kirbyplants/random,
/obj/item/radio/intercom{
	pixel_y = 28
	},
/turf/open/floor/wood,
/area/crew_quarters/bar)
"pF" = (
/obj/machinery/door/airlock/public/glass{
	name = "Diner"
	},
/obj/machinery/door/firedoor/border_only,
/obj/machinery/door/firedoor/border_only{
	dir = 1
	},
/obj/effect/turf_decal/siding/thinplating{
	dir = 1
	},
/turf/open/floor/plasteel,
/area/crew_quarters/bar)
"qi" = (
/obj/machinery/light_switch{
	pixel_y = 28
	},
/turf/open/floor/wood,
/area/crew_quarters/bar)
"qp" = (
/obj/machinery/computer/arcade{
	dir = 8
	},
/turf/open/floor/eighties,
/area/crew_quarters/bar)
"qQ" = (
/obj/structure/table/reinforced,
/obj/structure/window/reinforced{
	dir = 8
	},
/obj/structure/window/reinforced,
/obj/machinery/door/poddoor/shutters/preopen{
	id = "barshutters";
	name = "bar shutters"
	},
/turf/open/floor/wood,
/area/crew_quarters/bar)
"rb" = (
/obj/effect/turf_decal/siding/wood{
	dir = 8
	},
/obj/machinery/light,
/turf/open/floor/wood,
/area/crew_quarters/bar)
"sf" = (
/obj/structure/disposalpipe/trunk{
	dir = 8
	},
/obj/machinery/disposal/bin,
/obj/machinery/firealarm{
	dir = 2;
	pixel_y = 26
	},
/turf/open/floor/wood,
/area/crew_quarters/bar)
"tc" = (
/obj/structure/table/reinforced,
/obj/item/reagent_containers/food/snacks/pie/cream,
/obj/machinery/door/window/westright,
/obj/machinery/door/firedoor/border_only{
	dir = 4
	},
/obj/machinery/door/firedoor/border_only{
	dir = 8
	},
/turf/open/floor/plasteel/cafeteria,
/area/crew_quarters/kitchen)
"tg" = (
/obj/effect/spawner/xmastree,
/obj/effect/landmark/event_spawn,
/obj/machinery/atmospherics/pipe/simple/supply/hidden/layer2{
	dir = 4
	},
/obj/machinery/atmospherics/components/unary/vent_scrubber/on/layer4{
	dir = 8
	},
/turf/open/floor/wood,
/area/crew_quarters/bar)
"tl" = (
/obj/machinery/griddle,
/turf/open/floor/plasteel/cafeteria,
/area/crew_quarters/kitchen)
"uz" = (
/obj/machinery/computer/arcade{
	dir = 4
	},
/obj/machinery/airalarm{
	dir = 4;
	pixel_x = -24
	},
/obj/machinery/camera{
	c_tag = "Bar West";
	dir = 4
	},
/turf/open/floor/eighties,
/area/crew_quarters/bar)
"wF" = (
/obj/machinery/vending/snack/random,
/turf/open/floor/eighties,
/area/crew_quarters/bar)
"xf" = (
/obj/effect/turf_decal/siding/wood,
/obj/structure/table,
/obj/item/clothing/head/hardhat/cakehat,
/turf/open/floor/wood,
/area/crew_quarters/bar)
"xh" = (
/obj/structure/extinguisher_cabinet{
	pixel_y = -30
	},
/turf/open/floor/eighties,
/area/crew_quarters/bar)
"xZ" = (
/obj/structure/table/reinforced,
/obj/item/toy/cards/deck,
/obj/machinery/door/poddoor/shutters/preopen{
	id = "barshutters";
	name = "bar shutters"
	},
/turf/open/floor/wood,
/area/crew_quarters/bar)
"yg" = (
/obj/machinery/vending/cola/random,
/turf/open/floor/eighties,
/area/crew_quarters/bar)
"yM" = (
/obj/structure/noticeboard{
	dir = 1;
	pixel_y = -27
	},
/turf/open/floor/wood,
/area/crew_quarters/bar)
"Af" = (
/obj/structure/closet/secure_closet/freezer/meat,
/obj/item/toy/figure/chef,
/turf/open/floor/plasteel/showroomfloor,
/area/crew_quarters/kitchen)
"Ak" = (
/obj/machinery/light,
/obj/machinery/firealarm{
	dir = 1;
	pixel_y = -26
	},
/turf/open/floor/eighties,
/area/crew_quarters/bar)
"BB" = (
/obj/structure/table/reinforced,
/obj/machinery/door/poddoor/shutters/preopen{
	id = "kitchen";
	name = "kitchen shutters"
	},
/obj/machinery/door/firedoor/border_only{
	dir = 1
	},
/obj/machinery/door/firedoor/border_only,
/turf/open/floor/plasteel/cafeteria,
/area/crew_quarters/kitchen)
"CV" = (
/obj/structure/disposalpipe/segment,
/obj/machinery/door/firedoor/border_only,
/obj/machinery/door/firedoor/border_only{
	dir = 1
	},
/obj/machinery/door/airlock/maintenance{
	name = "Bar Maintenance";
	req_access_txt = "12"
	},
/turf/open/floor/plating,
/area/maintenance/starboard/fore)
"DE" = (
/obj/structure/table/reinforced,
/obj/item/book/manual/wiki/barman_recipes,
/obj/item/reagent_containers/glass/rag,
/obj/machinery/door/poddoor/shutters/preopen{
	id = "barshutters";
	name = "bar shutters"
	},
/turf/open/floor/wood,
/area/crew_quarters/bar)
"FY" = (
/obj/item/twohanded/required/kirbyplants/random,
/turf/open/floor/eighties,
/area/crew_quarters/bar)
"Go" = (
/obj/structure/sign/plaques/deempisi{
	pixel_x = -6;
	pixel_y = -8
	},
/turf/closed/wall,
/area/crew_quarters/bar)
"He" = (
/obj/structure/chair{
	dir = 4
	},
/turf/open/floor/wood,
/area/crew_quarters/bar)
"Hw" = (
/obj/item/reagent_containers/food/drinks/shaker,
/obj/structure/table/wood,
/obj/item/stack/spacecash/c10,
/obj/item/stack/spacecash/c100,
/obj/item/toy/figure/bartender,
/turf/open/floor/wood,
/area/crew_quarters/bar)
"HX" = (
/obj/structure/chair{
	dir = 1
	},
/obj/machinery/light{
	dir = 4
	},
/turf/open/floor/wood,
/area/crew_quarters/bar)
"IO" = (
/obj/effect/turf_decal/siding/wood,
/obj/machinery/vending/cola/random,
/turf/open/floor/wood,
/area/crew_quarters/bar)
"Ja" = (
/obj/effect/turf_decal/siding/wood{
	dir = 8
	},
/turf/open/floor/wood,
/area/crew_quarters/bar)
"JF" = (
/obj/effect/spawner/structure/window,
/obj/machinery/door/poddoor/preopen{
	id = "barshutters";
	name = "privacy shutters"
	},
/turf/open/floor/plating,
/area/crew_quarters/bar)
"JH" = (
/obj/structure/chair/stool/bar,
/turf/open/floor/wood,
/area/crew_quarters/bar)
"JQ" = (
/obj/structure/table/reinforced,
/obj/item/clothing/head/that,
/obj/machinery/door/poddoor/shutters/preopen{
	id = "barshutters";
	name = "bar shutters"
	},
/turf/open/floor/wood,
/area/crew_quarters/bar)
"Kc" = (
/obj/structure/table,
/obj/item/reagent_containers/glass/mixbowl{
	pixel_y = 5
	},
/obj/item/reagent_containers/food/condiment/enzyme{
	layer = 5
	},
/turf/open/floor/plasteel/cafeteria,
/area/crew_quarters/kitchen)
"MG" = (
/obj/machinery/vending/boozeomat,
/obj/machinery/light{
	dir = 4
	},
/obj/machinery/requests_console{
	department = "Bar";
	departmentType = 2;
	pixel_x = 30
	},
/turf/open/floor/wood,
/area/crew_quarters/bar)
"Nf" = (
/obj/structure/closet/secure_closet/bar{
	req_access_txt = "25"
	},
/obj/item/gun/ballistic/revolver/russian,
/turf/open/floor/wood,
/area/crew_quarters/bar)
"Ol" = (
/obj/structure/table,
/obj/machinery/requests_console{
	department = "Kitchen";
	departmentType = 2;
	pixel_x = 30
	},
/obj/machinery/reagentgrinder/kitchen{
	pixel_y = 6
	},
/turf/open/floor/plasteel/cafeteria,
/area/crew_quarters/kitchen)
"Ow" = (
/obj/effect/turf_decal/siding/wood/corner{
	dir = 8
	},
/turf/open/floor/wood,
/area/crew_quarters/bar)
"Pr" = (
/obj/machinery/atmospherics/pipe/simple/supply/hidden/layer2{
	dir = 4
	},
/obj/machinery/atmospherics/pipe/simple/scrubbers/hidden/layer4{
	dir = 4
	},
/obj/machinery/holopad,
/turf/open/floor/wood,
/area/crew_quarters/bar)
"Px" = (
/obj/structure/table/reinforced,
/obj/item/storage/box/fancy/donut_box,
/obj/machinery/door/poddoor/shutters/preopen{
	id = "kitchen";
	name = "kitchen shutters"
	},
/obj/machinery/door/firedoor/border_only{
	dir = 1
	},
/obj/machinery/door/firedoor/border_only,
/turf/open/floor/plasteel/cafeteria,
/area/crew_quarters/kitchen)
"PU" = (
/obj/structure/table,
/obj/machinery/light,
/obj/machinery/airalarm{
	dir = 1;
	icon_state = "alarm0";
	pixel_y = -24
	},
/obj/item/clothing/head/hardhat/cakehat,
/turf/open/floor/wood,
/area/crew_quarters/bar)
"PV" = (
/mob/living/carbon/monkey/punpun,
/obj/structure/disposalpipe/segment{
	dir = 9
	},
/turf/open/floor/wood,
/area/crew_quarters/bar)
"QH" = (
/obj/structure/table,
/obj/item/kitchen/rollingpin{
	pixel_x = 5;
	pixel_y = -3
	},
/obj/item/reagent_containers/food/condiment/peppermill{
	pixel_x = -3;
	pixel_y = 8
	},
/obj/item/reagent_containers/food/condiment/saltshaker{
	pixel_x = -8;
	pixel_y = 5
	},
/turf/open/floor/plasteel/cafeteria,
/area/crew_quarters/kitchen)
"QX" = (
/obj/structure/chair,
/obj/machinery/atmospherics/pipe/simple/supply/hidden/layer2{
	dir = 4
	},
/obj/machinery/atmospherics/pipe/simple/scrubbers/hidden/layer4{
	dir = 4
	},
/turf/open/floor/wood,
/area/crew_quarters/bar)
"RD" = (
/obj/effect/landmark/event_spawn,
/obj/item/radio/intercom{
	pixel_y = -32
	},
/turf/open/floor/wood,
/area/crew_quarters/bar)
"SI" = (
/obj/structure/table,
/obj/machinery/chem_dispenser/drinks/beer{
	dir = 8
	},
/obj/machinery/firealarm{
	dir = 8;
	pixel_x = 26
	},
/turf/open/floor/wood,
/area/crew_quarters/bar)
"ST" = (
/obj/structure/chair,
/obj/machinery/atmospherics/pipe/simple/supply/hidden/layer2{
	dir = 5
	},
/obj/machinery/atmospherics/pipe/simple/scrubbers/hidden/layer4{
	dir = 5
	},
/turf/open/floor/wood,
/area/crew_quarters/bar)
"UF" = (
/obj/structure/chair/stool/bar,
/obj/effect/landmark/start/assistant,
/turf/open/floor/wood,
/area/crew_quarters/bar)
"UI" = (
/obj/machinery/disposal/bin,
/obj/structure/window/reinforced{
	dir = 8
	},
/obj/structure/disposalpipe/trunk{
	dir = 4
	},
/obj/machinery/door/poddoor/shutters/preopen{
	id = "barshutters";
	name = "bar shutters"
	},
/turf/open/floor/wood,
/area/crew_quarters/bar)
"Wx" = (
/obj/machinery/door/airlock/public/glass{
	name = "Kitchen";
	req_access_txt = "28"
	},
/obj/machinery/door/firedoor/border_only{
	dir = 4
	},
/obj/machinery/door/firedoor/border_only{
	dir = 8
	},
/turf/open/floor/plasteel,
/area/crew_quarters/kitchen)
"WU" = (
/obj/effect/turf_decal/siding/wood,
/obj/structure/table,
/obj/item/reagent_containers/food/snacks/candy,
/obj/item/reagent_containers/food/drinks/soda_cans/sprited_cranberry{
	pixel_x = 5;
	pixel_y = 10
	},
/turf/open/floor/wood,
/area/crew_quarters/bar)
"Xl" = (
/obj/structure/table/reinforced,
/obj/item/lighter,
/obj/machinery/door/poddoor/shutters/preopen{
	id = "barshutters";
	name = "bar shutters"
	},
/turf/open/floor/wood,
/area/crew_quarters/bar)
"Xq" = (
/obj/machinery/computer/arcade{
	dir = 4
	},
/obj/machinery/light{
	dir = 8
	},
/turf/open/floor/eighties,
/area/crew_quarters/bar)
"Xt" = (
/obj/structure/table,
/obj/machinery/chem_dispenser/drinks{
	dir = 8
	},
/obj/machinery/camera{
	c_tag = "Bar";
	dir = 8
	},
/turf/open/floor/wood,
/area/crew_quarters/bar)
"Yn" = (
/obj/structure/disposalpipe/segment{
	dir = 5
	},
/turf/open/floor/wood,
/area/crew_quarters/bar)
"Zb" = (
/obj/machinery/vending/snack/random,
/obj/machinery/light{
	dir = 8
	},
/turf/open/floor/wood,
/area/crew_quarters/bar)
"ZM" = (
/obj/machinery/door/airlock{
	name = "Kitchen";
	req_access_txt = "28"
	},
/obj/machinery/door/firedoor/border_only{
	dir = 8
	},
/obj/machinery/door/firedoor/border_only{
	dir = 4
	},
/turf/open/floor/plasteel,
/area/crew_quarters/kitchen)
"ZQ" = (
/obj/structure/table,
/obj/item/instrument/piano_synth,
/turf/open/floor/wood,
/area/crew_quarters/bar)
"ZY" = (
/obj/machinery/smartfridge/drinks,
/obj/machinery/door/poddoor/preopen{
	id = "barshutters";
	name = "privacy shutters"
	},
/turf/open/floor/wood,
/area/crew_quarters/bar)

(1,1,1) = {"
aa
aa
ag
ag
ag
ag
bE
JF
ag
JF
ag
JF
ag
ag
"}
(2,1,1) = {"
aa
aa
Zb
IO
hY
eK
Xq
FY
uz
eK
Xq
yg
wF
ag
"}
(3,1,1) = {"
aa
aa
aB
iF
hb
hb
ar
hb
hb
hb
hb
hb
xh
ag
"}
(4,1,1) = {"
ac
qi
aB
iF
hb
hb
hb
hb
hb
hb
hb
hb
fH
ag
"}
(5,1,1) = {"
ab
jv
ST
xf
qp
qp
qp
hb
qp
qp
qp
hb
Ak
ag
"}
(6,1,1) = {"
ac
fy
QX
WU
eK
eK
eK
hb
eK
eK
eK
hb
hb
pF
"}
(7,1,1) = {"
ac
dL
Pr
iF
hb
hb
hb
hb
hb
hb
hb
hb
hb
JF
"}
(8,1,1) = {"
ac
pw
tg
iF
hb
hb
hb
hb
hb
hb
hb
hb
hb
pF
"}
(9,1,1) = {"
ag
aB
is
iF
qp
qp
qp
hb
qp
qp
qp
hb
hb
dh
"}
(10,1,1) = {"
CV
Yn
aJ
Ow
Ja
Ja
Ja
Ja
Ja
Ja
Ja
Ja
rb
ag
"}
(11,1,1) = {"
ag
sf
ZQ
HX
aB
lJ
aB
JH
JH
JH
JH
aB
RD
ag
"}
(12,1,1) = {"
ag
ag
ag
ag
Go
UI
qQ
xZ
JQ
Xl
dC
JH
yM
ag
"}
(13,1,1) = {"
Hw
ay
aE
Nf
ag
kv
aB
ef
aB
aB
DE
UF
He
ag
"}
(14,1,1) = {"
ae
ae
aG
aT
bo
PV
aB
aB
aB
aB
lE
aB
PU
ag
"}
(15,1,1) = {"
af
aB
aJ
bf
ag
SI
Xt
aB
MG
aB
ZY
aB
nA
ag
"}
(16,1,1) = {"
ag
aA
aK
ag
ag
al
al
Wx
al
tc
al
ZM
al
al
"}
(17,1,1) = {"
ak
cf
aR
ag
bp
al
bL
ce
ce
ce
ce
cP
al
aa
"}
(18,1,1) = {"
al
al
al
al
al
al
bM
ce
ce
ce
ce
cQ
al
aa
"}
(19,1,1) = {"
al
Af
aS
bg
bq
al
bN
bn
oC
tl
ce
ce
Px
aa
"}
(20,1,1) = {"
ai
an
an
aW
aZ
bc
be
br
Kc
dt
cI
ce
BB
aa
"}
(21,1,1) = {"
al
ap
aL
aX
ba
al
bh
bs
QH
cB
ce
cR
BB
aa
"}
(22,1,1) = {"
ao
aF
aU
bt
bt
al
bQ
by
ck
cB
ce
ce
BB
aa
"}
(23,1,1) = {"
al
al
al
aY
bu
al
bR
bD
cv
cv
cv
cS
al
aa
"}
(24,1,1) = {"
aa
aa
al
al
al
al
bS
ce
ce
cg
Ol
cT
al
aa
"}
