//MAP CONVERTED BY dmm2tgm.py THIS HEADER COMMENT PREVENTS RECONVERSION, DO NOT REMOVE
"aa" = (
/turf/template_noop,
/area/template_noop)
"ab" = (
/turf/closed/wall,
/area/crew_quarters/bar)
"ae" = (
/obj/effect/turf_decal/tile/bar,
/obj/effect/turf_decal/tile/bar{
	dir = 1
	},
/obj/structure/disposalpipe/segment{
	dir = 5
	},
/turf/open/floor/plasteel,
/area/crew_quarters/bar)
"ag" = (
/obj/structure/disposalpipe/segment,
/obj/machinery/atmospherics/pipe/simple/scrubbers/hidden/layer4,
/obj/machinery/atmospherics/pipe/simple/supply/hidden/layer2,
/turf/open/floor/wood,
/area/crew_quarters/bar)
"ah" = (
/obj/structure/sink/kitchen{
	pixel_y = 28
	},
/turf/open/floor/wood,
/area/crew_quarters/bar)
"ai" = (
/obj/machinery/door/window/southleft{
	base_state = "left";
	dir = 2;
	icon_state = "left";
	name = "Bar Delivery";
	req_access_txt = "25"
	},
/obj/effect/turf_decal/delivery,
/turf/open/floor/plasteel,
/area/crew_quarters/bar)
"aj" = (
/turf/closed/wall,
/area/crew_quarters/kitchen)
"ak" = (
/obj/machinery/door/airlock/maintenance{
	name = "Kitchen Maintenance";
	req_access_txt = "28"
	},
/obj/structure/disposalpipe/segment,
/obj/machinery/atmospherics/pipe/simple/supply/hidden/layer2,
/obj/machinery/atmospherics/pipe/simple/scrubbers/hidden/layer4,
/obj/machinery/door/firedoor/border_only,
/obj/machinery/door/firedoor/border_only{
	dir = 1
	},
/turf/open/floor/plating,
/area/maintenance/starboard/fore)
"al" = (
/obj/structure/disposalpipe/segment,
/obj/machinery/atmospherics/pipe/simple/supply/hidden/layer2,
/obj/machinery/atmospherics/pipe/simple/scrubbers/hidden/layer4,
/turf/open/floor/plasteel/showroomfloor,
/area/crew_quarters/kitchen)
"am" = (
/obj/machinery/navbeacon{
	codes_txt = "delivery;dir=2";
	freq = 1400;
	location = "Kitchen"
	},
/obj/structure/plasticflaps{
	opacity = 1
	},
/obj/effect/turf_decal/bot{
	dir = 2
	},
/turf/open/floor/plasteel{
	dir = 2
	},
/area/crew_quarters/kitchen)
"an" = (
/turf/closed/wall,
/area/crew_quarters/theatre)
"ao" = (
/obj/machinery/reagentgrinder,
/obj/structure/table/wood,
/turf/open/floor/wood,
/area/crew_quarters/bar)
"ap" = (
/obj/machinery/door/airlock{
	name = "Theatre Backstage";
	req_access_txt = "46"
	},
/obj/machinery/atmospherics/pipe/simple/supply/hidden/layer2,
/obj/machinery/atmospherics/pipe/simple/scrubbers/hidden/layer4,
/obj/machinery/door/firedoor/border_only,
/obj/machinery/door/firedoor/border_only{
	dir = 1
	},
/turf/open/floor/plasteel,
/area/crew_quarters/theatre)
"aq" = (
/obj/machinery/light_switch{
	pixel_y = 28
	},
/obj/machinery/light{
	dir = 1
	},
/turf/open/floor/wood,
/area/crew_quarters/theatre)
"ar" = (
/obj/machinery/camera{
	c_tag = "Bar Storage"
	},
/turf/open/floor/wood,
/area/crew_quarters/bar)
"as" = (
/obj/machinery/airalarm{
	dir = 4;
	pixel_x = -24
	},
/obj/machinery/light/small{
	dir = 8
	},
/obj/structure/reagent_dispensers/beerkeg,
/obj/machinery/atmospherics/components/unary/vent_scrubber/on/layer4{
	dir = 4;
	icon_state = "scrub_map_on-3"
	},
/turf/open/floor/wood,
/area/crew_quarters/bar)
"at" = (
/obj/machinery/disposal/bin,
/obj/structure/disposalpipe/trunk{
	dir = 8
	},
/obj/effect/turf_decal/tile/bar,
/obj/effect/turf_decal/tile/bar{
	dir = 1
	},
/obj/machinery/firealarm{
	dir = 2;
	pixel_y = 26
	},
/turf/open/floor/plasteel,
/area/crew_quarters/bar)
"au" = (
/obj/structure/disposalpipe/segment,
/obj/effect/landmark/xeno_spawn,
/obj/machinery/atmospherics/pipe/simple/scrubbers/hidden/layer4{
	dir = 9
	},
/obj/machinery/atmospherics/pipe/simple/supply/hidden/layer2{
	dir = 5
	},
/turf/open/floor/wood,
/area/crew_quarters/bar)
"av" = (
/obj/machinery/vending/wardrobe/bar_wardrobe,
/turf/open/floor/wood,
/area/crew_quarters/bar)
"aw" = (
/obj/machinery/vending/coffee,
/turf/open/floor/wood,
/area/crew_quarters/bar)
"ay" = (
/obj/machinery/camera{
	c_tag = "Kitchen Cold Room"
	},
/obj/structure/reagent_dispensers/cooking_oil,
/turf/open/floor/plasteel/showroomfloor,
/area/crew_quarters/kitchen)
"az" = (
/obj/machinery/chem_master/condimaster{
	name = "CondiMaster Neo"
	},
/turf/open/floor/plasteel/showroomfloor,
/area/crew_quarters/kitchen)
"aA" = (
/obj/machinery/door/window/southleft{
	base_state = "left";
	dir = 2;
	icon_state = "left";
	name = "Kitchen Delivery";
	req_access_txt = "28"
	},
/obj/effect/turf_decal/delivery,
/obj/structure/window/reinforced{
	dir = 8
	},
/turf/open/floor/plasteel,
/area/crew_quarters/kitchen)
"aB" = (
/obj/machinery/atmospherics/pipe/simple/supply/hidden/layer2,
/obj/machinery/atmospherics/pipe/simple/scrubbers/hidden/layer4,
/turf/open/floor/wood,
/area/crew_quarters/theatre)
"aC" = (
/obj/machinery/airalarm{
	dir = 2;
	pixel_y = 24
	},
/turf/open/floor/wood,
/area/crew_quarters/theatre)
"aD" = (
/obj/structure/closet/secure_closet/bar{
	req_access_txt = "25"
	},
/turf/open/floor/wood,
/area/crew_quarters/bar)
"aE" = (
/obj/structure/disposalpipe/segment,
/turf/open/floor/wood,
/area/crew_quarters/bar)
"aF" = (
/obj/item/radio/intercom{
	pixel_y = 25
	},
/obj/machinery/camera{
	c_tag = "Theatre Stage";
	dir = 2
	},
/turf/open/floor/wood,
/area/crew_quarters/theatre)
"aG" = (
/obj/item/stack/sheet/metal/fifty,
/obj/item/stack/sheet/glass/fifty,
/obj/item/stack/cable_coil,
/obj/item/flashlight/lamp,
/obj/item/flashlight/lamp/green,
/obj/structure/closet/secure_closet/bartender,
/turf/open/floor/wood,
/area/crew_quarters/bar)
"aH" = (
/obj/machinery/door/airlock{
	name = "Bar Storage";
	req_access_txt = "25"
	},
/obj/structure/disposalpipe/segment,
/obj/machinery/door/firedoor/border_only,
/obj/machinery/door/firedoor/border_only{
	dir = 1
	},
/turf/open/floor/plasteel{
	icon_state = "wood"
	},
/area/crew_quarters/bar)
"aI" = (
/obj/effect/landmark/blobstart,
/obj/item/toy/beach_ball/holoball,
/turf/open/floor/plating,
/area/crew_quarters/bar)
"aJ" = (
/obj/structure/disposalpipe/segment,
/obj/machinery/atmospherics/pipe/simple/supply/hidden/layer2,
/obj/machinery/atmospherics/pipe/manifold/scrubbers/hidden/layer4{
	dir = 8
	},
/turf/open/floor/plasteel/showroomfloor,
/area/crew_quarters/kitchen)
"aK" = (
/obj/machinery/icecream_vat,
/turf/open/floor/plasteel/showroomfloor,
/area/crew_quarters/kitchen)
"aL" = (
/obj/machinery/atmospherics/components/unary/vent_scrubber/on/layer4{
	dir = 8;
	icon_state = "scrub_map_on-3"
	},
/obj/effect/spawner/lootdrop/mob/kitchen_animal,
/turf/open/floor/plasteel/showroomfloor,
/area/crew_quarters/kitchen)
"aM" = (
/obj/effect/turf_decal/loading_area,
/turf/open/floor/plasteel/showroomfloor,
/area/crew_quarters/kitchen)
"aN" = (
/obj/structure/window/reinforced{
	dir = 4
	},
/obj/machinery/door/firedoor/border_only{
	dir = 4
	},
/turf/open/floor/wood,
/area/crew_quarters/theatre)
"aO" = (
/obj/structure/musician/piano{
	icon_state = "piano"
	},
/turf/open/floor/wood,
/area/crew_quarters/theatre)
"aP" = (
/obj/structure/chair/stool{
	pixel_y = 8
	},
/turf/open/floor/wood,
/area/crew_quarters/theatre)
"aQ" = (
/obj/machinery/light/small{
	dir = 4
	},
/obj/machinery/airalarm{
	dir = 8;
	pixel_x = 24
	},
/obj/machinery/vending/wardrobe/chef_wardrobe,
/turf/open/floor/plasteel/showroomfloor,
/area/crew_quarters/kitchen)
"aR" = (
/obj/structure/disposalpipe/segment,
/obj/machinery/atmospherics/pipe/simple/scrubbers/hidden/layer4,
/obj/machinery/atmospherics/pipe/manifold/supply/hidden/layer2{
	dir = 8
	},
/turf/open/floor/plasteel/showroomfloor,
/area/crew_quarters/kitchen)
"aS" = (
/obj/machinery/light/small{
	dir = 4
	},
/obj/effect/turf_decal/tile/bar,
/obj/effect/turf_decal/tile/bar{
	dir = 1
	},
/turf/open/floor/plasteel,
/area/crew_quarters/bar)
"aT" = (
/obj/machinery/atmospherics/components/unary/vent_pump/on/layer2{
	dir = 8;
	icon_state = "vent_map_on-1"
	},
/turf/open/floor/plasteel/showroomfloor,
/area/crew_quarters/kitchen)
"aU" = (
/obj/machinery/door/airlock{
	name = "Kitchen cold room";
	req_access_txt = "28"
	},
/obj/structure/disposalpipe/segment,
/obj/machinery/atmospherics/pipe/simple/supply/hidden/layer2,
/obj/machinery/atmospherics/pipe/simple/scrubbers/hidden/layer4,
/obj/machinery/door/firedoor/border_only,
/obj/machinery/door/firedoor/border_only{
	dir = 1
	},
/turf/open/floor/plasteel/showroomfloor,
/area/crew_quarters/kitchen)
"aV" = (
/obj/structure/disposalpipe/segment,
/obj/machinery/atmospherics/pipe/simple/supply/hidden/layer2,
/obj/machinery/atmospherics/pipe/simple/scrubbers/hidden/layer4,
/turf/open/floor/plasteel/cafeteria,
/area/crew_quarters/kitchen)
"aW" = (
/obj/structure/kitchenspike,
/obj/machinery/light/small{
	dir = 8
	},
/turf/open/floor/plasteel/showroomfloor,
/area/crew_quarters/kitchen)
"aX" = (
/obj/item/radio/intercom{
	pixel_y = 25
	},
/obj/machinery/camera{
	c_tag = "Kitchen";
	dir = 2
	},
/obj/structure/closet/secure_closet/freezer/fridge,
/turf/open/floor/plasteel/cafeteria,
/area/crew_quarters/kitchen)
"aY" = (
/obj/effect/landmark/start/cook,
/obj/machinery/atmospherics/components/unary/vent_scrubber/on/layer4{
	dir = 4;
	icon_state = "scrub_map_on-3"
	},
/turf/open/floor/plasteel/cafeteria,
/area/crew_quarters/kitchen)
"aZ" = (
/obj/structure/disposalpipe/segment{
	dir = 5
	},
/obj/machinery/atmospherics/pipe/simple/supply/hidden/layer2{
	dir = 5
	},
/obj/machinery/atmospherics/pipe/simple/scrubbers/hidden/layer4{
	dir = 9
	},
/turf/open/floor/plasteel/cafeteria,
/area/crew_quarters/kitchen)
"ba" = (
/obj/effect/turf_decal/tile/bar,
/obj/effect/turf_decal/tile/bar{
	dir = 1
	},
/turf/open/floor/plasteel,
/area/crew_quarters/bar)
"bb" = (
/obj/structure/disposalpipe/segment{
	dir = 4
	},
/obj/machinery/atmospherics/components/unary/vent_pump/on/layer2{
	dir = 8;
	icon_state = "vent_map_on-1"
	},
/turf/open/floor/plasteel/cafeteria,
/area/crew_quarters/kitchen)
"bc" = (
/obj/structure/disposalpipe/segment{
	dir = 4
	},
/turf/open/floor/plasteel/cafeteria,
/area/crew_quarters/kitchen)
"bd" = (
/obj/structure/kitchenspike,
/turf/open/floor/plasteel/showroomfloor,
/area/crew_quarters/kitchen)
"be" = (
/obj/structure/disposalpipe/segment{
	dir = 10
	},
/turf/open/floor/plasteel/cafeteria,
/area/crew_quarters/kitchen)
"bg" = (
/turf/open/floor/plasteel/showroomfloor,
/area/crew_quarters/kitchen)
"bh" = (
/obj/machinery/gibber,
/turf/open/floor/plasteel/showroomfloor,
/area/crew_quarters/kitchen)
"bi" = (
/obj/machinery/computer/security/telescreen/entertainment{
	pixel_x = -31
	},
/obj/effect/turf_decal/tile/bar,
/obj/effect/turf_decal/tile/bar{
	dir = 1
	},
/turf/open/floor/plasteel,
/area/crew_quarters/bar)
"bj" = (
/turf/open/floor/plasteel/cafeteria,
/area/crew_quarters/bar)
"bm" = (
/obj/effect/landmark/event_spawn,
/turf/closed/wall,
/area/crew_quarters/bar)
"bn" = (
/obj/machinery/light{
	dir = 8
	},
/obj/effect/turf_decal/tile/bar,
/obj/effect/turf_decal/tile/bar{
	dir = 1
	},
/turf/open/floor/plasteel,
/area/crew_quarters/bar)
"bo" = (
/obj/machinery/vending/dinnerware,
/turf/open/floor/plasteel/cafeteria,
/area/crew_quarters/kitchen)
"bp" = (
/obj/structure/sink/kitchen{
	pixel_y = 28
	},
/obj/machinery/food_cart,
/turf/open/floor/plasteel/cafeteria,
/area/crew_quarters/kitchen)
"bq" = (
/obj/structure/extinguisher_cabinet{
	pixel_x = -5;
	pixel_y = 30
	},
/turf/open/floor/plasteel/cafeteria,
/area/crew_quarters/kitchen)
"br" = (
/obj/machinery/light/small{
	dir = 4
	},
/turf/open/floor/wood,
/area/crew_quarters/bar)
"bs" = (
/obj/structure/table,
/obj/machinery/chem_dispenser/drinks/beer{
	dir = 8
	},
/obj/item/radio/intercom{
	pixel_y = 25
	},
/obj/machinery/camera{
	c_tag = "Bar";
	dir = 8
	},
/obj/machinery/firealarm{
	dir = 8;
	pixel_x = 26
	},
/turf/open/floor/plasteel/cafeteria,
/area/crew_quarters/bar)
"bt" = (
/obj/structure/table,
/obj/machinery/microwave{
	pixel_x = -3;
	pixel_y = 6
	},
/obj/machinery/airalarm{
	pixel_y = 24
	},
/obj/machinery/light{
	dir = 1
	},
/turf/open/floor/plasteel/cafeteria,
/area/crew_quarters/kitchen)
"bu" = (
/obj/structure/table,
/obj/machinery/microwave{
	pixel_x = -3;
	pixel_y = 6
	},
/turf/open/floor/plasteel/cafeteria,
/area/crew_quarters/kitchen)
"bv" = (
/obj/structure/closet/secure_closet/freezer/kitchen,
/turf/open/floor/plasteel/cafeteria,
/area/crew_quarters/kitchen)
"bx" = (
/obj/structure/disposalpipe/segment{
	dir = 9
	},
/turf/open/floor/plasteel/cafeteria,
/area/crew_quarters/bar)
"bA" = (
/obj/machinery/processor,
/obj/machinery/firealarm{
	dir = 8;
	pixel_x = 26
	},
/turf/open/floor/plasteel/cafeteria,
/area/crew_quarters/kitchen)
"bB" = (
/obj/machinery/light,
/obj/effect/turf_decal/tile/bar,
/obj/effect/turf_decal/tile/bar{
	dir = 1
	},
/obj/machinery/firealarm{
	dir = 1;
	pixel_y = -26
	},
/turf/open/floor/plasteel,
/area/crew_quarters/bar)
"bC" = (
/turf/open/floor/plasteel/cafeteria,
/area/crew_quarters/kitchen)
"bD" = (
/obj/machinery/vending/boozeomat,
/obj/machinery/requests_console{
	department = "Bar";
	departmentType = 2;
	pixel_x = 30;
	receive_ore_updates = 1
	},
/obj/machinery/light{
	dir = 4
	},
/turf/open/floor/plasteel/cafeteria,
/area/crew_quarters/bar)
"bE" = (
/obj/effect/turf_decal/tile/bar,
/obj/effect/turf_decal/tile/bar{
	dir = 1
	},
/obj/structure/noticeboard{
	dir = 1;
	pixel_y = -27
	},
/turf/open/floor/plasteel,
/area/crew_quarters/bar)
"bJ" = (
/obj/machinery/airalarm{
	dir = 4;
	pixel_x = -24
	},
/obj/machinery/camera{
	c_tag = "Bar West";
	dir = 4
	},
/obj/effect/turf_decal/tile/bar,
/obj/effect/turf_decal/tile/bar{
	dir = 1
	},
/turf/open/floor/plasteel,
/area/crew_quarters/bar)
"bP" = (
/obj/structure/disposalpipe/segment,
/turf/open/floor/plasteel/cafeteria,
/area/crew_quarters/kitchen)
"bQ" = (
/mob/living/carbon/monkey/punpun,
/turf/open/floor/plasteel/cafeteria,
/area/crew_quarters/bar)
"bU" = (
/obj/machinery/deepfryer,
/turf/open/floor/plasteel/cafeteria,
/area/crew_quarters/kitchen)
"bW" = (
/obj/machinery/light{
	dir = 8
	},
/obj/machinery/computer/security/telescreen/entertainment{
	pixel_x = -31
	},
/obj/effect/turf_decal/tile/bar,
/obj/effect/turf_decal/tile/bar{
	dir = 1
	},
/turf/open/floor/plasteel,
/area/crew_quarters/bar)
"bX" = (
/obj/effect/landmark/start/cook,
/turf/open/floor/plasteel/cafeteria,
/area/crew_quarters/kitchen)
"bZ" = (
/obj/machinery/atmospherics/components/unary/vent_scrubber/on/layer4{
	dir = 4;
	icon_state = "scrub_map_on-3"
	},
/turf/open/floor/wood,
/area/crew_quarters/theatre)
"ca" = (
/obj/machinery/atmospherics/pipe/simple/supply/hidden/layer2{
	dir = 5
	},
/obj/machinery/atmospherics/pipe/simple/scrubbers/hidden/layer4{
	dir = 9
	},
/turf/open/floor/wood,
/area/crew_quarters/theatre)
"cb" = (
/obj/machinery/door/airlock{
	name = "Kitchen";
	req_access_txt = "28"
	},
/obj/effect/turf_decal/tile/bar,
/obj/effect/turf_decal/tile/bar{
	dir = 1
	},
/obj/machinery/door/firedoor/border_only{
	dir = 4
	},
/obj/machinery/door/firedoor/border_only{
	dir = 8
	},
/turf/open/floor/plasteel,
/area/crew_quarters/kitchen)
"cc" = (
/obj/machinery/light_switch{
	pixel_y = -25
	},
/turf/open/floor/plasteel/cafeteria,
/area/crew_quarters/kitchen)
"cd" = (
/obj/machinery/light,
/turf/open/floor/plasteel/cafeteria,
/area/crew_quarters/kitchen)
"ce" = (
/obj/effect/landmark/event_spawn,
/turf/open/floor/plasteel/cafeteria,
/area/crew_quarters/kitchen)
"cf" = (
/obj/structure/disposalpipe/segment{
	dir = 5
	},
/obj/machinery/button/door{
	id = "kitchen";
	name = "Kitchen Shutters Control";
	pixel_x = -1;
	pixel_y = -24;
	req_access_txt = "28"
	},
/turf/open/floor/plasteel/cafeteria,
/area/crew_quarters/kitchen)
"cg" = (
/obj/machinery/disposal/bin,
/obj/structure/disposalpipe/trunk{
	dir = 8
	},
/turf/open/floor/plasteel/cafeteria,
/area/crew_quarters/kitchen)
"ch" = (
/obj/machinery/computer/arcade,
/obj/effect/turf_decal/tile/bar,
/obj/effect/turf_decal/tile/bar{
	dir = 1
	},
/turf/open/floor/plasteel,
/area/crew_quarters/bar)
"ci" = (
/obj/machinery/vending/cigarette,
/obj/effect/turf_decal/tile/bar,
/obj/effect/turf_decal/tile/bar{
	dir = 1
	},
/turf/open/floor/plasteel,
/area/crew_quarters/bar)
"cj" = (
/obj/machinery/newscaster{
	pixel_y = -28
	},
/obj/effect/turf_decal/tile/bar,
/obj/effect/turf_decal/tile/bar{
	dir = 1
	},
/obj/item/twohanded/required/kirbyplants/random,
/turf/open/floor/plasteel,
/area/crew_quarters/bar)
"cl" = (
/obj/machinery/light,
/obj/effect/turf_decal/tile/bar,
/obj/effect/turf_decal/tile/bar{
	dir = 1
	},
/turf/open/floor/plasteel,
/area/crew_quarters/bar)
"cm" = (
/obj/machinery/camera{
	c_tag = "Bar South";
	dir = 1
	},
/obj/effect/turf_decal/tile/bar,
/obj/effect/turf_decal/tile/bar{
	dir = 1
	},
/turf/open/floor/plasteel,
/area/crew_quarters/bar)
"co" = (
/obj/structure/extinguisher_cabinet{
	pixel_y = -30
	},
/obj/effect/turf_decal/tile/bar,
/obj/effect/turf_decal/tile/bar{
	dir = 1
	},
/turf/open/floor/plasteel,
/area/crew_quarters/bar)
"cp" = (
/obj/machinery/airalarm{
	dir = 1;
	pixel_y = -24
	},
/obj/effect/turf_decal/tile/bar,
/obj/effect/turf_decal/tile/bar{
	dir = 1
	},
/turf/open/floor/plasteel,
/area/crew_quarters/bar)
"cq" = (
/obj/machinery/light/small,
/obj/effect/turf_decal/tile/bar,
/obj/effect/turf_decal/tile/bar{
	dir = 1
	},
/turf/open/floor/plasteel,
/area/crew_quarters/bar)
"ct" = (
/obj/machinery/door/airlock/public/glass{
	name = "Diner"
	},
/obj/machinery/door/firedoor/border_only,
/obj/machinery/door/firedoor/border_only{
	dir = 1
	},
/turf/open/floor/plasteel,
/area/crew_quarters/bar)
"cu" = (
/obj/structure/sign/barsign,
/turf/closed/wall,
/area/crew_quarters/bar)
"cz" = (
/obj/machinery/door/window/southright{
	name = "Bar Door";
	req_one_access_txt = "25;28"
	},
/turf/open/floor/plasteel/cafeteria,
/area/crew_quarters/bar)
"cC" = (
/obj/effect/spawner/xmastree,
/obj/effect/turf_decal/tile/bar,
/obj/effect/turf_decal/tile/bar{
	dir = 1
	},
/turf/open/floor/plasteel,
/area/crew_quarters/bar)
"cE" = (
/obj/effect/landmark/start/bartender,
/turf/open/floor/plasteel/cafeteria,
/area/crew_quarters/bar)
"cG" = (
/obj/machinery/atmospherics/components/unary/vent_pump/on/layer2{
	dir = 8;
	icon_state = "vent_map_on-1"
	},
/turf/open/floor/wood,
/area/crew_quarters/theatre)
"cH" = (
/turf/open/floor/wood,
/area/crew_quarters/bar)
"cI" = (
/obj/structure/chair/stool/bar,
/obj/effect/turf_decal/tile/bar,
/obj/effect/turf_decal/tile/bar{
	dir = 1
	},
/turf/open/floor/plasteel,
/area/crew_quarters/bar)
"cM" = (
/obj/effect/landmark/event_spawn,
/obj/structure/chair/stool/bar,
/obj/effect/turf_decal/tile/bar,
/obj/effect/turf_decal/tile/bar{
	dir = 1
	},
/turf/open/floor/plasteel,
/area/crew_quarters/bar)
"cO" = (
/obj/structure/table/wood,
/obj/item/instrument/guitar{
	pixel_x = -7
	},
/obj/item/instrument/eguitar{
	pixel_x = 5
	},
/turf/open/floor/wood,
/area/crew_quarters/theatre)
"cP" = (
/mob/living/simple_animal/bot/honkbot,
/turf/open/floor/wood,
/area/crew_quarters/theatre)
"cQ" = (
/obj/effect/landmark/event_spawn,
/turf/open/floor/wood,
/area/crew_quarters/theatre)
"cR" = (
/obj/machinery/door/window{
	dir = 4;
	name = "Theatre Stage"
	},
/obj/machinery/door/firedoor/border_only{
	dir = 4
	},
/turf/open/floor/wood,
/area/crew_quarters/theatre)
"cS" = (
/obj/structure/window/reinforced,
/obj/structure/table/wood,
/obj/item/instrument/violin,
/obj/machinery/door/firedoor/border_only,
/turf/open/floor/wood,
/area/crew_quarters/theatre)
"cT" = (
/obj/structure/window/reinforced,
/obj/machinery/door/firedoor/border_only,
/turf/open/floor/wood,
/area/crew_quarters/theatre)
"cU" = (
/obj/structure/window/reinforced,
/obj/structure/window/reinforced{
	dir = 4
	},
/obj/machinery/door/firedoor/border_only{
	dir = 4
	},
/obj/machinery/door/firedoor/border_only,
/turf/open/floor/wood,
/area/crew_quarters/theatre)
"dn" = (
/obj/machinery/disposal/bin,
/obj/structure/disposalpipe/trunk{
	dir = 4
	},
/obj/structure/window/reinforced{
	dir = 8
	},
/obj/machinery/door/poddoor/shutters/preopen{
	id = "barshutters";
	name = "bar shutters"
	},
/turf/open/floor/plasteel/cafeteria,
/area/crew_quarters/bar)
"et" = (
/obj/structure/table/reinforced,
/obj/machinery/door/poddoor/shutters/preopen{
	id = "kitchen";
	name = "kitchen shutters"
	},
/obj/machinery/door/firedoor/border_only,
/obj/machinery/door/firedoor/border_only{
	dir = 1
	},
/turf/open/floor/plasteel/cafeteria,
/area/crew_quarters/kitchen)
"gP" = (
/obj/effect/turf_decal/tile/bar,
/obj/effect/turf_decal/tile/bar{
	dir = 1
	},
/obj/machinery/holopad,
/turf/open/floor/plasteel,
/area/crew_quarters/bar)
"jY" = (
/obj/machinery/oven,
/turf/open/floor/plasteel/cafeteria,
/area/crew_quarters/kitchen)
"lI" = (
/obj/structure/chair/stool/bar,
/obj/effect/turf_decal/tile/bar,
/obj/effect/turf_decal/tile/bar{
	dir = 1
	},
/obj/effect/landmark/start/assistant,
/turf/open/floor/plasteel,
/area/crew_quarters/bar)
"lR" = (
/obj/effect/spawner/structure/window,
/obj/machinery/door/poddoor/preopen{
	id = "barshutters";
	name = "privacy shutters"
	},
/turf/open/floor/plating,
/area/crew_quarters/bar)
"nP" = (
/obj/structure/table,
/obj/item/kitchen/rollingpin{
	pixel_x = 5;
	pixel_y = -1
	},
/obj/item/reagent_containers/food/condiment/peppermill{
	pixel_x = -2;
	pixel_y = 8
	},
/turf/open/floor/plasteel/cafeteria,
/area/crew_quarters/kitchen)
"qv" = (
/obj/structure/table/reinforced,
/obj/machinery/door/poddoor/shutters/preopen{
	id = "barshutters";
	name = "bar shutters"
	},
/turf/open/floor/plasteel/cafeteria,
/area/crew_quarters/bar)
"qE" = (
/obj/structure/disposalpipe/segment{
	dir = 4
	},
/obj/machinery/button/door{
	id = "barshutters";
	name = "Bar Shutters Control";
	pixel_y = 24;
	req_access_txt = "25"
	},
/turf/open/floor/plasteel/cafeteria,
/area/crew_quarters/bar)
"ti" = (
/obj/effect/landmark/event_spawn,
/obj/structure/table/reinforced,
/obj/machinery/door/poddoor/shutters/preopen{
	id = "barshutters";
	name = "bar shutters"
	},
/turf/open/floor/plasteel/cafeteria,
/area/crew_quarters/bar)
"vL" = (
/obj/machinery/smartfridge/drinks,
/obj/machinery/door/poddoor/preopen{
	id = "barshutters";
	name = "privacy shutters"
	},
/turf/open/floor/plasteel/cafeteria,
/area/crew_quarters/bar)
"xj" = (
/obj/machinery/holopad,
/obj/structure/table/reinforced,
/obj/machinery/door/poddoor/shutters/preopen{
	id = "barshutters";
	name = "bar shutters"
	},
/turf/open/floor/plasteel/cafeteria,
/area/crew_quarters/bar)
"yS" = (
/obj/item/reagent_containers/food/drinks/shaker,
/obj/structure/table/wood,
/obj/item/stack/spacecash/c10,
/obj/item/stack/spacecash/c100,
/obj/item/toy/figure/bartender,
/turf/open/floor/wood,
/area/crew_quarters/bar)
"Eu" = (
/obj/structure/sign/plaques/deempisi,
/turf/closed/wall,
/area/crew_quarters/bar)
"EC" = (
/obj/structure/table,
/obj/machinery/requests_console{
	department = "Kitchen";
	departmentType = 2;
	pixel_x = 30
	},
/obj/machinery/reagentgrinder/kitchen{
	pixel_y = 6
	},
/turf/open/floor/plasteel/cafeteria,
/area/crew_quarters/kitchen)
"Ft" = (
/obj/structure/table/reinforced,
/obj/item/clothing/head/hardhat/cakehat,
/obj/machinery/door/poddoor/shutters/preopen{
	id = "barshutters";
	name = "bar shutters"
	},
/turf/open/floor/plasteel/cafeteria,
/area/crew_quarters/bar)
"FR" = (
/obj/structure/table/reinforced,
/obj/item/storage/box/fancy/donut_box,
/obj/machinery/door/poddoor/shutters/preopen{
	id = "kitchen";
	name = "kitchen shutters"
	},
/obj/machinery/door/firedoor/border_only,
/obj/machinery/door/firedoor/border_only{
	dir = 1
	},
/turf/open/floor/plasteel/cafeteria,
/area/crew_quarters/kitchen)
"Ij" = (
/obj/machinery/chem_dispenser/drinks,
/obj/structure/table/reinforced,
/obj/machinery/door/poddoor/shutters/preopen{
	id = "barshutters";
	name = "bar shutters"
	},
/turf/open/floor/plasteel/cafeteria,
/area/crew_quarters/bar)
"Ky" = (
/obj/structure/table,
/obj/item/reagent_containers/food/condiment/saltshaker{
	pixel_x = 23;
	pixel_y = 4
	},
/obj/item/reagent_containers/glass/mixbowl{
	pixel_x = 1;
	pixel_y = 4
	},
/obj/item/reagent_containers/food/condiment/enzyme{
	layer = 5
	},
/turf/open/floor/plasteel/cafeteria,
/area/crew_quarters/kitchen)
"Lp" = (
/turf/open/floor/wood,
/area/crew_quarters/theatre)
"MB" = (
/obj/structure/table/reinforced,
/obj/machinery/door/poddoor/shutters/preopen{
	id = "kitchen";
	name = "kitchen shutters"
	},
/obj/machinery/door/window/westright,
/obj/machinery/door/firedoor/border_only{
	dir = 4
	},
/obj/machinery/door/firedoor/border_only{
	dir = 8
	},
/turf/open/floor/plasteel/cafeteria,
/area/crew_quarters/kitchen)
"PW" = (
/obj/structure/table/reinforced,
/obj/structure/window/reinforced{
	dir = 8
	},
/obj/item/book/manual/wiki/barman_recipes,
/obj/item/reagent_containers/glass/rag,
/obj/machinery/door/poddoor/shutters/preopen{
	id = "barshutters";
	name = "bar shutters"
	},
/turf/open/floor/plasteel/cafeteria,
/area/crew_quarters/bar)
"Rx" = (
/obj/structure/disposalpipe/segment,
/obj/machinery/door/firedoor/border_only,
/obj/machinery/door/firedoor/border_only{
	dir = 1
	},
/obj/machinery/door/airlock/maintenance{
	name = "Bar Maintenance";
	req_access_txt = "12"
	},
/turf/open/floor/plating,
/area/maintenance/starboard/fore)
"RM" = (
/obj/structure/table,
/obj/item/book/manual/chef_recipes,
/obj/item/stack/packageWrap,
/turf/open/floor/plasteel/cafeteria,
/area/crew_quarters/kitchen)
"Sp" = (
/obj/effect/turf_decal/tile/bar,
/obj/effect/turf_decal/tile/bar{
	dir = 1
	},
/obj/item/twohanded/required/kirbyplants/random,
/turf/open/floor/plasteel,
/area/crew_quarters/bar)
"Wu" = (
/obj/machinery/atmospherics/components/unary/vent_pump/on/layer2{
	dir = 8;
	icon_state = "vent_map_on-1"
	},
/turf/open/floor/wood,
/area/crew_quarters/bar)
"YV" = (
/obj/structure/closet/secure_closet/freezer/meat,
/obj/item/toy/figure/chef,
/turf/open/floor/plasteel/showroomfloor,
/area/crew_quarters/kitchen)
"Zs" = (
/obj/structure/table,
/obj/item/reagent_containers/food/snacks/mint,
/obj/item/storage/box/donkpockets{
	pixel_x = 3;
	pixel_y = 3
	},
/turf/open/floor/plasteel/cafeteria,
/area/crew_quarters/kitchen)
"ZD" = (
/obj/machinery/griddle,
/turf/open/floor/plasteel/cafeteria,
/area/crew_quarters/kitchen)

(1,1,1) = {"
aa
aa
an
an
an
ab
bm
lR
ab
lR
ab
lR
ab
ab
"}
(2,1,1) = {"
aa
aa
aO
cO
cS
bi
bn
ba
bJ
ba
bW
ba
ch
ab
"}
(3,1,1) = {"
aa
aa
aP
Lp
cT
ba
ba
ba
cC
gP
ba
ba
ci
ab
"}
(4,1,1) = {"
an
aq
bZ
Lp
cT
ba
ba
ba
ba
ba
ba
ba
cj
ab
"}
(5,1,1) = {"
ap
aB
ca
cP
cT
ba
ba
cI
lI
cI
cI
ba
bB
ab
"}
(6,1,1) = {"
an
aC
cG
cQ
cT
ba
cI
Ft
ti
xj
qv
cI
ba
ct
"}
(7,1,1) = {"
an
aF
Lp
Lp
cT
ba
cI
qv
bj
bj
qv
lI
ba
lR
"}
(8,1,1) = {"
an
aN
aN
cR
cU
ba
cI
qv
bj
bj
qv
cI
ba
ct
"}
(9,1,1) = {"
ab
Sp
ba
ba
ba
ba
cI
qv
bj
bj
qv
cI
cl
cu
"}
(10,1,1) = {"
Rx
ae
ba
ba
ba
ba
cI
qv
bj
bj
qv
lI
cm
ab
"}
(11,1,1) = {"
ab
at
ba
aS
ba
ba
cI
qv
bj
bj
qv
cI
bE
ab
"}
(12,1,1) = {"
ab
ab
ab
ab
Eu
dn
PW
Ij
cE
bj
qv
cI
co
ab
"}
(13,1,1) = {"
yS
ao
as
aD
ab
qE
bj
bj
bj
bj
qv
cM
cp
ab
"}
(14,1,1) = {"
ag
ag
au
aE
aH
bx
bj
bQ
bj
bj
cz
ba
cq
ab
"}
(15,1,1) = {"
ah
cH
Wu
aG
ab
bs
bD
bj
bj
bj
vL
ba
ba
ab
"}
(16,1,1) = {"
ab
ar
av
ab
ab
aj
aj
MB
MB
MB
aj
cb
aj
aj
"}
(17,1,1) = {"
ai
br
aw
ab
aI
aj
bo
bC
bC
bC
bC
cc
aj
aa
"}
(18,1,1) = {"
aj
aj
aj
aj
aj
aj
bp
bC
bC
bC
bC
cd
aj
aa
"}
(19,1,1) = {"
aj
YV
aK
aW
bd
aj
bq
aY
Zs
ZD
bC
bC
FR
aa
"}
(20,1,1) = {"
ak
al
al
aJ
aR
aU
aV
aZ
Ky
jY
bX
bC
et
aa
"}
(21,1,1) = {"
aj
ay
az
aL
aT
aj
aX
bb
nP
bU
bC
ce
et
aa
"}
(22,1,1) = {"
am
aA
aM
bg
bg
aj
bt
bc
RM
bU
bC
bC
et
aa
"}
(23,1,1) = {"
aj
aj
aj
aQ
bh
aj
bu
be
bP
bP
bP
cf
aj
aa
"}
(24,1,1) = {"
aa
aa
aj
aj
aj
aj
bv
bC
bC
bA
EC
cg
aj
aa
"}
