//MAP CONVERTED BY dmm2tgm.py THIS HEADER COMMENT PREVENTS RECONVERSION, DO NOT REMOVE
"aa" = (
/turf/template_noop,
/area/template_noop)
"ab" = (
/obj/machinery/door/airlock{
	name = "Theatre Backstage";
	req_access_txt = "46"
	},
/obj/machinery/atmospherics/pipe/simple/supply/hidden/layer2,
/obj/machinery/atmospherics/pipe/simple/scrubbers/hidden/layer4,
/obj/machinery/door/firedoor/border_only{
	dir = 1
	},
/obj/machinery/door/firedoor/border_only,
/turf/open/floor/plasteel,
/area/crew_quarters/theatre)
"ac" = (
/turf/closed/wall,
/area/crew_quarters/theatre)
"ag" = (
/turf/closed/wall,
/area/crew_quarters/bar)
"ai" = (
/obj/machinery/door/airlock/maintenance{
	name = "Kitchen Maintenance";
	req_access_txt = "28"
	},
/obj/structure/disposalpipe/segment,
/obj/machinery/atmospherics/pipe/simple/supply/hidden/layer2,
/obj/machinery/atmospherics/pipe/simple/scrubbers/hidden/layer4,
/obj/machinery/door/firedoor/border_only{
	dir = 1
	},
/obj/machinery/door/firedoor/border_only,
/turf/open/floor/plating,
/area/maintenance/starboard/fore)
"ak" = (
/obj/machinery/door/window/southleft{
	base_state = "left";
	dir = 2;
	icon_state = "left";
	name = "Bar Delivery";
	req_access_txt = "25"
	},
/obj/effect/turf_decal/delivery,
/turf/open/floor/plasteel,
/area/crew_quarters/bar)
"al" = (
/turf/closed/wall,
/area/crew_quarters/kitchen)
"an" = (
/obj/structure/disposalpipe/segment,
/obj/machinery/atmospherics/pipe/simple/supply/hidden/layer2,
/obj/machinery/atmospherics/pipe/simple/scrubbers/hidden/layer4,
/turf/open/floor/plasteel/showroomfloor,
/area/crew_quarters/kitchen)
"ao" = (
/obj/machinery/navbeacon{
	codes_txt = "delivery;dir=2";
	freq = 1400;
	location = "Kitchen"
	},
/obj/structure/plasticflaps{
	opacity = 1
	},
/obj/effect/turf_decal/bot{
	dir = 2
	},
/turf/open/floor/plasteel{
	dir = 2
	},
/area/crew_quarters/kitchen)
"ap" = (
/obj/machinery/camera{
	c_tag = "Kitchen Cold Room"
	},
/obj/structure/reagent_dispensers/cooking_oil,
/turf/open/floor/plasteel/showroomfloor,
/area/crew_quarters/kitchen)
"aF" = (
/obj/machinery/door/window/southleft{
	base_state = "left";
	dir = 2;
	icon_state = "left";
	name = "Kitchen Delivery";
	req_access_txt = "28"
	},
/obj/effect/turf_decal/delivery,
/obj/structure/window/reinforced{
	dir = 8
	},
/turf/open/floor/plasteel,
/area/crew_quarters/kitchen)
"aL" = (
/obj/machinery/chem_master/condimaster{
	name = "CondiMaster Neo"
	},
/turf/open/floor/plasteel/showroomfloor,
/area/crew_quarters/kitchen)
"aS" = (
/obj/machinery/icecream_vat,
/turf/open/floor/plasteel/showroomfloor,
/area/crew_quarters/kitchen)
"aU" = (
/obj/effect/turf_decal/loading_area,
/turf/open/floor/plasteel/showroomfloor,
/area/crew_quarters/kitchen)
"aW" = (
/obj/structure/disposalpipe/segment,
/obj/machinery/atmospherics/pipe/simple/supply/hidden/layer2,
/obj/machinery/atmospherics/pipe/manifold/scrubbers/hidden/layer4{
	dir = 8
	},
/turf/open/floor/plasteel/showroomfloor,
/area/crew_quarters/kitchen)
"aX" = (
/obj/machinery/atmospherics/components/unary/vent_scrubber/on/layer4{
	dir = 8;
	icon_state = "scrub_map_on-3"
	},
/obj/effect/spawner/lootdrop/mob/kitchen_animal,
/turf/open/floor/plasteel/showroomfloor,
/area/crew_quarters/kitchen)
"aY" = (
/obj/machinery/light/small{
	dir = 4
	},
/obj/machinery/airalarm{
	dir = 8;
	pixel_x = 24
	},
/obj/machinery/vending/wardrobe/chef_wardrobe,
/turf/open/floor/plasteel/showroomfloor,
/area/crew_quarters/kitchen)
"aZ" = (
/obj/structure/disposalpipe/segment,
/obj/machinery/atmospherics/pipe/simple/scrubbers/hidden/layer4,
/obj/machinery/atmospherics/pipe/manifold/supply/hidden/layer2{
	dir = 8
	},
/turf/open/floor/plasteel/showroomfloor,
/area/crew_quarters/kitchen)
"ba" = (
/obj/machinery/atmospherics/components/unary/vent_pump/on/layer2{
	dir = 8;
	icon_state = "vent_map_on-1"
	},
/turf/open/floor/plasteel/showroomfloor,
/area/crew_quarters/kitchen)
"bb" = (
/obj/machinery/processor,
/obj/machinery/firealarm{
	dir = 8;
	pixel_x = 26
	},
/turf/open/floor/grass/fakebasalt,
/area/crew_quarters/kitchen)
"bc" = (
/obj/machinery/door/airlock{
	name = "Kitchen cold room";
	req_access_txt = "28"
	},
/obj/structure/disposalpipe/segment,
/obj/machinery/atmospherics/pipe/simple/supply/hidden/layer2,
/obj/machinery/atmospherics/pipe/simple/scrubbers/hidden/layer4,
/obj/machinery/door/firedoor/border_only,
/obj/machinery/door/firedoor/border_only{
	dir = 1
	},
/turf/open/floor/plasteel/showroomfloor,
/area/crew_quarters/kitchen)
"bg" = (
/obj/structure/kitchenspike,
/obj/machinery/light/small{
	dir = 8
	},
/turf/open/floor/plasteel/showroomfloor,
/area/crew_quarters/kitchen)
"bo" = (
/obj/machinery/door/airlock{
	name = "Bar Storage";
	req_access_txt = "25"
	},
/obj/structure/disposalpipe/segment,
/obj/machinery/door/firedoor/border_only,
/obj/machinery/door/firedoor/border_only{
	dir = 1
	},
/turf/open/floor/plasteel{
	icon_state = "wood"
	},
/area/crew_quarters/bar)
"bp" = (
/obj/effect/landmark/blobstart,
/obj/item/toy/beach_ball/holoball,
/turf/open/floor/plating,
/area/crew_quarters/bar)
"bq" = (
/obj/structure/kitchenspike,
/turf/open/floor/plasteel/showroomfloor,
/area/crew_quarters/kitchen)
"br" = (
/obj/structure/disposalpipe/segment{
	dir = 4
	},
/turf/open/floor/grass/fakebasalt,
/area/crew_quarters/kitchen)
"bt" = (
/turf/open/floor/plasteel/showroomfloor,
/area/crew_quarters/kitchen)
"bu" = (
/obj/machinery/gibber,
/turf/open/floor/plasteel/showroomfloor,
/area/crew_quarters/kitchen)
"bH" = (
/obj/machinery/vending/coffee,
/obj/structure/alien/weeds,
/turf/open/floor/wood,
/area/crew_quarters/bar)
"cH" = (
/obj/item/stack/sheet/metal/fifty,
/obj/item/stack/sheet/glass/fifty,
/obj/item/stack/cable_coil,
/obj/item/flashlight/lamp,
/obj/item/flashlight/lamp/green,
/obj/structure/closet/secure_closet/bartender,
/obj/structure/alien/weeds,
/turf/open/floor/wood,
/area/crew_quarters/bar)
"cJ" = (
/obj/machinery/vending/dinnerware,
/turf/open/floor/grass/fakebasalt,
/area/crew_quarters/kitchen)
"cZ" = (
/obj/machinery/light{
	dir = 4
	},
/obj/structure/chair/wood{
	dir = 1
	},
/turf/open/floor/grass/fakeweeds,
/area/crew_quarters/bar)
"dx" = (
/obj/structure/disposalpipe/segment,
/obj/structure/alien/weeds,
/turf/open/floor/wood,
/area/crew_quarters/bar)
"dA" = (
/obj/structure/table/abductor,
/obj/item/reagent_containers/food/snacks/burger/xeno,
/turf/open/floor/grass/fakeweeds,
/area/crew_quarters/bar)
"dX" = (
/obj/item/radio/intercom{
	pixel_y = 25
	},
/obj/machinery/camera{
	c_tag = "Kitchen";
	dir = 2
	},
/obj/structure/closet/secure_closet/freezer/fridge,
/turf/open/floor/grass/fakebasalt,
/area/crew_quarters/kitchen)
"ec" = (
/obj/item/book/manual/wiki/barman_recipes,
/obj/item/reagent_containers/glass/rag,
/obj/machinery/door/poddoor/shutters/preopen{
	id = "barshutters";
	name = "bar shutters"
	},
/obj/structure/table/abductor,
/turf/open/floor/grass/fakeweeds,
/area/crew_quarters/bar)
"fa" = (
/obj/structure/table/wood,
/obj/structure/alien/weeds,
/obj/item/stack/sheet/metal/fifty,
/obj/item/stack/spacecash/c10,
/obj/item/stack/spacecash/c100,
/obj/item/reagent_containers/food/drinks/shaker,
/obj/item/toy/figure/bartender,
/turf/open/floor/wood,
/area/crew_quarters/bar)
"fm" = (
/obj/machinery/newscaster{
	pixel_y = -28
	},
/turf/open/floor/grass/fakeweeds,
/area/crew_quarters/bar)
"fz" = (
/obj/structure/table/abductor,
/obj/item/reagent_containers/food/snacks/breadslice/xenomeat{
	pixel_x = 3;
	pixel_y = 3
	},
/obj/item/reagent_containers/food/snacks/breadslice/xenomeat{
	pixel_x = -4;
	pixel_y = 10
	},
/turf/open/floor/grass/fakeweeds,
/area/crew_quarters/bar)
"fD" = (
/obj/item/clothing/head/hardhat/cakehat,
/obj/structure/table/abductor,
/obj/effect/landmark/xeno_spawn,
/turf/open/floor/grass/fakeweeds,
/area/crew_quarters/bar)
"fV" = (
/obj/machinery/door/airlock/public/glass{
	name = "Kitchen";
	req_access_txt = "28"
	},
/obj/machinery/door/firedoor/border_only{
	dir = 4
	},
/obj/machinery/door/firedoor/border_only{
	dir = 8
	},
/turf/open/floor/grass/fakeweeds,
/area/crew_quarters/kitchen)
"gk" = (
/obj/structure/sign/poster/official/no_erp,
/turf/closed/wall,
/area/crew_quarters/theatre)
"gu" = (
/obj/machinery/holopad,
/turf/open/floor/grass/fakeweeds,
/area/crew_quarters/bar)
"hs" = (
/obj/machinery/atmospherics/components/unary/vent_pump/on/layer2{
	dir = 8;
	icon_state = "vent_map_on-1"
	},
/turf/open/floor/grass/fakeweeds,
/area/crew_quarters/bar)
"iy" = (
/obj/machinery/light,
/obj/machinery/airalarm{
	dir = 1;
	icon_state = "alarm0";
	pixel_y = -24
	},
/obj/structure/table/abductor,
/turf/open/floor/grass/fakeweeds,
/area/crew_quarters/bar)
"iT" = (
/obj/machinery/disposal/bin,
/obj/structure/window/reinforced{
	dir = 8
	},
/obj/structure/disposalpipe/trunk{
	dir = 4
	},
/obj/machinery/door/poddoor/shutters/preopen{
	id = "barshutters";
	name = "bar shutters"
	},
/turf/open/floor/grass/fakeweeds,
/area/crew_quarters/bar)
"jC" = (
/obj/machinery/microwave{
	pixel_x = -3;
	pixel_y = 6
	},
/obj/structure/table/abductor,
/turf/open/floor/grass/fakebasalt,
/area/crew_quarters/kitchen)
"jK" = (
/obj/structure/alien/resin/wall,
/obj/structure/sign/poster/official/no_erp,
/turf/open/floor/plating/asteroid/basalt,
/area/crew_quarters/kitchen)
"ku" = (
/obj/machinery/light{
	dir = 4
	},
/obj/machinery/requests_console{
	department = "Bar";
	departmentType = 2;
	pixel_x = 30
	},
/obj/machinery/vending/boozeomat,
/turf/open/floor/grass/fakeweeds,
/area/crew_quarters/bar)
"kV" = (
/obj/machinery/light_switch{
	pixel_y = 28
	},
/obj/item/clothing/head/xenos,
/obj/item/clothing/suit/xenos,
/obj/item/clothing/under/maid,
/obj/item/clothing/under/waiter,
/obj/structure/rack,
/turf/open/floor/grass/fakeweeds,
/area/crew_quarters/bar)
"ld" = (
/obj/structure/closet/secure_closet/freezer/kitchen,
/turf/open/floor/grass/fakebasalt,
/area/crew_quarters/kitchen)
"lL" = (
/obj/item/instrument/piano_synth{
	pixel_x = 6;
	pixel_y = -4
	},
/obj/structure/table/abductor,
/obj/item/instrument/eguitar{
	pixel_x = -3;
	pixel_y = 3
	},
/turf/open/floor/grass/fakeweeds,
/area/crew_quarters/bar)
"mL" = (
/obj/machinery/door/window/southright{
	name = "Bar Door";
	req_one_access_txt = "25;28"
	},
/turf/open/floor/grass/fakeweeds,
/area/crew_quarters/bar)
"mU" = (
/obj/machinery/door/poddoor/preopen{
	id = "barshutters";
	name = "privacy shutters"
	},
/obj/structure/alien/resin/membrane,
/turf/open/floor/plating,
/area/crew_quarters/bar)
"ni" = (
/obj/structure/alien/egg/burst,
/obj/item/clothing/mask/facehugger/toy,
/turf/open/floor/grass/fakeweeds,
/area/crew_quarters/bar)
"nu" = (
/obj/machinery/deepfryer,
/turf/open/floor/grass/fakebasalt,
/area/crew_quarters/kitchen)
"nI" = (
/obj/item/reagent_containers/glass/mixbowl{
	pixel_y = 5
	},
/obj/item/reagent_containers/food/condiment/enzyme{
	layer = 5
	},
/obj/structure/table/abductor,
/turf/open/floor/grass/fakebasalt,
/area/crew_quarters/kitchen)
"nS" = (
/obj/machinery/atmospherics/pipe/simple/supply/hidden/layer2,
/obj/machinery/atmospherics/pipe/simple/scrubbers/hidden/layer4,
/turf/open/floor/grass/fakeweeds,
/area/crew_quarters/bar)
"ou" = (
/obj/structure/table,
/obj/machinery/chem_dispenser/drinks/beer{
	dir = 8
	},
/obj/machinery/firealarm{
	dir = 8;
	pixel_x = 26
	},
/turf/open/floor/grass/fakeweeds,
/area/crew_quarters/bar)
"pn" = (
/obj/structure/window/reinforced{
	dir = 8
	},
/obj/structure/window/reinforced,
/obj/machinery/door/poddoor/shutters/preopen{
	id = "barshutters";
	name = "bar shutters"
	},
/obj/structure/table/abductor,
/turf/open/floor/grass/fakeweeds,
/area/crew_quarters/bar)
"pD" = (
/obj/machinery/vending/snack/random,
/turf/open/floor/grass/fakeweeds,
/area/crew_quarters/bar)
"pF" = (
/obj/machinery/door/airlock/public/glass{
	name = "Diner"
	},
/obj/machinery/door/firedoor/border_only,
/obj/machinery/door/firedoor/border_only{
	dir = 1
	},
/obj/effect/turf_decal/siding/thinplating{
	dir = 1
	},
/turf/open/floor/plasteel,
/area/crew_quarters/bar)
"pM" = (
/obj/machinery/disposal/bin,
/obj/structure/disposalpipe/trunk{
	dir = 8
	},
/turf/open/floor/grass/fakebasalt,
/area/crew_quarters/kitchen)
"qh" = (
/obj/item/storage/box/fancy/donut_box,
/obj/machinery/door/poddoor/shutters/preopen{
	id = "kitchen";
	name = "kitchen shutters"
	},
/obj/machinery/door/firedoor/border_only{
	dir = 1
	},
/obj/machinery/door/firedoor/border_only,
/obj/structure/table/abductor,
/turf/open/floor/plating/asteroid/basalt,
/area/crew_quarters/kitchen)
"qE" = (
/obj/machinery/airalarm{
	dir = 4;
	pixel_x = -24
	},
/obj/machinery/light/small{
	dir = 8
	},
/obj/structure/reagent_dispensers/beerkeg,
/obj/machinery/atmospherics/components/unary/vent_scrubber/on/layer4{
	dir = 4;
	icon_state = "scrub_map_on-3"
	},
/obj/structure/alien/weeds,
/turf/open/floor/wood,
/area/crew_quarters/bar)
"qP" = (
/obj/machinery/light{
	dir = 1
	},
/obj/machinery/computer/security/telescreen/entertainment{
	pixel_y = 32
	},
/obj/structure/disposalpipe/segment{
	dir = 8
	},
/obj/machinery/button/door{
	id = "barshutters";
	name = "Bar Shutters Control";
	pixel_x = -25;
	pixel_y = 24;
	req_access_txt = "25"
	},
/turf/open/floor/grass/fakeweeds,
/area/crew_quarters/bar)
"rf" = (
/obj/structure/sink/kitchen{
	pixel_y = 28
	},
/obj/structure/alien/weeds,
/turf/open/floor/wood,
/area/crew_quarters/bar)
"rx" = (
/obj/machinery/oven,
/turf/open/floor/grass/fakebasalt,
/area/crew_quarters/kitchen)
"rK" = (
/obj/effect/landmark/event_spawn,
/obj/item/radio/intercom{
	pixel_y = -32
	},
/turf/open/floor/grass/fakeweeds,
/area/crew_quarters/bar)
"sa" = (
/obj/effect/landmark/start/assistant,
/obj/structure/bed/nest,
/turf/open/floor/grass/fakeweeds,
/area/crew_quarters/bar)
"sd" = (
/obj/machinery/door/poddoor/shutters/preopen{
	id = "kitchen";
	name = "kitchen shutters"
	},
/obj/machinery/door/firedoor/border_only{
	dir = 1
	},
/obj/machinery/door/firedoor/border_only,
/obj/structure/table/abductor,
/turf/open/floor/plating/asteroid/basalt,
/area/crew_quarters/kitchen)
"sy" = (
/obj/machinery/light,
/turf/open/floor/grass/fakebasalt,
/area/crew_quarters/kitchen)
"sZ" = (
/obj/structure/noticeboard{
	dir = 1;
	pixel_y = -27
	},
/obj/effect/landmark/start/assistant,
/turf/open/floor/grass/fakeweeds,
/area/crew_quarters/bar)
"tq" = (
/obj/structure/chair/stool/bar,
/turf/open/floor/grass/fakeweeds,
/area/crew_quarters/bar)
"ts" = (
/obj/item/book/manual/chef_recipes,
/obj/item/stack/packageWrap,
/obj/structure/table/abductor,
/turf/open/floor/grass/fakebasalt,
/area/crew_quarters/kitchen)
"tL" = (
/obj/structure/chair/wood/normal{
	dir = 4
	},
/turf/open/floor/grass/fakeweeds,
/area/crew_quarters/bar)
"uc" = (
/obj/machinery/light{
	dir = 8
	},
/turf/open/floor/grass/fakeweeds,
/area/crew_quarters/bar)
"ug" = (
/obj/machinery/light/small{
	dir = 4
	},
/obj/structure/alien/weeds,
/turf/open/floor/wood,
/area/crew_quarters/bar)
"uS" = (
/obj/item/reagent_containers/food/snacks/candy,
/obj/item/reagent_containers/food/drinks/soda_cans/sprited_cranberry{
	pixel_x = 5;
	pixel_y = 10
	},
/obj/structure/table/abductor,
/turf/open/floor/grass/fakeweeds,
/area/crew_quarters/bar)
"vp" = (
/obj/structure/alien/resin/wall,
/obj/structure/sign/poster/official/no_erp,
/turf/open/floor/grass/fakebasalt,
/area/crew_quarters/bar)
"vy" = (
/obj/machinery/airalarm{
	dir = 4;
	pixel_x = -24
	},
/obj/machinery/camera{
	c_tag = "Bar West";
	dir = 4
	},
/turf/open/floor/grass/fakeweeds,
/area/crew_quarters/bar)
"wp" = (
/obj/machinery/computer/security/telescreen/entertainment{
	pixel_x = -31
	},
/turf/open/floor/grass/fakeweeds,
/area/crew_quarters/bar)
"ww" = (
/obj/structure/alien/resin/wall,
/turf/open/floor/grass/fakebasalt,
/area/crew_quarters/kitchen)
"wR" = (
/obj/structure/mecha_wreckage/ripley,
/turf/open/floor/grass/fakeweeds,
/area/crew_quarters/bar)
"xA" = (
/turf/open/floor/grass/fakeweeds,
/area/crew_quarters/bar)
"yd" = (
/obj/structure/disposalpipe/segment,
/obj/machinery/atmospherics/pipe/simple/supply/hidden/layer2,
/obj/machinery/atmospherics/pipe/simple/scrubbers/hidden/layer4,
/turf/open/floor/grass/fakebasalt,
/area/crew_quarters/kitchen)
"yk" = (
/obj/machinery/airalarm{
	dir = 2;
	pixel_y = 24
	},
/turf/open/floor/grass/fakeweeds,
/area/crew_quarters/bar)
"zf" = (
/obj/structure/disposalpipe/segment{
	dir = 5
	},
/obj/machinery/button/door{
	id = "kitchen";
	name = "Kitchen Shutters Control";
	pixel_x = -1;
	pixel_y = -24;
	req_access_txt = "28"
	},
/turf/open/floor/grass/fakebasalt,
/area/crew_quarters/kitchen)
"zo" = (
/obj/item/reagent_containers/food/snacks/mint,
/obj/item/storage/box/donkpockets{
	pixel_x = 3;
	pixel_y = 3
	},
/obj/structure/table/abductor,
/obj/item/reagent_containers/food/snacks/raw_meatball/xeno{
	pixel_x = -10;
	pixel_y = -3
	},
/obj/item/reagent_containers/food/snacks/raw_meatball/xeno{
	pixel_x = -8;
	pixel_y = 7
	},
/turf/open/floor/grass/fakebasalt,
/area/crew_quarters/kitchen)
"Af" = (
/obj/structure/closet/secure_closet/freezer/meat,
/obj/item/toy/figure/chef,
/turf/open/floor/plasteel/showroomfloor,
/area/crew_quarters/kitchen)
"Bf" = (
/obj/machinery/light,
/obj/machinery/firealarm{
	dir = 1;
	pixel_y = -26
	},
/obj/structure/alien/egg/burst,
/obj/item/clothing/mask/facehugger/toy,
/turf/open/floor/grass/fakeweeds,
/area/crew_quarters/bar)
"Cp" = (
/obj/machinery/door/poddoor/shutters/preopen{
	id = "barshutters";
	name = "bar shutters"
	},
/obj/structure/table/abductor,
/obj/effect/landmark/xeno_spawn,
/turf/open/floor/grass/fakeweeds,
/area/crew_quarters/bar)
"CV" = (
/obj/structure/disposalpipe/segment,
/obj/machinery/door/firedoor/border_only,
/obj/machinery/door/firedoor/border_only{
	dir = 1
	},
/obj/machinery/door/airlock/maintenance{
	name = "Bar Maintenance";
	req_access_txt = "12"
	},
/turf/open/floor/plating,
/area/maintenance/starboard/fore)
"De" = (
/obj/machinery/vending/wardrobe/bar_wardrobe,
/obj/structure/alien/weeds,
/turf/open/floor/wood,
/area/crew_quarters/bar)
"DH" = (
/obj/structure/disposalpipe/trunk{
	dir = 8
	},
/obj/machinery/disposal/bin,
/obj/machinery/firealarm{
	dir = 2;
	pixel_y = 26
	},
/turf/open/floor/grass/fakeweeds,
/area/crew_quarters/bar)
"DN" = (
/obj/structure/disposalpipe/segment{
	dir = 5
	},
/turf/open/floor/grass/fakeweeds,
/area/crew_quarters/bar)
"Em" = (
/obj/structure/alien/resin/wall,
/turf/open/floor/grass/fakeweeds,
/area/crew_quarters/bar)
"Eq" = (
/obj/item/lighter,
/obj/machinery/door/poddoor/shutters/preopen{
	id = "barshutters";
	name = "bar shutters"
	},
/obj/structure/table/abductor,
/turf/open/floor/grass/fakeweeds,
/area/crew_quarters/bar)
"Fi" = (
/obj/structure/table/abductor,
/obj/item/reagent_containers/food/snacks/chocolateegg,
/turf/open/floor/grass/fakeweeds,
/area/crew_quarters/bar)
"Gf" = (
/obj/structure/alien/weeds,
/obj/structure/sign/poster/contraband/busty_backdoor_xeno_babes_6{
	pixel_x = 32;
	pixel_y = 32
	},
/turf/open/floor/wood,
/area/crew_quarters/bar)
"Gg" = (
/obj/machinery/camera{
	c_tag = "Theatre Stage";
	dir = 2
	},
/turf/open/floor/grass/fakeweeds,
/area/crew_quarters/bar)
"HB" = (
/obj/machinery/light_switch{
	pixel_y = -25
	},
/turf/open/floor/grass/fakebasalt,
/area/crew_quarters/kitchen)
"It" = (
/obj/structure/table/reinforced,
/obj/item/reagent_containers/food/snacks/pie/cream,
/obj/machinery/door/window/westright,
/obj/machinery/door/firedoor/border_only{
	dir = 4
	},
/obj/machinery/door/firedoor/border_only{
	dir = 8
	},
/turf/open/floor/grass/fakeweeds,
/area/crew_quarters/kitchen)
"IL" = (
/obj/structure/sign/plaques/deempisi{
	pixel_x = -6;
	pixel_y = -8
	},
/obj/structure/alien/resin/wall,
/turf/open/floor/grass/fakebasalt,
/area/crew_quarters/bar)
"Jr" = (
/obj/structure/sign/barsign,
/obj/structure/alien/resin/wall,
/turf/open/floor/grass/fakebasalt,
/area/crew_quarters/bar)
"JE" = (
/obj/item/twohanded/required/kirbyplants/random,
/obj/item/radio/intercom{
	pixel_y = 28
	},
/turf/open/floor/grass/fakeweeds,
/area/crew_quarters/bar)
"JT" = (
/obj/effect/landmark/start/cook,
/turf/open/floor/grass/fakebasalt,
/area/crew_quarters/kitchen)
"Kh" = (
/obj/machinery/atmospherics/pipe/simple/supply/hidden/layer2{
	dir = 4
	},
/obj/machinery/atmospherics/pipe/simple/scrubbers/hidden/layer4{
	dir = 4
	},
/obj/machinery/holopad,
/turf/open/floor/grass/fakeweeds,
/area/crew_quarters/bar)
"Kx" = (
/obj/effect/landmark/start/cook,
/obj/machinery/atmospherics/components/unary/vent_scrubber/on/layer4{
	dir = 4;
	icon_state = "scrub_map_on-3"
	},
/turf/open/floor/grass/fakebasalt,
/area/crew_quarters/kitchen)
"Ky" = (
/obj/structure/table/abductor,
/obj/item/reagent_containers/food/snacks/pie/xemeatpie,
/turf/open/floor/grass/fakeweeds,
/area/crew_quarters/bar)
"Lx" = (
/obj/machinery/reagentgrinder,
/obj/structure/table/wood,
/obj/structure/alien/weeds,
/turf/open/floor/wood,
/area/crew_quarters/bar)
"MG" = (
/obj/structure/disposalpipe/segment{
	dir = 4
	},
/obj/machinery/atmospherics/components/unary/vent_pump/on/layer2{
	dir = 8;
	icon_state = "vent_map_on-1"
	},
/turf/open/floor/grass/fakebasalt,
/area/crew_quarters/kitchen)
"MI" = (
/obj/item/kitchen/rollingpin{
	pixel_x = 5;
	pixel_y = -3
	},
/obj/item/reagent_containers/food/condiment/peppermill{
	pixel_x = -3;
	pixel_y = 8
	},
/obj/item/reagent_containers/food/condiment/saltshaker{
	pixel_x = -8;
	pixel_y = 5
	},
/obj/structure/table/abductor,
/turf/open/floor/grass/fakebasalt,
/area/crew_quarters/kitchen)
"NJ" = (
/obj/machinery/atmospherics/pipe/simple/supply/hidden/layer2{
	dir = 4
	},
/obj/machinery/atmospherics/pipe/simple/scrubbers/hidden/layer4{
	dir = 4
	},
/obj/structure/chair/wood/normal,
/turf/open/floor/grass/fakeweeds,
/area/crew_quarters/bar)
"Ol" = (
/obj/structure/disposalpipe/segment{
	dir = 10
	},
/turf/open/floor/grass/fakebasalt,
/area/crew_quarters/kitchen)
"OD" = (
/obj/machinery/atmospherics/pipe/simple/supply/hidden/layer2{
	dir = 5
	},
/obj/machinery/atmospherics/pipe/simple/scrubbers/hidden/layer4{
	dir = 5
	},
/obj/structure/chair/wood/normal,
/turf/open/floor/grass/fakeweeds,
/area/crew_quarters/bar)
"OM" = (
/obj/structure/extinguisher_cabinet{
	pixel_y = -30
	},
/obj/structure/chair/wood/normal{
	dir = 8
	},
/turf/open/floor/grass/fakeweeds,
/area/crew_quarters/bar)
"OU" = (
/obj/structure/disposalpipe/segment,
/obj/machinery/atmospherics/pipe/simple/scrubbers/hidden/layer4,
/obj/machinery/atmospherics/pipe/simple/supply/hidden/layer2,
/obj/structure/alien/weeds,
/turf/open/floor/wood,
/area/crew_quarters/bar)
"Pl" = (
/obj/machinery/griddle,
/turf/open/floor/grass/fakebasalt,
/area/crew_quarters/kitchen)
"Qu" = (
/obj/structure/bed/nest,
/turf/open/floor/grass/fakeweeds,
/area/crew_quarters/bar)
"QY" = (
/obj/machinery/atmospherics/components/unary/vent_pump/on/layer2{
	dir = 8;
	icon_state = "vent_map_on-1"
	},
/obj/structure/alien/weeds,
/turf/open/floor/wood,
/area/crew_quarters/bar)
"Rw" = (
/obj/structure/disposalpipe/segment,
/turf/open/floor/grass/fakebasalt,
/area/crew_quarters/kitchen)
"RJ" = (
/obj/structure/extinguisher_cabinet{
	pixel_y = -30
	},
/turf/open/floor/grass/fakeweeds,
/area/crew_quarters/bar)
"Sy" = (
/obj/item/clothing/head/that,
/obj/machinery/door/poddoor/shutters/preopen{
	id = "barshutters";
	name = "bar shutters"
	},
/obj/structure/table/abductor,
/turf/open/floor/grass/fakeweeds,
/area/crew_quarters/bar)
"SO" = (
/obj/structure/extinguisher_cabinet{
	pixel_x = -5;
	pixel_y = 30
	},
/turf/open/floor/grass/fakebasalt,
/area/crew_quarters/kitchen)
"Tg" = (
/obj/structure/disposalpipe/segment{
	dir = 9
	},
/mob/living/simple_animal/hostile/alien/maid/barmaid{
	desc = "It looks like it rode a ripley for a time.";
	name = "Ridley"
	},
/turf/open/floor/grass/fakeweeds,
/area/crew_quarters/bar)
"Tr" = (
/obj/structure/alien/resin/wall,
/turf/open/floor/grass/fakebasalt,
/area/crew_quarters/bar)
"Tz" = (
/obj/machinery/camera{
	c_tag = "Bar Storage"
	},
/obj/structure/alien/weeds,
/turf/open/floor/wood,
/area/crew_quarters/bar)
"Ud" = (
/obj/structure/closet/secure_closet/bar{
	req_access_txt = "25"
	},
/obj/item/gun/ballistic/revolver/russian,
/obj/structure/alien/weeds,
/obj/structure/sign/poster/contraband/lusty_xenomorph{
	pixel_x = -32
	},
/turf/open/floor/wood,
/area/crew_quarters/bar)
"Uv" = (
/obj/machinery/smartfridge/drinks,
/obj/machinery/door/poddoor/preopen{
	id = "barshutters";
	name = "privacy shutters"
	},
/obj/structure/alien/weeds,
/turf/open/floor/grass/fakeweeds,
/area/crew_quarters/bar)
"UN" = (
/obj/machinery/microwave{
	pixel_x = -3;
	pixel_y = 6
	},
/obj/machinery/airalarm{
	pixel_y = 24
	},
/obj/machinery/light{
	dir = 1
	},
/obj/structure/table/abductor,
/turf/open/floor/grass/fakebasalt,
/area/crew_quarters/kitchen)
"Va" = (
/obj/item/toy/cards/deck,
/obj/machinery/door/poddoor/shutters/preopen{
	id = "barshutters";
	name = "bar shutters"
	},
/obj/structure/table/abductor,
/turf/open/floor/grass/fakeweeds,
/area/crew_quarters/bar)
"Vm" = (
/obj/effect/landmark/event_spawn,
/turf/open/floor/grass/fakebasalt,
/area/crew_quarters/kitchen)
"Vv" = (
/obj/machinery/door/airlock{
	name = "Kitchen";
	req_access_txt = "28"
	},
/obj/machinery/door/firedoor/border_only{
	dir = 8
	},
/obj/machinery/door/firedoor/border_only{
	dir = 4
	},
/turf/open/floor/grass/fakeweeds,
/area/crew_quarters/kitchen)
"VQ" = (
/obj/structure/table,
/obj/machinery/chem_dispenser/drinks{
	dir = 8
	},
/obj/machinery/camera{
	c_tag = "Bar";
	dir = 8
	},
/turf/open/floor/grass/fakeweeds,
/area/crew_quarters/bar)
"Xd" = (
/turf/open/floor/grass/fakebasalt,
/area/crew_quarters/kitchen)
"XL" = (
/obj/machinery/requests_console{
	department = "Kitchen";
	departmentType = 2;
	pixel_x = 30
	},
/obj/machinery/reagentgrinder/kitchen{
	pixel_y = 6
	},
/obj/structure/table/abductor,
/turf/open/floor/grass/fakebasalt,
/area/crew_quarters/kitchen)
"XO" = (
/obj/machinery/light,
/turf/open/floor/grass/fakeweeds,
/area/crew_quarters/bar)
"Yu" = (
/obj/effect/landmark/start/bartender,
/turf/open/floor/grass/fakeweeds,
/area/crew_quarters/bar)
"YB" = (
/obj/structure/disposalpipe/segment,
/obj/effect/landmark/xeno_spawn,
/obj/machinery/atmospherics/pipe/simple/scrubbers/hidden/layer4{
	dir = 9
	},
/obj/machinery/atmospherics/pipe/simple/supply/hidden/layer2{
	dir = 5
	},
/obj/structure/alien/weeds,
/obj/structure/alien/weeds/node,
/turf/open/floor/wood,
/area/crew_quarters/bar)
"YV" = (
/obj/structure/disposalpipe/segment{
	dir = 5
	},
/obj/machinery/atmospherics/pipe/simple/supply/hidden/layer2{
	dir = 5
	},
/obj/machinery/atmospherics/pipe/simple/scrubbers/hidden/layer4{
	dir = 9
	},
/turf/open/floor/grass/fakebasalt,
/area/crew_quarters/kitchen)
"Zm" = (
/obj/machinery/atmospherics/pipe/simple/supply/hidden/layer2{
	dir = 4
	},
/turf/open/floor/grass/fakeweeds,
/area/crew_quarters/bar)
"ZG" = (
/obj/effect/landmark/event_spawn,
/obj/structure/alien/resin/wall,
/turf/open/floor/grass/fakebasalt,
/area/crew_quarters/bar)
"ZQ" = (
/obj/effect/spawner/xmastree,
/obj/effect/landmark/event_spawn,
/obj/machinery/atmospherics/pipe/simple/supply/hidden/layer2{
	dir = 4
	},
/obj/machinery/atmospherics/components/unary/vent_scrubber/on/layer4{
	dir = 8
	},
/turf/open/floor/grass/fakeweeds,
/area/crew_quarters/bar)
"ZV" = (
/obj/structure/sink/kitchen{
	pixel_y = 28
	},
/obj/machinery/food_cart,
/turf/open/floor/grass/fakebasalt,
/area/crew_quarters/kitchen)

(1,1,1) = {"
aa
aa
Tr
Tr
Tr
Tr
ZG
mU
Tr
mU
vp
mU
Tr
Tr
"}
(2,1,1) = {"
aa
aa
uc
xA
wp
xA
xA
xA
vy
ni
uc
xA
pD
Tr
"}
(3,1,1) = {"
aa
aa
xA
xA
xA
Qu
sa
Qu
Qu
Qu
Qu
xA
RJ
Tr
"}
(4,1,1) = {"
ac
kV
xA
ni
xA
Fi
Fi
Fi
Fi
Fi
Fi
xA
fm
Tr
"}
(5,1,1) = {"
ab
nS
OD
fD
xA
Qu
Qu
Qu
Qu
Qu
Qu
xA
Bf
Tr
"}
(6,1,1) = {"
ac
yk
NJ
uS
xA
xA
xA
xA
xA
xA
xA
ni
xA
pF
"}
(7,1,1) = {"
gk
Gg
Kh
xA
xA
Qu
Qu
Qu
Qu
Qu
Qu
xA
xA
mU
"}
(8,1,1) = {"
ac
JE
ZQ
xA
xA
Ky
Ky
dA
dA
fz
fz
xA
xA
pF
"}
(9,1,1) = {"
ag
xA
Zm
xA
xA
Qu
Qu
Qu
Qu
Qu
Qu
xA
xA
Jr
"}
(10,1,1) = {"
CV
DN
hs
xA
xA
xA
ni
xA
xA
xA
xA
xA
XO
Tr
"}
(11,1,1) = {"
ag
DH
lL
cZ
wR
gu
tq
tq
tq
tq
tq
xA
rK
Tr
"}
(12,1,1) = {"
ag
Em
Tr
Tr
IL
iT
pn
Va
Sy
Eq
Cp
xA
sZ
Tr
"}
(13,1,1) = {"
fa
Lx
qE
Ud
Tr
qP
xA
Yu
xA
xA
ec
tq
tL
Tr
"}
(14,1,1) = {"
OU
OU
YB
dx
bo
Tg
xA
xA
xA
xA
mL
ni
iy
Tr
"}
(15,1,1) = {"
rf
Gf
QY
cH
Tr
ou
VQ
xA
ku
xA
Uv
xA
OM
Tr
"}
(16,1,1) = {"
ag
Tz
De
ag
Tr
ww
ww
fV
ww
It
ww
Vv
jK
ww
"}
(17,1,1) = {"
ak
ug
bH
ag
bp
al
cJ
Xd
Xd
Xd
Xd
HB
ww
aa
"}
(18,1,1) = {"
al
al
al
al
al
al
ZV
Xd
Xd
Xd
Xd
sy
ww
aa
"}
(19,1,1) = {"
al
Af
aS
bg
bq
al
SO
Kx
zo
Pl
Xd
Xd
qh
aa
"}
(20,1,1) = {"
ai
an
an
aW
aZ
bc
yd
YV
nI
rx
JT
Xd
sd
aa
"}
(21,1,1) = {"
al
ap
aL
aX
ba
al
dX
MG
MI
nu
Xd
Vm
sd
aa
"}
(22,1,1) = {"
ao
aF
aU
bt
bt
al
UN
br
ts
nu
Xd
Xd
sd
aa
"}
(23,1,1) = {"
al
al
al
aY
bu
al
jC
Ol
Rw
Rw
Rw
zf
ww
aa
"}
(24,1,1) = {"
aa
aa
al
al
al
al
ld
Xd
Xd
bb
XL
pM
ww
aa
"}
