//MAP CONVERTED BY dmm2tgm.py THIS HEADER COMMENT PREVENTS RECONVERSION, DO NOT REMOVE
"aa" = (
/turf/template_noop,
/area/template_noop)
"ab" = (
/obj/machinery/door/airlock{
	name = "Theatre Backstage";
	req_access_txt = "46"
	},
/obj/machinery/atmospherics/pipe/simple/supply/hidden/layer2,
/obj/machinery/atmospherics/pipe/simple/scrubbers/hidden/layer4,
/obj/machinery/door/firedoor/border_only,
/obj/machinery/door/firedoor/border_only{
	dir = 1
	},
/turf/open/floor/plasteel,
/area/crew_quarters/theatre)
"ae" = (
/obj/machinery/disposal/bin,
/obj/structure/disposalpipe/trunk{
	dir = 4
	},
/turf/open/floor/wood,
/area/crew_quarters/bar)
"ag" = (
/turf/closed/wall,
/area/crew_quarters/bar)
"ah" = (
/obj/structure/disposalpipe/segment{
	dir = 9
	},
/obj/machinery/atmospherics/pipe/simple/scrubbers/hidden/layer4,
/obj/machinery/atmospherics/pipe/simple/supply/hidden/layer2,
/turf/open/floor/wood,
/area/crew_quarters/bar)
"ai" = (
/obj/machinery/door/airlock/maintenance{
	name = "Kitchen Maintenance";
	req_access_txt = "28"
	},
/obj/structure/disposalpipe/segment,
/obj/machinery/atmospherics/pipe/simple/supply/hidden/layer2,
/obj/machinery/atmospherics/pipe/simple/scrubbers/hidden/layer4,
/turf/open/floor/plating,
/area/maintenance/starboard/fore)
"aj" = (
/obj/machinery/light{
	dir = 1
	},
/obj/machinery/light_switch{
	pixel_y = 28
	},
/obj/effect/landmark/event_spawn,
/turf/open/floor/wood,
/area/crew_quarters/bar)
"ak" = (
/obj/machinery/door/window/southleft{
	base_state = "left";
	dir = 2;
	icon_state = "left";
	name = "Bar Delivery";
	req_access_txt = "25"
	},
/obj/effect/turf_decal/delivery,
/turf/open/floor/plasteel,
/area/crew_quarters/bar)
"al" = (
/turf/closed/wall,
/area/crew_quarters/kitchen)
"am" = (
/obj/machinery/atmospherics/pipe/simple/scrubbers/hidden/layer4,
/obj/machinery/atmospherics/pipe/manifold/supply/hidden/layer2{
	dir = 8
	},
/turf/open/floor/wood,
/area/crew_quarters/bar)
"an" = (
/obj/structure/table/wood/fancy,
/obj/item/kitchen/fork,
/obj/item/kitchen/fork{
	pixel_x = -6
	},
/obj/item/kitchen/fork{
	pixel_x = 6
	},
/turf/open/floor/wood,
/area/crew_quarters/bar)
"ao" = (
/obj/machinery/navbeacon{
	codes_txt = "delivery;dir=2";
	freq = 1400;
	location = "Kitchen"
	},
/obj/structure/plasticflaps{
	opacity = 1
	},
/obj/effect/turf_decal/bot{
	dir = 2
	},
/turf/open/floor/plasteel{
	dir = 2
	},
/area/crew_quarters/kitchen)
"ap" = (
/obj/structure/window{
	dir = 4;
	icon_state = "window"
	},
/obj/machinery/camera{
	c_tag = "Theatre Stage";
	dir = 2
	},
/obj/item/radio/intercom{
	pixel_y = 25
	},
/turf/open/floor/wood,
/area/crew_quarters/bar)
"aq" = (
/obj/machinery/airalarm{
	pixel_y = 24
	},
/obj/machinery/vending/cigarette,
/turf/open/floor/wood,
/area/crew_quarters/bar)
"ar" = (
/obj/structure/disposalpipe/segment{
	dir = 5
	},
/turf/open/floor/wood,
/area/crew_quarters/bar)
"as" = (
/obj/machinery/firealarm{
	dir = 2;
	pixel_y = 26
	},
/obj/structure/disposalpipe/trunk{
	dir = 8
	},
/obj/machinery/disposal/bin,
/turf/open/floor/wood,
/area/crew_quarters/bar)
"at" = (
/obj/machinery/atmospherics/pipe/simple/scrubbers/hidden/layer4,
/obj/machinery/atmospherics/pipe/simple/supply/hidden/layer2{
	dir = 5
	},
/turf/open/floor/wood,
/area/crew_quarters/bar)
"au" = (
/obj/machinery/atmospherics/pipe/simple/supply/hidden/layer2{
	dir = 8
	},
/turf/open/floor/wood,
/area/crew_quarters/bar)
"ay" = (
/obj/machinery/atmospherics/pipe/simple/scrubbers/hidden/layer4,
/obj/machinery/atmospherics/pipe/simple/supply/hidden/layer2,
/obj/structure/disposalpipe/segment,
/turf/open/floor/plasteel/showroomfloor,
/area/crew_quarters/kitchen)
"az" = (
/obj/effect/turf_decal/loading_area{
	dir = 8
	},
/obj/machinery/camera{
	c_tag = "Kitchen Cold Room"
	},
/turf/open/floor/plasteel/showroomfloor,
/area/crew_quarters/kitchen)
"aA" = (
/obj/effect/turf_decal/delivery,
/obj/structure/window/reinforced,
/obj/machinery/door/window/westleft{
	name = "Kitchen Delivery";
	req_access_txt = "28"
	},
/turf/open/floor/plasteel,
/area/crew_quarters/kitchen)
"aB" = (
/turf/open/floor/wood,
/area/crew_quarters/bar)
"aC" = (
/obj/machinery/status_display/evac{
	pixel_x = 32
	},
/obj/structure/chair/stool/bar,
/obj/machinery/light{
	dir = 1;
	light_color = "#c1caff"
	},
/turf/open/floor/wood,
/area/crew_quarters/bar)
"aD" = (
/obj/machinery/atmospherics/pipe/simple/supply/hidden/layer2{
	dir = 5
	},
/obj/machinery/atmospherics/pipe/simple/scrubbers/hidden/layer4{
	dir = 5
	},
/turf/open/floor/wood,
/area/crew_quarters/bar)
"aE" = (
/obj/machinery/atmospherics/pipe/simple/scrubbers/hidden/layer4{
	dir = 4
	},
/turf/open/floor/wood,
/area/crew_quarters/bar)
"aF" = (
/obj/machinery/atmospherics/components/unary/vent_scrubber/on/layer4{
	dir = 4;
	icon_state = "scrub_map_on-3"
	},
/turf/open/floor/carpet/red,
/area/crew_quarters/bar)
"aG" = (
/obj/machinery/atmospherics/pipe/simple/scrubbers/hidden/layer4{
	dir = 4
	},
/obj/machinery/atmospherics/pipe/simple/supply/hidden/layer2{
	dir = 8
	},
/turf/open/floor/wood,
/area/crew_quarters/bar)
"aH" = (
/obj/machinery/door/window/eastleft,
/obj/machinery/atmospherics/pipe/simple/scrubbers/hidden/layer4{
	dir = 4
	},
/obj/machinery/atmospherics/pipe/simple/supply/hidden/layer2{
	dir = 8
	},
/turf/open/floor/wood,
/area/crew_quarters/bar)
"aI" = (
/obj/machinery/atmospherics/pipe/simple/scrubbers/hidden/layer4{
	dir = 10
	},
/obj/machinery/atmospherics/pipe/simple/supply/hidden/layer2{
	dir = 10
	},
/turf/open/floor/wood,
/area/crew_quarters/bar)
"aJ" = (
/obj/machinery/computer/slot_machine,
/turf/open/floor/wood,
/area/crew_quarters/bar)
"aK" = (
/obj/machinery/vending/wardrobe/bar_wardrobe,
/turf/open/floor/wood,
/area/crew_quarters/bar)
"aM" = (
/obj/structure/chair/stool,
/turf/open/floor/wood,
/area/crew_quarters/bar)
"aP" = (
/obj/machinery/atmospherics/pipe/simple/supply/hidden/layer2,
/obj/machinery/atmospherics/pipe/manifold/scrubbers/hidden/layer4{
	dir = 8
	},
/obj/structure/disposalpipe/segment,
/turf/open/floor/plasteel/showroomfloor,
/area/crew_quarters/kitchen)
"aQ" = (
/obj/machinery/atmospherics/components/unary/vent_scrubber/on/layer4{
	dir = 8;
	icon_state = "scrub_map_on-3"
	},
/turf/open/floor/plasteel/showroomfloor,
/area/crew_quarters/kitchen)
"aR" = (
/obj/structure/table/wood,
/obj/item/reagent_containers/food/snacks/store/cheesewheel/mozzarella,
/obj/structure/window/reinforced/tinted,
/turf/open/floor/wood,
/area/crew_quarters/bar)
"aS" = (
/obj/structure/table/wood/fancy,
/obj/machinery/paystand/register{
	dir = 1;
	icon_state = "register"
	},
/turf/open/floor/wood,
/area/crew_quarters/bar)
"aT" = (
/obj/structure/table/wood/fancy,
/obj/item/reagent_containers/food/snacks/cheesewedge/mozzarella,
/obj/item/reagent_containers/food/snacks/cheesewedge/mozzarella{
	pixel_x = -2;
	pixel_y = 4
	},
/turf/open/floor/wood,
/area/crew_quarters/bar)
"aU" = (
/obj/structure/table/wood/fancy,
/obj/item/reagent_containers/food/snacks/cracker,
/turf/open/floor/wood,
/area/crew_quarters/bar)
"aX" = (
/obj/effect/landmark/event_spawn,
/turf/open/floor/wood,
/area/crew_quarters/bar)
"aY" = (
/obj/structure/chair/stool/bar,
/turf/open/floor/wood,
/area/crew_quarters/bar)
"aZ" = (
/obj/structure/table/wood/fancy,
/obj/item/kitchen/fork{
	dir = 1;
	icon_state = "fork";
	pixel_x = -6
	},
/obj/item/kitchen/fork{
	dir = 1;
	icon_state = "fork";
	pixel_x = 6
	},
/obj/item/kitchen/fork{
	dir = 1;
	icon_state = "fork"
	},
/turf/open/floor/wood,
/area/crew_quarters/bar)
"ba" = (
/obj/structure/fermenting_barrel,
/turf/open/floor/wood,
/area/crew_quarters/bar)
"bc" = (
/obj/machinery/vending/wardrobe/chef_wardrobe,
/turf/open/floor/plasteel/showroomfloor,
/area/crew_quarters/kitchen)
"bd" = (
/obj/machinery/atmospherics/pipe/simple/scrubbers/hidden/layer4,
/obj/machinery/atmospherics/pipe/manifold/supply/hidden/layer2{
	dir = 8
	},
/obj/structure/disposalpipe/segment,
/turf/open/floor/plasteel/showroomfloor,
/area/crew_quarters/kitchen)
"be" = (
/obj/structure/disposalpipe/segment,
/obj/machinery/atmospherics/pipe/simple/supply/hidden/layer2,
/obj/machinery/atmospherics/pipe/simple/scrubbers/hidden/layer4,
/turf/open/floor/plasteel/cafeteria,
/area/crew_quarters/kitchen)
"bf" = (
/obj/machinery/atmospherics/components/unary/vent_pump/on/layer2{
	dir = 8;
	icon_state = "vent_map_on-1"
	},
/obj/effect/spawner/lootdrop/mob/kitchen_animal,
/turf/open/floor/plasteel/showroomfloor,
/area/crew_quarters/kitchen)
"bg" = (
/obj/machinery/chem_master/condimaster{
	name = "CondiMaster Neo"
	},
/obj/machinery/light/small{
	dir = 4
	},
/turf/open/floor/plasteel/showroomfloor,
/area/crew_quarters/kitchen)
"bh" = (
/turf/open/floor/carpet/red,
/area/crew_quarters/bar)
"bi" = (
/obj/effect/landmark/start/assistant,
/turf/open/floor/carpet/red,
/area/crew_quarters/bar)
"bj" = (
/obj/machinery/atmospherics/pipe/simple/scrubbers/hidden/layer4,
/obj/machinery/atmospherics/pipe/simple/supply/hidden/layer2,
/turf/open/floor/wood,
/area/crew_quarters/bar)
"bl" = (
/obj/machinery/door/airlock{
	name = "Bar Storage";
	req_access_txt = "25"
	},
/obj/machinery/door/firedoor/border_only{
	dir = 1
	},
/obj/machinery/door/firedoor/border_only,
/turf/open/floor/wood,
/area/crew_quarters/bar)
"bm" = (
/obj/structure/reagent_dispensers/cooking_oil,
/turf/open/floor/plasteel/showroomfloor,
/area/crew_quarters/kitchen)
"bn" = (
/obj/structure/chair/stool/bar,
/obj/effect/landmark/start/assistant,
/turf/open/floor/wood,
/area/crew_quarters/bar)
"bq" = (
/obj/structure/kitchenspike,
/turf/open/floor/plasteel/showroomfloor,
/area/crew_quarters/kitchen)
"br" = (
/mob/living/carbon/monkey/punpun,
/turf/open/floor/wood,
/area/crew_quarters/bar)
"bt" = (
/turf/open/floor/plasteel/showroomfloor,
/area/crew_quarters/kitchen)
"bu" = (
/obj/machinery/gibber,
/turf/open/floor/plasteel/showroomfloor,
/area/crew_quarters/kitchen)
"bv" = (
/obj/machinery/door/airlock{
	name = "Kitchen cold room";
	req_access_txt = "28"
	},
/obj/machinery/atmospherics/pipe/simple/scrubbers/hidden/layer4,
/obj/machinery/atmospherics/pipe/simple/supply/hidden/layer2,
/obj/structure/disposalpipe/segment,
/obj/machinery/door/firedoor/border_only,
/obj/machinery/door/firedoor/border_only{
	dir = 1
	},
/turf/open/floor/plasteel/showroomfloor,
/area/crew_quarters/kitchen)
"bw" = (
/obj/structure/table/wood,
/obj/item/reagent_containers/food/snacks/store/cheesewheel/american,
/obj/structure/window/reinforced/tinted{
	dir = 1
	},
/turf/open/floor/wood,
/area/crew_quarters/bar)
"bx" = (
/obj/structure/table/wood/fancy,
/obj/item/reagent_containers/food/snacks/cheesewedge/american{
	pixel_x = -2;
	pixel_y = 4
	},
/obj/item/reagent_containers/food/snacks/cheesewedge/american,
/turf/open/floor/wood,
/area/crew_quarters/bar)
"by" = (
/obj/structure/disposalpipe/segment{
	dir = 4
	},
/turf/open/floor/plasteel/cafeteria,
/area/crew_quarters/kitchen)
"bz" = (
/obj/machinery/light/small,
/obj/machinery/computer/arcade,
/turf/open/floor/wood,
/area/crew_quarters/bar)
"bA" = (
/obj/machinery/atmospherics/components/unary/vent_pump/on/layer2{
	dir = 4;
	icon_state = "vent_map_on-1"
	},
/turf/open/floor/wood,
/area/crew_quarters/bar)
"bB" = (
/obj/machinery/atmospherics/pipe/simple/scrubbers/hidden/layer4{
	dir = 4
	},
/turf/open/floor/carpet/red,
/area/crew_quarters/bar)
"bC" = (
/obj/machinery/atmospherics/pipe/manifold/scrubbers/hidden/layer4{
	dir = 4
	},
/obj/machinery/atmospherics/pipe/simple/supply/hidden/layer2,
/turf/open/floor/wood,
/area/crew_quarters/bar)
"bE" = (
/obj/structure/sink/kitchen{
	pixel_y = 28
	},
/turf/open/floor/plasteel/cafeteria,
/area/crew_quarters/kitchen)
"bF" = (
/obj/structure/closet/secure_closet/freezer/fridge,
/obj/machinery/camera{
	c_tag = "Kitchen";
	dir = 2
	},
/obj/item/radio/intercom{
	pixel_y = 25
	},
/turf/open/floor/plasteel/cafeteria,
/area/crew_quarters/kitchen)
"bG" = (
/obj/structure/closet/secure_closet/freezer/kitchen,
/obj/machinery/light{
	dir = 1
	},
/obj/machinery/airalarm{
	pixel_y = 24
	},
/turf/open/floor/plasteel/cafeteria,
/area/crew_quarters/kitchen)
"bI" = (
/obj/machinery/light{
	dir = 8
	},
/obj/machinery/computer/security/telescreen/entertainment{
	pixel_x = -31
	},
/obj/machinery/camera{
	c_tag = "Bar West";
	dir = 4
	},
/turf/open/floor/wood,
/area/crew_quarters/bar)
"bJ" = (
/obj/structure/chair/stool/bar,
/obj/machinery/atmospherics/pipe/simple/supply/hidden/layer2{
	dir = 8
	},
/turf/open/floor/wood,
/area/crew_quarters/bar)
"bO" = (
/obj/structure/disposalpipe/segment,
/obj/effect/landmark/start/cook,
/obj/machinery/atmospherics/pipe/simple/supply/hidden/layer2{
	dir = 5
	},
/obj/machinery/atmospherics/pipe/simple/scrubbers/hidden/layer4{
	dir = 5
	},
/turf/open/floor/plasteel/cafeteria,
/area/crew_quarters/kitchen)
"bQ" = (
/obj/machinery/atmospherics/pipe/simple/supply/hidden/layer2{
	dir = 8
	},
/obj/machinery/atmospherics/pipe/simple/scrubbers/hidden/layer4{
	dir = 4
	},
/turf/open/floor/plasteel/cafeteria,
/area/crew_quarters/kitchen)
"bR" = (
/obj/structure/table,
/obj/machinery/microwave{
	pixel_x = -3;
	pixel_y = 6
	},
/turf/open/floor/plasteel/cafeteria,
/area/crew_quarters/kitchen)
"bS" = (
/obj/machinery/atmospherics/pipe/simple/supply/hidden/layer2{
	dir = 10
	},
/obj/machinery/atmospherics/pipe/simple/scrubbers/hidden/layer4{
	dir = 10
	},
/turf/open/floor/plasteel/cafeteria,
/area/crew_quarters/kitchen)
"bU" = (
/obj/structure/table/wood,
/obj/item/reagent_containers/food/snacks/store/cheesewheel/blue,
/obj/structure/window/reinforced/tinted,
/turf/open/floor/wood,
/area/crew_quarters/bar)
"bV" = (
/obj/structure/table/wood/fancy,
/obj/item/reagent_containers/food/snacks/cheesewedge/blue,
/obj/item/reagent_containers/food/snacks/cheesewedge/blue{
	pixel_x = -2;
	pixel_y = 4
	},
/turf/open/floor/wood,
/area/crew_quarters/bar)
"bY" = (
/obj/machinery/door/window/southright{
	name = "Bar Door";
	req_one_access_txt = "25;28"
	},
/turf/open/floor/wood,
/area/crew_quarters/bar)
"cb" = (
/obj/machinery/atmospherics/pipe/simple/supply/hidden/layer2,
/obj/machinery/atmospherics/pipe/simple/scrubbers/hidden/layer4{
	dir = 5
	},
/turf/open/floor/plasteel/cafeteria,
/area/crew_quarters/kitchen)
"cc" = (
/obj/machinery/atmospherics/components/unary/vent_scrubber/on/layer4{
	dir = 8;
	icon_state = "scrub_map_on-3"
	},
/turf/open/floor/plasteel/cafeteria,
/area/crew_quarters/kitchen)
"cd" = (
/obj/machinery/computer/security/telescreen/entertainment{
	pixel_x = 32
	},
/turf/open/floor/wood,
/area/crew_quarters/bar)
"ce" = (
/turf/open/floor/plasteel/cafeteria,
/area/crew_quarters/kitchen)
"ci" = (
/obj/machinery/atmospherics/pipe/simple/supply/hidden/layer2,
/obj/effect/landmark/event_spawn,
/turf/open/floor/plasteel/cafeteria,
/area/crew_quarters/kitchen)
"cj" = (
/obj/machinery/processor,
/turf/open/floor/plasteel/cafeteria,
/area/crew_quarters/kitchen)
"cl" = (
/obj/machinery/door/airlock{
	name = "Kitchen";
	req_access_txt = "28"
	},
/obj/machinery/door/firedoor/border_only{
	dir = 4
	},
/obj/machinery/door/firedoor/border_only{
	dir = 8
	},
/turf/open/floor/wood,
/area/crew_quarters/kitchen)
"cm" = (
/obj/machinery/atmospherics/components/unary/vent_pump/on/layer2{
	dir = 1;
	icon_state = "vent_map_on-1"
	},
/turf/open/floor/plasteel/cafeteria,
/area/crew_quarters/kitchen)
"cn" = (
/obj/machinery/requests_console{
	department = "Kitchen";
	departmentType = 2;
	pixel_x = 30
	},
/turf/open/floor/plasteel/cafeteria,
/area/crew_quarters/kitchen)
"co" = (
/obj/structure/table/wood,
/obj/item/reagent_containers/food/snacks/store/cheesewheel/feta,
/obj/structure/window/reinforced/tinted{
	dir = 1
	},
/turf/open/floor/wood,
/area/crew_quarters/bar)
"cp" = (
/obj/structure/table/wood/fancy,
/obj/item/reagent_containers/food/snacks/cheesewedge/feta,
/obj/item/reagent_containers/food/snacks/cheesewedge/feta{
	pixel_x = -2;
	pixel_y = 4
	},
/turf/open/floor/wood,
/area/crew_quarters/bar)
"cq" = (
/turf/open/floor/wood{
	icon_state = "wood-broken5"
	},
/area/crew_quarters/bar)
"cr" = (
/obj/item/twohanded/required/kirbyplants/random,
/turf/open/floor/wood,
/area/crew_quarters/bar)
"cs" = (
/obj/machinery/button/door{
	id = "kitchen";
	name = "Kitchen Shutters Control";
	pixel_x = -1;
	pixel_y = -24;
	req_access_txt = "28"
	},
/obj/machinery/disposal/bin,
/obj/structure/disposalpipe/trunk{
	dir = 4
	},
/turf/open/floor/plasteel/cafeteria,
/area/crew_quarters/kitchen)
"ct" = (
/obj/structure/disposalpipe/segment{
	dir = 9
	},
/turf/open/floor/plasteel/cafeteria,
/area/crew_quarters/kitchen)
"cu" = (
/obj/structure/table,
/obj/machinery/microwave{
	pixel_x = -3;
	pixel_y = 6
	},
/obj/item/storage/box/donkpockets{
	pixel_x = 3;
	pixel_y = 3
	},
/obj/machinery/light,
/turf/open/floor/plasteel/cafeteria,
/area/crew_quarters/kitchen)
"cv" = (
/obj/structure/disposalpipe/segment,
/turf/open/floor/plasteel/cafeteria,
/area/crew_quarters/kitchen)
"cw" = (
/obj/machinery/door/window/eastright,
/turf/open/floor/wood,
/area/crew_quarters/bar)
"cx" = (
/obj/machinery/light,
/obj/machinery/newscaster{
	pixel_y = -28
	},
/turf/open/floor/wood,
/area/crew_quarters/bar)
"cy" = (
/obj/machinery/camera{
	c_tag = "Bar South";
	dir = 1
	},
/obj/machinery/firealarm{
	dir = 1;
	pixel_y = -26
	},
/turf/open/floor/wood,
/area/crew_quarters/bar)
"cC" = (
/obj/machinery/door/airlock/public/glass{
	name = "Diner"
	},
/obj/machinery/door/firedoor/border_only{
	dir = 1
	},
/obj/machinery/door/firedoor/border_only,
/turf/open/floor/wood,
/area/crew_quarters/bar)
"cD" = (
/obj/effect/landmark/start/bartender,
/obj/machinery/atmospherics/pipe/simple/supply/hidden/layer2{
	dir = 8
	},
/turf/open/floor/wood,
/area/crew_quarters/bar)
"cE" = (
/obj/machinery/atmospherics/components/unary/vent_pump/on/layer2{
	dir = 8;
	icon_state = "vent_map_on-1"
	},
/turf/open/floor/wood,
/area/crew_quarters/bar)
"cF" = (
/obj/machinery/door/window/eastleft,
/obj/machinery/atmospherics/pipe/simple/supply/hidden/layer2{
	dir = 8
	},
/turf/open/floor/wood,
/area/crew_quarters/bar)
"cG" = (
/obj/machinery/atmospherics/pipe/simple/scrubbers/hidden/layer4{
	dir = 5
	},
/obj/machinery/atmospherics/pipe/simple/supply/hidden/layer2{
	dir = 9
	},
/turf/open/floor/wood,
/area/crew_quarters/bar)
"cH" = (
/obj/structure/chair/stool/bar,
/obj/machinery/atmospherics/pipe/simple/scrubbers/hidden/layer4{
	dir = 4
	},
/turf/open/floor/wood,
/area/crew_quarters/bar)
"cI" = (
/obj/effect/landmark/start/cook,
/turf/open/floor/plasteel/cafeteria,
/area/crew_quarters/kitchen)
"cK" = (
/obj/machinery/atmospherics/components/unary/vent_scrubber/on/layer4{
	dir = 8;
	icon_state = "scrub_map_on-3"
	},
/turf/open/floor/wood,
/area/crew_quarters/bar)
"dh" = (
/obj/structure/sign/barsign,
/turf/closed/wall,
/area/crew_quarters/bar)
"dI" = (
/obj/machinery/light{
	dir = 4
	},
/obj/structure/sign/warning/securearea{
	desc = "Under the painting a plaque reads: 'While the meat grinder may not have spared you, fear not. Not one part of you has gone to waste... You were delicious.'";
	icon_state = "monkey_painting";
	name = "Mr. Deempisi portrait";
	pixel_x = 28;
	pixel_y = -4
	},
/obj/machinery/chem_dispenser/drinks/beer{
	dir = 8
	},
/obj/structure/table,
/obj/item/radio/intercom{
	pixel_y = 25
	},
/turf/open/floor/wood,
/area/crew_quarters/bar)
"hk" = (
/obj/effect/landmark/xeno_spawn,
/turf/open/floor/wood,
/area/crew_quarters/bar)
"iI" = (
/obj/machinery/atmospherics/pipe/simple/supply/hidden/layer2{
	dir = 8
	},
/obj/structure/table/wood,
/obj/machinery/door/poddoor/shutters/preopen{
	id = "barshutters";
	name = "bar shutters"
	},
/turf/open/floor/wood,
/area/crew_quarters/bar)
"jf" = (
/obj/item/reagent_containers/food/drinks/drinkingglass,
/obj/item/reagent_containers/glass/rag,
/obj/structure/table/wood,
/obj/machinery/door/poddoor/shutters/preopen{
	id = "barshutters";
	name = "bar shutters"
	},
/turf/open/floor/wood,
/area/crew_quarters/bar)
"kA" = (
/obj/structure/closet/secure_closet/freezer/meat{
	name = "cured meat fridge"
	},
/obj/item/toy/figure/chef,
/turf/open/floor/plasteel/cafeteria,
/area/crew_quarters/kitchen)
"kC" = (
/obj/structure/table,
/obj/machinery/chem_dispenser/drinks{
	dir = 8
	},
/obj/machinery/firealarm{
	dir = 8;
	pixel_x = 26
	},
/turf/open/floor/wood,
/area/crew_quarters/bar)
"kT" = (
/obj/machinery/computer/arcade,
/turf/open/floor/wood,
/area/crew_quarters/bar)
"nY" = (
/obj/item/reagent_containers/food/drinks/drinkingglass,
/obj/structure/table/wood,
/obj/machinery/door/poddoor/shutters/preopen{
	id = "barshutters";
	name = "bar shutters"
	},
/turf/open/floor/wood,
/area/crew_quarters/bar)
"oC" = (
/obj/item/stack/sheet/metal/fifty,
/obj/item/stack/sheet/glass/fifty,
/obj/item/stack/cable_coil,
/obj/item/flashlight/lamp,
/obj/item/flashlight/lamp/green,
/obj/structure/closet/secure_closet/bartender,
/turf/open/floor/wood,
/area/crew_quarters/bar)
"qS" = (
/obj/item/book/manual/wiki/barman_recipes,
/obj/item/reagent_containers/food/drinks/drinkingglass,
/obj/structure/table/wood,
/obj/machinery/door/poddoor/shutters/preopen{
	id = "barshutters";
	name = "bar shutters"
	},
/turf/open/floor/wood,
/area/crew_quarters/bar)
"rk" = (
/obj/structure/table,
/obj/machinery/firealarm{
	dir = 8;
	pixel_x = 26
	},
/obj/machinery/reagentgrinder/kitchen{
	pixel_y = 10
	},
/turf/open/floor/plasteel/cafeteria,
/area/crew_quarters/kitchen)
"rA" = (
/obj/effect/landmark/blobstart,
/obj/item/reagent_containers/food/snacks/store/cheesewheel/cheddar,
/turf/open/floor/plating,
/area/crew_quarters/bar)
"rW" = (
/obj/machinery/light{
	dir = 1;
	light_color = "#706891"
	},
/obj/machinery/vending/dinnerware,
/turf/open/floor/plasteel/cafeteria,
/area/crew_quarters/kitchen)
"tG" = (
/obj/machinery/food_cart,
/turf/open/floor/plasteel/cafeteria,
/area/crew_quarters/kitchen)
"tV" = (
/obj/structure/table/wood,
/obj/structure/sign/poster/official/fruit_bowl{
	pixel_x = 32
	},
/obj/item/reagent_containers/food/snacks/grown/grapes{
	pixel_x = -2;
	pixel_y = 7
	},
/obj/item/reagent_containers/food/snacks/grown/grapes/green{
	pixel_x = 4;
	pixel_y = 3
	},
/obj/item/toy/figure/bartender,
/turf/open/floor/wood,
/area/crew_quarters/bar)
"ul" = (
/obj/machinery/vending/boozeomat,
/turf/open/floor/wood,
/area/crew_quarters/bar)
"vy" = (
/obj/structure/table/wood,
/obj/machinery/door/poddoor/shutters/preopen{
	id = "barshutters";
	name = "bar shutters"
	},
/obj/item/clothing/head/hardhat/cakehat,
/turf/open/floor/wood,
/area/crew_quarters/bar)
"vN" = (
/obj/structure/disposalpipe/segment,
/obj/structure/table,
/obj/item/reagent_containers/food/snacks/mint,
/obj/item/reagent_containers/glass/mixbowl{
	pixel_x = 1;
	pixel_y = 4
	},
/turf/open/floor/plasteel/cafeteria,
/area/crew_quarters/kitchen)
"we" = (
/obj/machinery/deepfryer,
/turf/open/floor/plasteel/cafeteria,
/area/crew_quarters/kitchen)
"zN" = (
/obj/structure/table/reinforced,
/obj/machinery/door/poddoor/shutters/preopen{
	id = "kitchen";
	name = "kitchen shutters"
	},
/obj/machinery/door/firedoor/border_only{
	dir = 1
	},
/obj/machinery/door/firedoor/border_only,
/turf/open/floor/plasteel/cafeteria,
/area/crew_quarters/kitchen)
"BJ" = (
/obj/machinery/light/small{
	dir = 4
	},
/turf/open/floor/wood,
/area/crew_quarters/bar)
"BM" = (
/obj/structure/table/wood,
/obj/item/reagent_containers/food/drinks/bottle/wine{
	pixel_x = -4
	},
/obj/item/reagent_containers/food/drinks/bottle/wine{
	pixel_x = 4
	},
/obj/item/reagent_containers/food/drinks/bottle/lizardwine,
/obj/machinery/door/poddoor/shutters/preopen{
	id = "barshutters";
	name = "bar shutters"
	},
/turf/open/floor/wood,
/area/crew_quarters/bar)
"Dl" = (
/obj/structure/disposalpipe/segment,
/obj/machinery/griddle,
/turf/open/floor/plasteel/cafeteria,
/area/crew_quarters/kitchen)
"Ew" = (
/obj/machinery/light/small{
	dir = 8
	},
/obj/machinery/airalarm{
	dir = 4;
	pixel_x = -24
	},
/obj/machinery/atmospherics/components/unary/vent_scrubber/on/layer4{
	dir = 1;
	icon_state = "scrub_map_on-3"
	},
/obj/machinery/reagentgrinder,
/obj/structure/table/wood,
/turf/open/floor/wood,
/area/crew_quarters/bar)
"EV" = (
/obj/structure/table,
/obj/item/book/manual/chef_recipes,
/obj/item/reagent_containers/food/condiment/enzyme{
	layer = 5
	},
/turf/open/floor/plasteel/cafeteria,
/area/crew_quarters/kitchen)
"Fb" = (
/obj/machinery/light/small{
	dir = 8
	},
/obj/machinery/icecream_vat,
/turf/open/floor/plasteel/showroomfloor,
/area/crew_quarters/kitchen)
"Hm" = (
/obj/machinery/button/door{
	id = "barshutters";
	name = "Bar Shutters Control";
	pixel_y = 24;
	req_access_txt = "25"
	},
/turf/open/floor/wood,
/area/crew_quarters/bar)
"IK" = (
/obj/structure/table/wood,
/obj/machinery/door/poddoor/shutters/preopen{
	id = "barshutters";
	name = "bar shutters"
	},
/turf/open/floor/wood,
/area/crew_quarters/bar)
"Ju" = (
/obj/structure/extinguisher_cabinet{
	pixel_y = -30
	},
/turf/open/floor/wood,
/area/crew_quarters/bar)
"KK" = (
/obj/structure/disposalpipe/segment,
/obj/machinery/door/airlock/maintenance{
	name = "Bar Maintenance";
	req_access_txt = "12"
	},
/turf/open/floor/plating,
/area/maintenance/starboard/fore)
"PB" = (
/obj/machinery/atmospherics/pipe/simple/scrubbers/hidden/layer4{
	dir = 4
	},
/obj/structure/table/wood,
/obj/machinery/door/poddoor/shutters/preopen{
	id = "barshutters";
	name = "bar shutters"
	},
/turf/open/floor/wood,
/area/crew_quarters/bar)
"PP" = (
/obj/effect/spawner/structure/window,
/obj/machinery/door/poddoor/preopen{
	id = "barshutters";
	name = "privacy shutters"
	},
/turf/open/floor/plating,
/area/crew_quarters/bar)
"SE" = (
/obj/machinery/smartfridge/drinks,
/obj/machinery/door/poddoor/preopen{
	id = "barshutters";
	name = "privacy shutters"
	},
/turf/open/floor/wood,
/area/crew_quarters/bar)
"UZ" = (
/obj/machinery/camera{
	c_tag = "Bar Storage"
	},
/obj/machinery/atmospherics/components/unary/vent_pump/on/layer2{
	dir = 8;
	icon_state = "vent_map_on-1"
	},
/obj/structure/sink/kitchen{
	pixel_y = 28
	},
/turf/open/floor/wood,
/area/crew_quarters/bar)
"XV" = (
/obj/structure/table/reinforced,
/obj/machinery/door/poddoor/shutters/preopen{
	id = "kitchen";
	name = "kitchen shutters"
	},
/obj/item/reagent_containers/food/snacks/baguette,
/obj/machinery/door/firedoor/border_only{
	dir = 1
	},
/obj/machinery/door/firedoor/border_only,
/turf/open/floor/plasteel/cafeteria,
/area/crew_quarters/kitchen)
"XY" = (
/obj/machinery/oven,
/turf/open/floor/plasteel/cafeteria,
/area/crew_quarters/kitchen)
"ZP" = (
/obj/machinery/atmospherics/pipe/simple/scrubbers/hidden/layer4,
/obj/machinery/atmospherics/pipe/simple/supply/hidden/layer2,
/obj/effect/spawner/xmastree,
/turf/open/floor/wood{
	icon_state = "wood-broken6"
	},
/area/crew_quarters/bar)

(1,1,1) = {"
aa
aa
ag
ag
PP
PP
ag
ag
ag
PP
PP
ag
ag
ag
"}
(2,1,1) = {"
aa
aa
aB
aR
bh
bh
bw
bI
bU
bh
bh
co
aB
ag
"}
(3,1,1) = {"
aa
aa
aB
aS
bh
bh
aS
bA
aS
bh
bi
aS
aB
ag
"}
(4,1,1) = {"
ag
aj
aB
aT
bh
bh
bx
au
bV
bh
bh
cp
aB
PP
"}
(5,1,1) = {"
ab
bj
aD
aT
bh
bh
bx
au
bV
bh
bh
cp
aB
PP
"}
(6,1,1) = {"
ag
aB
aG
aU
bi
aF
aU
au
aU
bh
bh
aU
aB
ag
"}
(7,1,1) = {"
ag
ap
aH
an
bh
bB
aZ
cF
an
bh
bh
aZ
cw
ag
"}
(8,1,1) = {"
ag
aq
aG
aB
aB
aE
aB
au
aB
aB
aB
cq
cx
ag
"}
(9,1,1) = {"
ag
aB
aI
ZP
bj
bC
am
cG
aB
aB
aB
aB
Ju
dh
"}
(10,1,1) = {"
KK
ar
aB
aX
aY
bn
bJ
cH
aY
aB
aB
aB
aB
ag
"}
(11,1,1) = {"
ag
as
aJ
aY
IK
nY
iI
PB
IK
aY
aB
aB
cy
ag
"}
(12,1,1) = {"
ag
ag
ag
aC
vy
aB
au
aE
BM
aY
aB
aX
aB
cC
"}
(13,1,1) = {"
ae
aK
ag
ag
ag
ul
cD
cK
qS
aY
aB
aB
aB
cC
"}
(14,1,1) = {"
ah
at
Ew
ba
ag
Hm
au
aB
jf
aY
aB
aB
kT
ag
"}
(15,1,1) = {"
oC
au
hk
aB
bl
aB
cE
br
bY
aB
aB
aB
bz
ag
"}
(16,1,1) = {"
ag
UZ
aM
ag
ag
ag
dI
kC
SE
cd
aB
cr
ag
ag
"}
(17,1,1) = {"
ak
BJ
tV
ag
rA
al
al
al
al
al
cl
al
al
aa
"}
(18,1,1) = {"
al
al
al
al
al
al
rW
ce
we
we
ce
cs
al
aa
"}
(19,1,1) = {"
al
bc
Fb
bq
bq
al
bE
ce
EV
XY
ce
by
XV
aa
"}
(20,1,1) = {"
ai
ay
aP
bd
ay
bv
be
bO
vN
Dl
cv
ct
zN
aa
"}
(21,1,1) = {"
al
az
aQ
bf
bt
al
tG
bQ
ce
ce
cI
ce
zN
aa
"}
(22,1,1) = {"
ao
aA
bu
bt
bt
al
bF
bS
cb
ci
cm
ce
zN
aa
"}
(23,1,1) = {"
al
al
al
bg
bm
al
bG
ce
cc
cj
ce
cu
al
aa
"}
(24,1,1) = {"
aa
aa
al
al
al
al
kA
ce
ce
rk
cn
bR
al
aa
"}
