//MAP CONVERTED BY dmm2tgm.py THIS HEADER COMMENT PREVENTS RECONVERSION, DO NOT REMOVE
"a" = (
/mob/living/simple_animal/spiffles,
/turf/open/floor/wood,
/area/space)
"b" = (
/obj/machinery/light{
	dir = 4
	},
/turf/open/floor/wood,
/area/space)
"c" = (
/obj/machinery/atmospherics/pipe/simple/scrubbers/hidden/layer4{
	dir = 5
	},
/obj/machinery/atmospherics/pipe/simple/supply/hidden/layer2{
	dir = 9
	},
/turf/open/floor/wood,
/area/space)
"d" = (
/obj/machinery/vending/autodrobe,
/turf/open/floor/wood,
/area/space)
"e" = (
/obj/structure/sign/poster/official/random{
	pixel_x = 32
	},
/turf/open/floor/wood,
/area/space)
"f" = (
/obj/machinery/door/poddoor/shutters/preopen{
	id = "gamblinghall_ext"
	},
/obj/effect/spawner/structure/window,
/turf/open/floor/plating,
/area/clerk)
"g" = (
/obj/structure/chair/stool,
/obj/structure/extinguisher_cabinet{
	pixel_x = 27
	},
/turf/open/floor/wood,
/area/space)
"h" = (
/obj/structure/table/wood/poker,
/obj/machinery/door/poddoor/shutters{
	id = "gamblinghall"
	},
/obj/item/toy/cards/deck,
/turf/open/floor/wood,
/area/space)
"i" = (
/obj/structure/table/wood,
/obj/item/coinstack,
/obj/item/coin/gold,
/obj/item/coin/gold,
/obj/item/coin/gold,
/obj/item/coin/plasma,
/obj/item/coin/uranium,
/obj/item/coin/diamond,
/obj/item/coin/iron,
/obj/item/coin/iron,
/turf/open/floor/wood,
/area/space)
"k" = (
/obj/machinery/atmospherics/components/unary/vent_scrubber/on/layer4{
	dir = 4
	},
/obj/machinery/button/door{
	id = "gamblinghall";
	name = "Gift Shop Internal Shutters";
	pixel_x = -6;
	pixel_y = -24
	},
/obj/machinery/button/door{
	id = "gamblinghall_ext";
	name = "Gift Shop External Shutters";
	pixel_x = 6;
	pixel_y = -24
	},
/turf/open/floor/wood,
/area/space)
"l" = (
/turf/open/floor/wood,
/area/space)
"m" = (
/obj/machinery/door/firedoor/border_only{
	dir = 1
	},
/obj/machinery/door/firedoor/border_only,
/obj/machinery/door/airlock{
	name = "Gambling Hall"
	},
/obj/machinery/door/poddoor/shutters/preopen{
	id = "gamblinghall_ext"
	},
/turf/open/floor/wood,
/area/clerk)
"n" = (
/obj/machinery/camera{
	c_tag = "Clerk's Gambling Hall"
	},
/turf/open/floor/wood,
/area/space)
"o" = (
/obj/structure/table/wood,
/obj/item/a_gift{
	pixel_x = -5;
	pixel_y = -2
	},
/obj/item/a_gift{
	pixel_x = 7;
	pixel_y = 4
	},
/turf/open/floor/wood,
/area/space)
"q" = (
/obj/structure/cable{
	icon_state = "1-4"
	},
/obj/machinery/atmospherics/pipe/simple/scrubbers/hidden/layer4,
/obj/machinery/atmospherics/pipe/simple/supply/hidden/layer2{
	dir = 5
	},
/obj/machinery/atmospherics/pipe/simple/supply/hidden/layer2,
/turf/open/floor/wood,
/area/space)
"r" = (
/obj/machinery/firealarm{
	dir = 1;
	pixel_y = -28
	},
/turf/open/floor/wood,
/area/space)
"s" = (
/obj/structure/chair,
/turf/open/floor/wood,
/area/space)
"t" = (
/obj/structure/table/wood,
/obj/machinery/paystand/register{
	dir = 1
	},
/obj/machinery/light{
	dir = 8
	},
/turf/open/floor/wood,
/area/space)
"u" = (
/obj/structure/table/wood/poker,
/obj/machinery/door/poddoor/shutters{
	id = "gamblinghall"
	},
/turf/open/floor/wood,
/area/space)
"v" = (
/turf/template_noop,
/area/template_noop)
"w" = (
/obj/machinery/vending/games,
/obj/machinery/light{
	dir = 1
	},
/turf/open/floor/wood,
/area/space)
"x" = (
/obj/machinery/vending/coffee,
/obj/machinery/light{
	dir = 8
	},
/turf/open/floor/wood,
/area/space)
"y" = (
/obj/machinery/atmospherics/pipe/simple/scrubbers/hidden/layer4,
/obj/machinery/atmospherics/pipe/simple/supply/hidden/layer2,
/turf/open/floor/wood,
/area/space)
"z" = (
/obj/machinery/vending/cigarette,
/turf/open/floor/wood,
/area/space)
"A" = (
/obj/machinery/vending/gifts,
/turf/open/floor/wood,
/area/space)
"B" = (
/obj/machinery/firealarm{
	pixel_y = 28
	},
/obj/structure/cable{
	icon_state = "4-8"
	},
/obj/machinery/atmospherics/pipe/simple/supply/hidden/layer2{
	dir = 4
	},
/turf/open/floor/wood,
/area/space)
"C" = (
/obj/structure/chair/stool,
/turf/open/floor/wood,
/area/space)
"E" = (
/obj/machinery/atmospherics/pipe/simple/scrubbers/hidden/layer4{
	dir = 4
	},
/turf/open/floor/wood,
/area/space)
"F" = (
/obj/machinery/door/airlock{
	name = "Gambling Hall";
	req_access_txt = "36"
	},
/obj/machinery/door/firedoor/border_only,
/obj/machinery/door/firedoor/border_only{
	dir = 1
	},
/obj/machinery/atmospherics/pipe/simple/scrubbers/hidden/layer4,
/obj/machinery/atmospherics/pipe/simple/supply/hidden/layer2,
/obj/structure/cable{
	icon_state = "1-2"
	},
/turf/open/floor/wood,
/area/clerk)
"G" = (
/obj/effect/spawner/structure/window,
/obj/machinery/door/poddoor/shutters/preopen{
	id = "gamblinghall_ext"
	},
/turf/open/floor/plating,
/area/clerk)
"H" = (
/obj/item/storage/secure/safe{
	pixel_x = 5;
	pixel_y = -25
	},
/turf/open/floor/wood,
/area/space)
"J" = (
/obj/machinery/door/firedoor/border_only,
/obj/machinery/door/firedoor/border_only{
	dir = 1
	},
/obj/machinery/door/airlock{
	name = "Gambling Hall";
	req_access_txt = "36"
	},
/obj/machinery/atmospherics/pipe/simple/scrubbers/hidden/layer4,
/obj/machinery/atmospherics/pipe/simple/supply/hidden/layer2,
/turf/open/floor/wood,
/area/space)
"L" = (
/obj/machinery/vending/cola/random,
/turf/open/floor/wood,
/area/space)
"N" = (
/obj/structure/chair/stool,
/obj/machinery/light{
	dir = 1
	},
/turf/open/floor/wood,
/area/space)
"O" = (
/turf/closed/wall,
/area/clerk)
"P" = (
/obj/machinery/atmospherics/components/unary/vent_pump/on/layer2{
	dir = 4
	},
/turf/open/floor/wood,
/area/space)
"R" = (
/obj/structure/chair/stool,
/obj/machinery/atmospherics/pipe/simple/scrubbers/hidden/layer4{
	dir = 10
	},
/turf/open/floor/wood,
/area/space)
"S" = (
/obj/machinery/atmospherics/components/unary/vent_pump/on/layer2{
	dir = 8
	},
/turf/open/floor/wood,
/area/space)
"U" = (
/obj/machinery/door/firedoor/border_only,
/obj/machinery/door/firedoor/border_only{
	dir = 1
	},
/obj/machinery/door/airlock{
	name = "Gambling Hall"
	},
/obj/machinery/door/poddoor/shutters/preopen{
	id = "gamblinghall_ext"
	},
/turf/open/floor/wood,
/area/clerk)
"V" = (
/turf/closed/wall,
/area/space)
"W" = (
/obj/machinery/atmospherics/components/unary/vent_scrubber/on/layer4{
	dir = 1
	},
/turf/open/floor/wood,
/area/space)
"X" = (
/obj/structure/chair/stool,
/obj/machinery/atmospherics/pipe/simple/scrubbers/hidden/layer4{
	dir = 4
	},
/turf/open/floor/wood,
/area/space)
"Y" = (
/obj/machinery/power/apc{
	areastring = "/area/clerk";
	dir = 1;
	name = "Gift Shop APC";
	pixel_y = 23
	},
/obj/structure/cable{
	icon_state = "0-8"
	},
/obj/machinery/atmospherics/pipe/simple/supply/hidden/layer2{
	dir = 4
	},
/turf/open/floor/wood,
/area/space)
"Z" = (
/obj/machinery/atmospherics/pipe/manifold/scrubbers/hidden/layer4{
	dir = 4
	},
/obj/machinery/atmospherics/pipe/simple/supply/hidden/layer2,
/turf/open/floor/wood,
/area/space)

(1,1,1) = {"
v
O
O
O
O
O
O
O
O
"}
(2,1,1) = {"
v
O
o
t
V
L
x
z
O
"}
(3,1,1) = {"
v
O
l
k
V
n
P
l
f
"}
(4,1,1) = {"
v
F
q
Z
J
y
c
l
m
"}
(5,1,1) = {"
v
O
B
H
V
N
E
l
G
"}
(6,1,1) = {"
O
O
Y
l
h
u
X
l
U
"}
(7,1,1) = {"
O
A
S
l
s
u
R
W
G
"}
(8,1,1) = {"
O
w
a
l
u
u
C
r
O
"}
(9,1,1) = {"
O
d
C
i
V
g
b
e
O
"}
(10,1,1) = {"
O
O
O
O
O
O
O
O
O
"}
