//MAP CONVERTED BY dmm2tgm.py THIS HEADER COMMENT PREVENTS RECONVERSION, DO NOT REMOVE
"c" = (
/obj/structure/chair/stool{
	pixel_y = 8
	},
/turf/open/floor/wood,
/area/template_noop)
"d" = (
/obj/effect/landmark/xeno_spawn,
/obj/machinery/atmospherics/pipe/simple/scrubbers/hidden/layer4{
	dir = 5
	},
/obj/machinery/atmospherics/pipe/simple/supply/hidden/layer2{
	dir = 5
	},
/turf/open/floor/wood,
/area/template_noop)
"n" = (
/obj/machinery/light/small{
	dir = 8
	},
/obj/machinery/atmospherics/components/unary/vent_scrubber/on/layer4{
	dir = 4
	},
/obj/structure/table/wood,
/turf/open/floor/wood,
/area/template_noop)
"s" = (
/obj/structure/closet/secure_closet/personal,
/obj/machinery/atmospherics/pipe/simple/scrubbers/hidden/layer4{
	dir = 10
	},
/obj/machinery/atmospherics/pipe/simple/supply/hidden/layer2{
	dir = 6
	},
/turf/open/floor/wood,
/area/template_noop)
"G" = (
/obj/structure/bed,
/obj/machinery/airalarm{
	pixel_y = 24
	},
/obj/machinery/atmospherics/components/unary/vent_pump/on/layer2{
	dir = 8
	},
/obj/item/bedsheet/brown,
/turf/open/floor/wood,
/area/template_noop)
"L" = (
/obj/machinery/atmospherics/pipe/simple/scrubbers/hidden/layer4{
	dir = 4
	},
/obj/machinery/atmospherics/pipe/simple/supply/hidden/layer2{
	dir = 8
	},
/turf/open/floor/wood,
/area/template_noop)

(1,1,1) = {"
n
c
"}
(2,1,1) = {"
s
d
"}
(3,1,1) = {"
G
L
"}
