//MAP CONVERTED BY dmm2tgm.py THIS HEADER COMMENT PREVENTS RECONVERSION, DO NOT REMOVE
"j" = (
/obj/machinery/atmospherics/pipe/simple/scrubbers/hidden/layer4{
	dir = 4
	},
/obj/machinery/atmospherics/pipe/simple/supply/hidden/layer2{
	dir = 8
	},
/turf/open/floor/carpet,
/area/template_noop)
"k" = (
/obj/structure/chair/stool{
	pixel_y = 8
	},
/turf/open/floor/carpet,
/area/template_noop)
"z" = (
/obj/structure/closet/secure_closet/personal,
/obj/machinery/atmospherics/pipe/simple/scrubbers/hidden/layer4{
	dir = 10
	},
/obj/machinery/atmospherics/pipe/simple/supply/hidden/layer2{
	dir = 6
	},
/turf/open/floor/carpet,
/area/template_noop)
"J" = (
/obj/structure/table,
/obj/machinery/light/small{
	dir = 8
	},
/obj/machinery/atmospherics/components/unary/vent_scrubber/on/layer4{
	dir = 4
	},
/turf/open/floor/carpet,
/area/template_noop)
"L" = (
/obj/structure/bed,
/obj/item/bedsheet,
/obj/machinery/airalarm{
	pixel_y = 24
	},
/obj/machinery/atmospherics/components/unary/vent_pump/on/layer2{
	dir = 8
	},
/turf/open/floor/carpet,
/area/template_noop)
"Q" = (
/obj/effect/landmark/xeno_spawn,
/obj/machinery/atmospherics/pipe/simple/scrubbers/hidden/layer4{
	dir = 5
	},
/obj/machinery/atmospherics/pipe/simple/supply/hidden/layer2{
	dir = 5
	},
/turf/open/floor/carpet,
/area/template_noop)

(1,1,1) = {"
J
k
"}
(2,1,1) = {"
z
Q
"}
(3,1,1) = {"
L
j
"}
