//MAP CONVERTED BY dmm2tgm.py THIS HEADER COMMENT PREVENTS RECONVERSION, DO NOT REMOVE
"c" = (
/obj/effect/landmark/xeno_spawn,
/obj/machinery/atmospherics/pipe/simple/scrubbers/hidden/layer3{
	dir = 5
	},
/obj/machinery/atmospherics/pipe/simple/supply/hidden/layer1{
	dir = 5
	},
/turf/open/floor/wood,
/area/crew_quarters/dorms)
"j" = (
/obj/machinery/atmospherics/pipe/simple/scrubbers/hidden/layer3{
	dir = 4
	},
/obj/machinery/atmospherics/pipe/simple/supply/hidden/layer1{
	dir = 8
	},
/turf/open/floor/wood,
/area/crew_quarters/dorms)
"s" = (
/obj/structure/bed,
/obj/machinery/airalarm{
	pixel_y = 24
	},
/obj/machinery/atmospherics/components/unary/vent_pump/on/layer1{
	dir = 8
	},
/obj/item/bedsheet/brown,
/turf/open/floor/wood,
/area/crew_quarters/dorms)
"E" = (
/turf/closed/wall,
/area/crew_quarters/dorms)
"H" = (
/obj/machinery/light/small{
	dir = 8
	},
/obj/machinery/atmospherics/components/unary/vent_scrubber/on/layer3{
	dir = 4
	},
/obj/structure/table/wood,
/turf/open/floor/wood,
/area/crew_quarters/dorms)
"I" = (
/obj/structure/closet/secure_closet/personal,
/obj/machinery/atmospherics/pipe/simple/scrubbers/hidden/layer3{
	dir = 10
	},
/obj/machinery/atmospherics/pipe/simple/supply/hidden/layer1{
	dir = 6
	},
/turf/open/floor/wood,
/area/crew_quarters/dorms)
"Q" = (
/obj/structure/chair/stool{
	pixel_y = 8
	},
/turf/open/floor/wood,
/area/crew_quarters/dorms)

(1,1,1) = {"
E
E
E
E
"}
(2,1,1) = {"
E
H
Q
E
"}
(3,1,1) = {"
E
I
c
E
"}
(4,1,1) = {"
E
s
j
E
"}
(5,1,1) = {"
E
E
j
E
"}
