//MAP CONVERTED BY dmm2tgm.py THIS HEADER COMMENT PREVENTS RECONVERSION, DO NOT REMOVE
"c" = (
/obj/structure/closet/secure_closet/personal,
/obj/machinery/atmospherics/pipe/simple/scrubbers/hidden/layer4{
	dir = 10
	},
/obj/machinery/atmospherics/pipe/simple/supply/hidden/layer2{
	dir = 6
	},
/turf/open/floor/carpet,
/area/crew_quarters/dorms)
"e" = (
/obj/effect/landmark/xeno_spawn,
/obj/machinery/atmospherics/pipe/simple/scrubbers/hidden/layer4{
	dir = 5
	},
/obj/machinery/atmospherics/pipe/simple/supply/hidden/layer2{
	dir = 5
	},
/turf/open/floor/carpet,
/area/crew_quarters/dorms)
"E" = (
/turf/closed/wall,
/area/crew_quarters/dorms)
"I" = (
/obj/structure/bed,
/obj/item/bedsheet,
/obj/machinery/airalarm{
	pixel_y = 24
	},
/obj/machinery/atmospherics/components/unary/vent_pump/on/layer2{
	dir = 8
	},
/turf/open/floor/carpet,
/area/crew_quarters/dorms)
"J" = (
/obj/structure/table,
/obj/machinery/light/small{
	dir = 8
	},
/obj/machinery/atmospherics/components/unary/vent_scrubber/on/layer4{
	dir = 4
	},
/turf/open/floor/carpet,
/area/crew_quarters/dorms)
"L" = (
/obj/machinery/atmospherics/pipe/simple/scrubbers/hidden/layer4{
	dir = 4
	},
/obj/machinery/atmospherics/pipe/simple/supply/hidden/layer2{
	dir = 8
	},
/turf/open/floor/plasteel,
/area/crew_quarters/dorms)
"R" = (
/obj/machinery/atmospherics/pipe/simple/scrubbers/hidden/layer4{
	dir = 4
	},
/obj/machinery/atmospherics/pipe/simple/supply/hidden/layer2{
	dir = 8
	},
/turf/open/floor/carpet,
/area/crew_quarters/dorms)
"X" = (
/obj/structure/chair/stool{
	pixel_y = 8
	},
/turf/open/floor/carpet,
/area/crew_quarters/dorms)

(1,1,1) = {"
E
E
E
E
"}
(2,1,1) = {"
E
J
X
E
"}
(3,1,1) = {"
E
c
e
E
"}
(4,1,1) = {"
E
I
R
E
"}
(5,1,1) = {"
E
E
L
E
"}
