//MAP CONVERTED BY dmm2tgm.py THIS HEADER COMMENT PREVENTS RECONVERSION, DO NOT REMOVE
"ab" = (
/turf/template_noop,
/area/template_noop)
"ac" = (
/obj/effect/spawner/structure/window/plasma/reinforced,
/turf/open/floor/plating,
/area/engine/engineering)
"ad" = (
/turf/closed/wall/r_wall,
/area/engine/engineering)
"ag" = (
/obj/structure/table,
/obj/item/clothing/gloves/color/yellow,
/obj/item/storage/toolbox/electrical{
	pixel_y = 5
	},
/turf/open/floor/plasteel,
/area/engine/engineering)
"ah" = (
/obj/structure/cable/yellow{
	icon_state = "4-8"
	},
/obj/effect/spawner/structure/window/plasma/reinforced,
/turf/open/floor/plating,
/area/engine/engineering)
"au" = (
/turf/open/floor/plasteel,
/area/engine/engineering)
"av" = (
/obj/machinery/atmospherics/pipe/simple/orange/hidden,
/turf/closed/wall,
/area/engine/engineering)
"aJ" = (
/obj/effect/turf_decal/stripes/line{
	dir = 8
	},
/turf/open/floor/engine,
/area/engine/engineering)
"aM" = (
/obj/structure/cable/yellow{
	icon_state = "4-8"
	},
/turf/open/floor/engine,
/area/engine/engineering)
"aY" = (
/obj/effect/turf_decal/stripes/line{
	dir = 9
	},
/turf/open/floor/engine,
/area/engine/engineering)
"ba" = (
/obj/machinery/atmospherics/components/binary/valve/digital{
	dir = 4;
	name = "Moderator Purge"
	},
/turf/open/floor/engine,
/area/engine/engineering)
"bb" = (
/turf/closed/wall,
/area/engine/engineering)
"bf" = (
/obj/effect/turf_decal/stripes/line{
	dir = 1
	},
/obj/effect/turf_decal/delivery,
/obj/structure/closet/radiation,
/obj/item/clothing/glasses/meson/engine,
/obj/machinery/light/small{
	dir = 1
	},
/obj/structure/sign/warning/radiation{
	pixel_y = 32
	},
/turf/open/floor/plasteel/dark,
/area/engine/engineering)
"bk" = (
/obj/machinery/atmospherics/pipe/simple/scrubbers/visible{
	dir = 4
	},
/obj/effect/spawner/structure/window/plasma/reinforced,
/turf/open/floor/engine,
/area/engine/engineering)
"bq" = (
/obj/structure/rack,
/obj/item/clothing/mask/gas{
	pixel_x = 3;
	pixel_y = 3
	},
/obj/item/clothing/mask/gas,
/obj/item/clothing/mask/gas{
	pixel_x = -3;
	pixel_y = -3
	},
/turf/open/floor/plasteel,
/area/engine/engineering)
"bt" = (
/obj/effect/turf_decal/stripes/line{
	dir = 8
	},
/obj/structure/cable/yellow{
	icon_state = "4-8"
	},
/turf/open/floor/plasteel/dark,
/area/engine/engineering)
"bN" = (
/turf/open/floor/plasteel/dark,
/area/engine/engineering)
"bQ" = (
/obj/machinery/light{
	dir = 1
	},
/obj/effect/turf_decal/stripes/line{
	dir = 9
	},
/turf/open/floor/engine,
/area/engine/engineering)
"bW" = (
/obj/effect/turf_decal/stripes/line{
	dir = 10
	},
/obj/machinery/shower{
	dir = 4
	},
/turf/open/floor/noslip,
/area/engine/engineering)
"cc" = (
/obj/machinery/atmospherics/components/binary/valve/digital{
	dir = 4;
	name = "Emergency Coolant Purge"
	},
/turf/open/floor/engine,
/area/engine/engineering)
"cy" = (
/obj/effect/turf_decal/stripes/line{
	dir = 10
	},
/turf/open/floor/engine,
/area/engine/engineering)
"cA" = (
/turf/open/floor/engine,
/area/engine/engineering)
"cY" = (
/obj/structure/lattice,
/obj/structure/grille,
/turf/template_noop,
/area/space)
"dp" = (
/obj/machinery/atmospherics/pipe/simple/scrubbers/visible{
	dir = 4
	},
/turf/open/floor/engine,
/area/engine/engineering)
"dx" = (
/obj/machinery/atmospherics/pipe/heat_exchanging/simple{
	dir = 10
	},
/obj/structure/lattice,
/turf/open/space/basic,
/area/space/nearstation)
"dA" = (
/obj/effect/turf_decal/stripes/line,
/obj/machinery/atmospherics/components/binary/pump{
	name = "Atmospherics to Reactor"
	},
/turf/open/floor/plasteel/dark,
/area/engine/engineering)
"dG" = (
/turf/template_noop,
/area/space)
"dJ" = (
/obj/effect/turf_decal/stripes/line{
	dir = 4
	},
/obj/machinery/atmospherics/pipe/manifold/scrubbers/visible{
	dir = 8
	},
/obj/machinery/meter,
/turf/open/floor/engine,
/area/engine/engineering)
"dV" = (
/obj/effect/turf_decal/stripes/line{
	dir = 10
	},
/obj/machinery/shower{
	dir = 4
	},
/obj/machinery/firealarm{
	dir = 8;
	pixel_y = -28
	},
/turf/open/floor/noslip,
/area/engine/engineering)
"ei" = (
/obj/structure/lattice/catwalk,
/turf/template_noop,
/area/space/nearstation)
"eu" = (
/turf/closed/wall/r_wall,
/area/space/nearstation)
"eQ" = (
/obj/machinery/atmospherics/pipe/simple/scrubbers/visible{
	dir = 4
	},
/obj/effect/turf_decal/stripes/line{
	dir = 8
	},
/turf/open/floor/engine,
/area/engine/engineering)
"fg" = (
/obj/machinery/light{
	dir = 1
	},
/obj/machinery/modular_computer/console/preset/engineering,
/turf/open/floor/plasteel/dark,
/area/engine/engineering)
"fq" = (
/obj/machinery/atmospherics/pipe/simple/orange/visible{
	dir = 4
	},
/obj/machinery/door/airlock/engineering/glass{
	name = "TEG Room";
	req_access_txt = "10"
	},
/obj/effect/mapping_helpers/airlock/cyclelink_helper{
	dir = 4
	},
/turf/open/floor/plasteel/dark,
/area/engine/engineering)
"fx" = (
/obj/machinery/atmospherics/pipe/simple/orange/hidden{
	dir = 6
	},
/obj/structure/cable/yellow{
	icon_state = "4-8"
	},
/turf/open/floor/carpet/royalblack,
/area/engine/engineering)
"gf" = (
/obj/item/twohanded/required/fuel_rod,
/obj/effect/turf_decal/stripes/line,
/turf/open/floor/engine,
/area/engine/engineering)
"gk" = (
/obj/machinery/atmospherics/pipe/simple/orange/visible{
	dir = 4
	},
/obj/effect/turf_decal/stripes/line{
	dir = 4
	},
/turf/open/floor/plasteel/dark,
/area/engine/engineering)
"gv" = (
/obj/machinery/atmospherics/pipe/simple/brown/visible{
	dir = 4
	},
/turf/closed/wall/r_wall,
/area/engine/engineering)
"gw" = (
/obj/effect/turf_decal/stripes/line{
	dir = 1
	},
/obj/machinery/atmospherics/pipe/simple/brown/visible{
	dir = 5
	},
/obj/machinery/meter,
/turf/open/floor/engine,
/area/engine/engineering)
"ht" = (
/obj/effect/spawner/structure/window/plasma/reinforced,
/obj/structure/cable/yellow{
	icon_state = "2-8"
	},
/turf/open/floor/plating,
/area/engine/engineering)
"hw" = (
/obj/effect/turf_decal/stripes/line{
	dir = 9
	},
/obj/structure/closet/firecloset,
/obj/machinery/firealarm{
	pixel_y = 24
	},
/turf/open/floor/plasteel/dark,
/area/engine/engineering)
"hG" = (
/obj/structure/cable/yellow,
/obj/machinery/atmospherics/components/trinary/nuclear_reactor/preset,
/turf/open/floor/engine,
/area/engine/engineering)
"hN" = (
/obj/machinery/atmospherics/pipe/simple/scrubbers/hidden/layer4,
/obj/machinery/atmospherics/pipe/simple/supply/hidden/layer2,
/turf/open/floor/plasteel,
/area/engine/engineering)
"iU" = (
/obj/effect/turf_decal/stripes/line{
	dir = 1
	},
/obj/machinery/atmospherics/pipe/simple/brown/visible{
	dir = 8
	},
/turf/open/floor/engine,
/area/engine/engineering)
"iX" = (
/obj/effect/mapping_helpers/airlock/cyclelink_helper{
	dir = 1
	},
/obj/machinery/door/airlock/external{
	name = "Engineering External Access";
	req_access_txt = "10;13"
	},
/obj/machinery/atmospherics/pipe/layer_manifold,
/turf/open/floor/plating,
/area/engine/engineering)
"ji" = (
/obj/machinery/atmospherics/pipe/heat_exchanging/simple{
	dir = 1
	},
/obj/structure/lattice,
/turf/open/space/basic,
/area/space/nearstation)
"jO" = (
/obj/effect/turf_decal/stripes/line{
	dir = 6
	},
/obj/machinery/shower{
	dir = 8
	},
/obj/structure/extinguisher_cabinet{
	pixel_x = 25
	},
/turf/open/floor/noslip,
/area/engine/engineering)
"kg" = (
/obj/effect/turf_decal/stripes/line,
/obj/machinery/light/small,
/turf/open/floor/noslip,
/area/engine/engineering)
"ko" = (
/obj/machinery/door/firedoor/border_only{
	dir = 8
	},
/obj/machinery/door/airlock/engineering/glass{
	name = "TEG Room";
	req_access_txt = "10"
	},
/obj/effect/mapping_helpers/airlock/cyclelink_helper{
	dir = 8
	},
/obj/machinery/door/firedoor/border_only{
	dir = 4
	},
/obj/structure/cable/yellow{
	icon_state = "4-8"
	},
/turf/open/floor/plasteel/dark,
/area/engine/engineering)
"kK" = (
/obj/machinery/door/poddoor{
	id = "au_nuclear_vent"
	},
/turf/open/space/basic,
/area/engine/engineering)
"la" = (
/obj/effect/mapping_helpers/airlock/cyclelink_helper,
/obj/machinery/door/airlock/external{
	name = "Engineering External Access";
	req_access_txt = "10;13"
	},
/obj/machinery/atmospherics/pipe/simple/supply/hidden/layer2,
/obj/machinery/atmospherics/pipe/simple/scrubbers/hidden/layer4,
/turf/open/floor/plating,
/area/engine/engineering)
"lW" = (
/obj/machinery/atmospherics/pipe/manifold/supply/hidden/layer2{
	dir = 8
	},
/obj/machinery/atmospherics/pipe/manifold/scrubbers/hidden/layer4{
	dir = 8
	},
/turf/open/floor/plasteel,
/area/engine/engineering)
"mf" = (
/obj/machinery/atmospherics/components/binary/pump{
	dir = 1;
	name = "Cooling Loop to Reactor"
	},
/obj/effect/turf_decal/stripes/line,
/turf/open/floor/engine,
/area/engine/engineering)
"mp" = (
/obj/machinery/atmospherics/components/unary/outlet_injector/atmos/engine_waste{
	dir = 4
	},
/obj/structure/grille/broken,
/turf/open/floor/plating/airless,
/area/engine/engineering)
"mK" = (
/obj/effect/turf_decal/stripes/line{
	dir = 8
	},
/obj/machinery/atmospherics/pipe/manifold/cyan/visible{
	dir = 1
	},
/obj/machinery/meter,
/turf/open/floor/engine,
/area/engine/engineering)
"nb" = (
/obj/machinery/atmospherics/pipe/simple/scrubbers/visible{
	dir = 10
	},
/turf/open/floor/engine,
/area/engine/engineering)
"nv" = (
/obj/machinery/camera/autoname,
/obj/effect/turf_decal/stripes/line{
	dir = 1
	},
/obj/machinery/atmospherics/pipe/manifold/brown/visible{
	dir = 1
	},
/turf/open/floor/engine,
/area/engine/engineering)
"nF" = (
/obj/effect/turf_decal/stripes/line{
	dir = 5
	},
/obj/item/radio/intercom{
	pixel_x = 26
	},
/obj/effect/turf_decal/delivery,
/obj/structure/closet/radiation,
/obj/item/clothing/glasses/meson/engine,
/turf/open/floor/plasteel/dark,
/area/engine/engineering)
"nP" = (
/obj/effect/spawner/structure/window/plasma/reinforced,
/obj/machinery/atmospherics/pipe/simple/scrubbers/visible,
/turf/open/floor/plating,
/area/engine/engineering)
"nS" = (
/obj/effect/turf_decal/stripes/corner{
	dir = 8
	},
/turf/open/floor/engine,
/area/engine/engineering)
"nX" = (
/obj/machinery/computer/reactor/fuel_rods,
/obj/structure/table,
/turf/open/floor/plasteel/dark,
/area/engine/engineering)
"oi" = (
/obj/structure/table,
/obj/item/storage/toolbox/mechanical{
	pixel_y = 5
	},
/obj/item/flashlight{
	pixel_x = 1;
	pixel_y = 5
	},
/obj/item/flashlight{
	pixel_x = 1;
	pixel_y = 5
	},
/obj/structure/sign/warning/vacuum/external{
	pixel_y = -32
	},
/turf/open/floor/plasteel,
/area/engine/engineering)
"oj" = (
/obj/machinery/atmospherics/components/binary/pump{
	name = "Coolent to Reactor"
	},
/turf/open/floor/engine,
/area/engine/engineering)
"ow" = (
/obj/effect/spawner/structure/window/plasma/reinforced,
/obj/machinery/atmospherics/pipe/simple/brown/visible,
/turf/open/floor/plating,
/area/engine/engineering)
"qt" = (
/obj/machinery/portable_atmospherics/canister/oxygen,
/obj/machinery/camera/autoname{
	dir = 4
	},
/obj/effect/turf_decal/stripes/line{
	dir = 8
	},
/turf/open/floor/engine,
/area/engine/engineering)
"qC" = (
/obj/effect/turf_decal/stripes/line{
	dir = 1
	},
/obj/structure/table,
/obj/item/paper_bin,
/obj/item/pen,
/turf/open/floor/plasteel/dark,
/area/engine/engineering)
"qJ" = (
/obj/machinery/light/small{
	dir = 8
	},
/obj/structure/closet/emcloset/anchored,
/obj/machinery/advanced_airlock_controller{
	dir = 1;
	pixel_y = -24
	},
/turf/open/floor/plating,
/area/engine/engineering)
"qT" = (
/obj/machinery/atmospherics/pipe/simple/cyan/visible{
	dir = 4
	},
/turf/open/floor/engine,
/area/engine/engineering)
"qV" = (
/obj/machinery/atmospherics/pipe/simple/supply/hidden/layer2,
/obj/machinery/atmospherics/pipe/simple/scrubbers/hidden/layer4,
/obj/structure/cable{
	icon_state = "1-2"
	},
/turf/open/floor/plasteel,
/area/engine/engineering)
"rd" = (
/obj/structure/lattice,
/turf/template_noop,
/area/space)
"rB" = (
/obj/machinery/atmospherics/components/binary/pump{
	name = "Moderators to Reactor"
	},
/obj/effect/turf_decal/stripes/line,
/obj/structure/cable/yellow{
	icon_state = "2-8"
	},
/turf/open/floor/engine,
/area/engine/engineering)
"sB" = (
/obj/structure/grille,
/turf/open/space/basic,
/area/space/nearstation)
"sT" = (
/obj/structure/lattice,
/turf/template_noop,
/area/space/nearstation)
"sZ" = (
/obj/structure/cable{
	icon_state = "1-8"
	},
/obj/machinery/atmospherics/pipe/simple/orange/visible{
	dir = 4
	},
/turf/open/floor/plasteel,
/area/engine/engineering)
"ti" = (
/obj/machinery/atmospherics/pipe/simple/supply/hidden/layer2{
	dir = 8
	},
/obj/machinery/atmospherics/pipe/simple/scrubbers/hidden/layer4{
	dir = 4
	},
/obj/machinery/door/firedoor/border_only{
	dir = 4
	},
/obj/machinery/door/firedoor/border_only{
	dir = 8
	},
/obj/machinery/door/airlock/engineering{
	name = "AI Satellite Access";
	req_one_access_txt = "10;17;32"
	},
/obj/machinery/atmospherics/pipe/simple/orange/hidden{
	dir = 9
	},
/turf/open/floor/plasteel,
/area/engine/engineering)
"tB" = (
/obj/effect/spawner/structure/window/plasma/reinforced,
/obj/machinery/door/firedoor/window,
/turf/open/floor/plating,
/area/engine/engineering)
"ua" = (
/obj/machinery/computer/station_alert,
/obj/machinery/airalarm{
	pixel_y = 24
	},
/turf/open/floor/plasteel/dark,
/area/engine/engineering)
"uC" = (
/obj/machinery/atmospherics/pipe/heat_exchanging/simple{
	dir = 4
	},
/obj/structure/lattice/catwalk,
/turf/open/space/basic,
/area/space/nearstation)
"vE" = (
/obj/machinery/shower{
	dir = 8
	},
/obj/effect/turf_decal/stripes/line{
	dir = 6
	},
/obj/item/radio/intercom{
	pixel_x = 27
	},
/turf/open/floor/noslip,
/area/engine/engineering)
"vH" = (
/obj/effect/turf_decal/stripes/line,
/obj/machinery/atmospherics/components/binary/pump{
	name = "Atmospherics to Moderator"
	},
/turf/open/floor/plasteel/dark,
/area/engine/engineering)
"vS" = (
/obj/machinery/atmospherics/pipe/simple/brown/visible{
	dir = 10
	},
/turf/closed/wall/r_wall,
/area/engine/engineering)
"wm" = (
/obj/structure/table/reinforced,
/obj/machinery/light{
	dir = 1
	},
/obj/item/sealant,
/obj/effect/turf_decal/stripes/line{
	dir = 5
	},
/obj/item/sealant{
	pixel_x = 4
	},
/obj/item/reagent_containers/food/snacks/pizzaslice/meat{
	pixel_x = -1;
	pixel_y = 12
	},
/turf/open/floor/engine,
/area/engine/engineering)
"xi" = (
/obj/machinery/atmospherics/pipe/manifold/orange/hidden{
	dir = 1
	},
/obj/structure/chair/office/light{
	dir = 1
	},
/turf/open/floor/carpet/royalblack,
/area/engine/engineering)
"xq" = (
/obj/structure/extinguisher_cabinet{
	pixel_x = -25
	},
/obj/effect/turf_decal/stripes/line{
	dir = 10
	},
/turf/open/floor/plasteel/dark,
/area/engine/engineering)
"xN" = (
/obj/effect/turf_decal/stripes/line{
	dir = 1
	},
/obj/machinery/airalarm{
	pixel_y = 24
	},
/obj/structure/closet/secure_closet/engineering_welding,
/turf/open/floor/engine,
/area/engine/engineering)
"yE" = (
/obj/machinery/atmospherics/pipe/simple/orange/visible{
	dir = 4
	},
/turf/open/floor/carpet/royalblack,
/area/engine/engineering)
"ze" = (
/obj/effect/turf_decal/delivery,
/turf/closed/wall/r_wall,
/area/engine/engineering)
"zw" = (
/obj/effect/turf_decal/stripes/line{
	dir = 8
	},
/obj/machinery/atmospherics/pipe/simple/cyan/visible,
/turf/open/floor/engine,
/area/engine/engineering)
"zI" = (
/obj/effect/turf_decal/stripes/corner{
	dir = 4
	},
/obj/machinery/atmospherics/pipe/simple/scrubbers/visible,
/turf/open/floor/engine,
/area/engine/engineering)
"Ad" = (
/obj/effect/turf_decal/stripes/line,
/turf/open/floor/engine,
/area/engine/engineering)
"Aw" = (
/obj/machinery/atmospherics/pipe/simple/orange/visible{
	dir = 4
	},
/turf/open/floor/plasteel/dark,
/area/engine/engineering)
"AX" = (
/obj/machinery/atmospherics/pipe/simple/orange/visible{
	dir = 4
	},
/obj/structure/cable/yellow{
	icon_state = "2-8"
	},
/turf/open/floor/carpet/royalblack,
/area/engine/engineering)
"Ca" = (
/obj/effect/turf_decal/stripes/line,
/obj/structure/cable/yellow{
	icon_state = "1-2"
	},
/turf/open/floor/plasteel/dark,
/area/engine/engineering)
"Cq" = (
/obj/effect/turf_decal/stripes/line{
	dir = 4
	},
/obj/machinery/atmospherics/pipe/simple/scrubbers/visible,
/turf/open/floor/engine,
/area/engine/engineering)
"Cz" = (
/obj/item/twohanded/required/fuel_rod,
/obj/effect/turf_decal/stripes/line{
	dir = 5
	},
/turf/open/floor/engine,
/area/engine/engineering)
"CD" = (
/obj/item/twohanded/required/fuel_rod,
/obj/effect/turf_decal/stripes/line{
	dir = 4
	},
/turf/open/floor/engine,
/area/engine/engineering)
"CI" = (
/obj/effect/turf_decal/stripes/corner{
	dir = 1
	},
/obj/machinery/atmospherics/pipe/simple/cyan/visible{
	dir = 9
	},
/turf/open/floor/engine,
/area/engine/engineering)
"DI" = (
/obj/structure/lattice,
/turf/open/space/basic,
/area/space/nearstation)
"DS" = (
/obj/structure/cable/yellow{
	icon_state = "4-8"
	},
/obj/effect/turf_decal/stripes/line{
	dir = 4
	},
/turf/open/floor/plasteel/dark,
/area/engine/engineering)
"DU" = (
/obj/structure/cable/yellow{
	icon_state = "4-8"
	},
/turf/open/floor/plasteel/dark,
/area/engine/engineering)
"DV" = (
/obj/machinery/button/door{
	id = "au_nuclear_vent";
	name = "RBMK Compartment Flush";
	pixel_x = 27
	},
/turf/open/floor/plasteel/dark,
/area/engine/engineering)
"Ea" = (
/obj/effect/turf_decal/stripes/line,
/obj/structure/cable/yellow{
	icon_state = "4-8"
	},
/turf/open/floor/engine,
/area/engine/engineering)
"Ep" = (
/obj/effect/spawner/structure/window/plasma/reinforced,
/turf/open/floor/engine,
/area/engine/engineering)
"EB" = (
/obj/structure/table,
/obj/machinery/computer/reactor/stats,
/obj/machinery/camera/autoname,
/turf/open/floor/plasteel/dark,
/area/engine/engineering)
"EO" = (
/obj/effect/turf_decal/stripes/line{
	dir = 9
	},
/obj/effect/turf_decal/delivery,
/obj/structure/closet/firecloset,
/turf/open/floor/plasteel/dark,
/area/engine/engineering)
"FH" = (
/obj/machinery/pool/drain,
/obj/item/twohanded/required/fuel_rod,
/turf/open/floor/engine,
/area/engine/engineering)
"HN" = (
/obj/effect/turf_decal/stripes/line,
/obj/effect/turf_decal/stripes/line{
	dir = 8
	},
/turf/open/floor/engine,
/area/engine/engineering)
"Ie" = (
/obj/machinery/atmospherics/pipe/simple/purple/visible,
/obj/structure/cable/yellow{
	icon_state = "1-2"
	},
/turf/open/floor/engine,
/area/engine/engineering)
"Iy" = (
/obj/machinery/atmospherics/pipe/simple/scrubbers/hidden/layer4{
	dir = 4
	},
/obj/machinery/atmospherics/pipe/simple/supply/hidden/layer2{
	dir = 8
	},
/obj/machinery/door/firedoor/border_only{
	dir = 4
	},
/obj/machinery/door/firedoor/border_only{
	dir = 8
	},
/obj/machinery/door/airlock/engineering/glass{
	name = "TEG Room";
	req_access_txt = "10"
	},
/obj/effect/mapping_helpers/airlock/cyclelink_helper{
	dir = 4
	},
/turf/open/floor/engine,
/area/engine/engineering)
"ID" = (
/obj/machinery/atmospherics/components/unary/portables_connector,
/obj/machinery/portable_atmospherics/canister/nitrogen,
/turf/open/floor/engine,
/area/engine/engineering)
"IF" = (
/obj/structure/lattice,
/obj/structure/grille,
/turf/template_noop,
/area/space/nearstation)
"IM" = (
/obj/machinery/light/small{
	dir = 8
	},
/obj/structure/closet/emcloset/anchored,
/obj/machinery/advanced_airlock_controller{
	dir = 1;
	pixel_y = -24
	},
/obj/effect/turf_decal/box,
/turf/open/floor/plating,
/area/engine/engineering)
"IX" = (
/obj/machinery/computer/reactor/control_rods,
/obj/structure/table,
/turf/open/floor/plasteel/dark,
/area/engine/engineering)
"Jc" = (
/obj/machinery/atmospherics/pipe/simple/cyan/visible{
	dir = 9
	},
/turf/open/floor/engine,
/area/engine/engineering)
"Ji" = (
/obj/machinery/meter,
/obj/machinery/atmospherics/pipe/manifold/brown/visible{
	dir = 8
	},
/turf/open/floor/engine,
/area/engine/engineering)
"Jp" = (
/obj/machinery/atmospherics/pipe/heat_exchanging/simple{
	dir = 6
	},
/obj/structure/lattice,
/turf/open/space/basic,
/area/space/nearstation)
"Js" = (
/obj/machinery/meter,
/obj/machinery/atmospherics/pipe/simple/orange/visible{
	dir = 4
	},
/obj/machinery/atmospherics/pipe/simple/scrubbers/hidden/layer4{
	dir = 4
	},
/obj/machinery/atmospherics/pipe/simple/supply/hidden/layer2{
	dir = 8
	},
/turf/open/floor/plasteel,
/area/engine/engineering)
"Jz" = (
/obj/machinery/atmospherics/pipe/simple/brown/visible{
	dir = 8
	},
/turf/open/floor/engine,
/area/engine/engineering)
"JA" = (
/turf/closed/wall/r_wall,
/area/space)
"KE" = (
/obj/effect/turf_decal/stripes/line{
	dir = 1
	},
/obj/machinery/atmospherics/pipe/simple/cyan/visible{
	dir = 6
	},
/turf/open/floor/engine,
/area/engine/engineering)
"LO" = (
/obj/machinery/atmospherics/pipe/simple/supply/hidden/layer1,
/obj/machinery/door/airlock/engineering{
	name = "Reactor Core";
	req_one_access_txt = "10;24"
	},
/obj/machinery/door/firedoor/border_only{
	dir = 1
	},
/obj/machinery/door/firedoor/border_only,
/obj/effect/turf_decal/stripes/line{
	dir = 1
	},
/obj/effect/turf_decal/stripes/line,
/obj/structure/cable/yellow{
	icon_state = "1-2"
	},
/turf/open/floor/plasteel/dark,
/area/engine/engineering)
"MB" = (
/obj/effect/turf_decal/stripes/line{
	dir = 1
	},
/obj/machinery/atmospherics/components/unary/portables_connector{
	dir = 8
	},
/obj/machinery/portable_atmospherics/canister/toxins,
/turf/open/floor/engine,
/area/engine/engineering)
"MJ" = (
/obj/effect/turf_decal/stripes/line{
	dir = 8
	},
/obj/machinery/light,
/obj/effect/turf_decal/stripes/line,
/turf/open/floor/engine,
/area/engine/engineering)
"Nu" = (
/obj/effect/turf_decal/stripes/line{
	dir = 1
	},
/obj/machinery/atmospherics/pipe/simple/scrubbers/visible,
/obj/machinery/meter,
/turf/open/floor/engine,
/area/engine/engineering)
"NR" = (
/obj/effect/turf_decal/stripes/line{
	dir = 1
	},
/obj/structure/cable/yellow{
	icon_state = "1-2"
	},
/turf/open/floor/engine,
/area/engine/engineering)
"OY" = (
/obj/machinery/atmospherics/pipe/heat_exchanging/simple{
	dir = 10
	},
/obj/structure/lattice/catwalk,
/turf/open/space/basic,
/area/space/nearstation)
"Po" = (
/obj/machinery/light,
/obj/machinery/portable_atmospherics/canister/carbon_dioxide,
/obj/effect/turf_decal/box,
/obj/effect/turf_decal/stripes/line,
/turf/open/floor/engine,
/area/engine/engineering)
"PH" = (
/obj/structure/grille,
/turf/template_noop,
/area/space/nearstation)
"PR" = (
/obj/effect/turf_decal/stripes/line{
	dir = 9
	},
/obj/machinery/light/small{
	dir = 1
	},
/obj/structure/closet/radiation,
/obj/item/clothing/glasses/meson/engine,
/obj/effect/turf_decal/delivery,
/turf/open/floor/plasteel/dark,
/area/engine/engineering)
"Qb" = (
/obj/structure/cable{
	icon_state = "4-8"
	},
/obj/machinery/atmospherics/pipe/simple/orange/visible{
	dir = 4
	},
/obj/machinery/door/airlock/engineering/glass{
	name = "TEG Room";
	req_access_txt = "10"
	},
/obj/effect/mapping_helpers/airlock/cyclelink_helper{
	dir = 8
	},
/obj/machinery/door/firedoor/border_only{
	dir = 4
	},
/obj/machinery/door/firedoor/border_only{
	dir = 8
	},
/turf/open/floor/plasteel,
/area/engine/engineering)
"Qm" = (
/obj/machinery/atmospherics/components/binary/pump{
	name = "Reactor to Cooling Loop"
	},
/obj/effect/turf_decal/stripes/line,
/turf/open/floor/engine,
/area/engine/engineering)
"QO" = (
/obj/effect/turf_decal/stripes/line{
	dir = 1
	},
/obj/machinery/atmospherics/pipe/simple/cyan/visible{
	dir = 4
	},
/turf/open/floor/engine,
/area/engine/engineering)
"Rm" = (
/obj/item/twohanded/required/fuel_rod,
/obj/effect/turf_decal/stripes/line{
	dir = 6
	},
/turf/open/floor/engine,
/area/engine/engineering)
"SA" = (
/obj/machinery/portable_atmospherics/canister/toxins,
/obj/effect/turf_decal/stripes/line{
	dir = 10
	},
/turf/open/floor/engine,
/area/engine/engineering)
"SC" = (
/obj/machinery/atmospherics/pipe/simple/supply/hidden/layer2,
/obj/machinery/atmospherics/pipe/simple/scrubbers/hidden/layer4,
/turf/open/floor/plasteel,
/area/engine/engineering)
"TJ" = (
/obj/effect/turf_decal/stripes/line,
/obj/machinery/light/small,
/obj/machinery/firealarm{
	dir = 8;
	pixel_y = -28
	},
/turf/open/floor/noslip,
/area/engine/engineering)
"TO" = (
/obj/effect/turf_decal/stripes/corner,
/obj/machinery/atmospherics/pipe/simple/scrubbers/visible,
/obj/structure/cable/yellow{
	icon_state = "4-8"
	},
/turf/open/floor/engine,
/area/engine/engineering)
"UW" = (
/obj/machinery/atmospherics/pipe/manifold/scrubbers/visible,
/turf/open/floor/engine,
/area/engine/engineering)
"Vd" = (
/obj/structure/sign/warning/vacuum/external{
	pixel_x = 32
	},
/obj/machinery/atmospherics/components/binary/dp_vent_pump/layer2,
/obj/machinery/atmospherics/pipe/simple/scrubbers/hidden/layer4,
/turf/open/floor/plating,
/area/engine/engineering)
"Vq" = (
/obj/machinery/atmospherics/components/unary/outlet_injector/atmos/engine_waste{
	dir = 1
	},
/turf/open/floor/plating,
/area/space)
"VH" = (
/obj/machinery/atmospherics/pipe/simple/scrubbers/visible{
	dir = 4
	},
/obj/structure/cable/yellow{
	icon_state = "1-2"
	},
/turf/open/floor/engine,
/area/engine/engineering)
"VP" = (
/obj/machinery/atmospherics/pipe/heat_exchanging/simple{
	dir = 5
	},
/obj/structure/lattice,
/turf/open/space/basic,
/area/space/nearstation)
"XE" = (
/obj/machinery/atmospherics/pipe/heat_exchanging/junction,
/turf/closed/wall/r_wall,
/area/engine/engineering)
"YC" = (
/obj/effect/turf_decal/stripes/line{
	dir = 1
	},
/obj/machinery/atmospherics/components/binary/pump{
	dir = 8;
	name = "Moderator to Reactor"
	},
/turf/open/floor/engine,
/area/engine/engineering)
"YT" = (
/obj/structure/cable/yellow{
	icon_state = "1-4"
	},
/turf/open/floor/engine,
/area/engine/engineering)
"YV" = (
/obj/machinery/atmospherics/pipe/heat_exchanging/simple{
	dir = 8
	},
/obj/structure/lattice,
/turf/open/space/basic,
/area/space/nearstation)
"Ze" = (
/obj/machinery/atmospherics/pipe/heat_exchanging/simple{
	dir = 9
	},
/obj/structure/lattice,
/turf/open/space/basic,
/area/space/nearstation)
"Zh" = (
/obj/item/twohanded/required/fuel_rod,
/obj/effect/turf_decal/stripes/line{
	dir = 1
	},
/obj/structure/pool/ladder{
	dir = 2;
	pixel_y = 17
	},
/turf/open/floor/engine,
/area/engine/engineering)
"Zm" = (
/obj/structure/lattice/catwalk,
/obj/machinery/atmospherics/pipe/heat_exchanging/simple{
	dir = 4
	},
/turf/open/space/basic,
/area/space/nearstation)
"Zy" = (
/obj/effect/turf_decal/delivery,
/obj/structure/closet/radiation,
/obj/item/clothing/glasses/meson/engine,
/obj/machinery/camera/autoname,
/obj/effect/turf_decal/stripes/line{
	dir = 5
	},
/obj/structure/sign/warning/radiation{
	pixel_y = 32
	},
/obj/item/clothing/glasses/meson/engine,
/turf/open/floor/plasteel/dark,
/area/engine/engineering)
"ZH" = (
/obj/structure/cable/yellow{
	icon_state = "1-4"
	},
/turf/open/floor/plasteel/dark,
/area/engine/engineering)

(1,1,1) = {"
ab
ab
ab
ab
ab
ab
ab
dG
dG
dG
dG
dG
dG
dG
dG
dG
dG
dG
dG
dG
dG
ab
ab
ab
ab
ab
"}
(2,1,1) = {"
ab
ab
ab
ab
ab
ab
ab
dG
dG
dG
dG
dG
dG
dG
dG
dG
dG
dG
dG
dG
dG
ab
ab
ab
ab
ab
"}
(3,1,1) = {"
ab
ab
ab
ab
ab
ab
ab
dG
dG
dG
dG
dG
dG
dG
dG
dG
dG
dG
dG
dG
dG
ab
ab
ab
ab
ab
"}
(4,1,1) = {"
ab
ab
ab
ab
ab
ab
ab
dG
dG
dG
dG
dG
dG
dG
dG
dG
dG
dG
dG
dG
dG
ab
ab
ab
ab
ab
"}
(5,1,1) = {"
ab
ab
ab
ab
ab
ab
ab
dG
dG
sB
sB
sB
sB
sB
sB
sB
sB
dG
dG
dG
dG
ab
ab
ab
ab
ab
"}
(6,1,1) = {"
ab
ab
ab
ab
ab
ab
ab
dG
dG
sB
eu
eu
eu
eu
eu
eu
sB
dG
dG
dG
dG
ab
ab
ab
ab
ab
"}
(7,1,1) = {"
ab
ab
ab
ab
bb
bb
ad
dG
dG
sB
sB
sB
sB
sB
sB
sB
sB
dG
dG
dG
dG
dG
dG
dG
dG
dG
"}
(8,1,1) = {"
ab
ab
ag
oi
bb
IM
ad
dG
dG
dG
sT
dG
dG
dG
sT
sT
dG
dG
dG
dG
dG
dG
dG
sT
dG
dG
"}
(9,1,1) = {"
ab
ab
lW
SC
la
Vd
iX
dG
dG
dG
sT
dG
dG
dG
sT
sT
dG
dG
dG
dG
dG
sT
sT
sT
sT
dG
"}
(10,1,1) = {"
ab
ah
Iy
ac
ad
ad
ad
dG
dG
dG
sT
dG
dG
dG
sT
sT
dG
dG
dG
sT
dG
dG
dG
dG
dG
dG
"}
(11,1,1) = {"
ac
ht
ZH
dV
ad
dG
dG
dG
dG
dG
sT
dG
dG
dG
Jp
VP
Jp
VP
DI
IF
IF
dG
dG
dG
dG
dG
"}
(12,1,1) = {"
ad
PR
DU
kg
ad
cY
mp
cY
cY
cY
IF
cY
rd
dG
YV
uC
YV
uC
DI
eu
IF
dG
dG
dG
dG
dG
"}
(13,1,1) = {"
ad
Zy
DS
vE
ad
ad
bk
ad
Ep
Ep
ad
ad
ad
ad
YV
uC
YV
uC
DI
eu
IF
dG
dG
dG
dG
dG
"}
(14,1,1) = {"
ad
ad
ko
ad
ad
bQ
eQ
aJ
aJ
aJ
HN
qt
SA
ad
YV
uC
YV
uC
DI
eu
IF
sT
dG
dG
dG
dG
"}
(15,1,1) = {"
ad
hw
bt
xq
ad
xN
cc
cA
cA
cA
nS
aJ
MJ
ad
YV
uC
YV
uC
DI
eu
IF
dG
dG
dG
dG
dG
"}
(16,1,1) = {"
ac
qC
fx
dA
nP
Nu
UW
cA
aY
aJ
cy
cA
Ad
Ep
YV
Zm
YV
uC
DI
eu
IF
dG
dG
dG
dG
dG
"}
(17,1,1) = {"
ac
EB
AX
Ca
LO
NR
VH
YT
Zh
FH
gf
cA
Ad
Ep
YV
uC
YV
uC
DI
eu
IF
dG
dG
dG
dG
dG
"}
(18,1,1) = {"
ac
nX
xi
vH
ow
gw
dp
aM
Cz
CD
Rm
cA
Ad
Ep
YV
uC
YV
uC
DI
eu
IF
dG
dG
dG
dG
dG
"}
(19,1,1) = {"
ac
IX
yE
bN
ac
iU
nb
TO
Cq
dJ
Cq
zI
Qm
XE
Ze
uC
YV
Zm
DI
eu
IF
dG
dG
dG
dG
dG
"}
(20,1,1) = {"
ac
fg
yE
bN
ac
iU
cA
Ea
cA
dp
cA
KE
mf
XE
VP
uC
YV
uC
DI
eu
IF
dG
dG
dG
dG
dG
"}
(21,1,1) = {"
ad
ua
Aw
DV
ac
nv
Ji
rB
Ie
hG
cA
QO
Ad
Ep
YV
uC
YV
uC
DI
eu
IF
dG
dG
dG
dG
dG
"}
(22,1,1) = {"
ad
ad
fq
ad
ad
YC
ba
Ad
cA
qT
cA
QO
Ad
Ep
YV
uC
YV
uC
DI
eu
IF
sT
dG
dG
dG
dG
"}
(23,1,1) = {"
ad
EO
Aw
bW
ad
MB
Jz
nS
aJ
mK
zw
CI
Po
ad
YV
uC
YV
uC
DI
eu
IF
dG
dG
dG
dG
dG
"}
(24,1,1) = {"
ad
bf
Aw
TJ
ad
wm
Jz
ID
oj
Jc
cA
cA
Ad
ad
YV
OY
Ze
uC
DI
eu
IF
dG
dG
dG
dG
dG
"}
(25,1,1) = {"
ad
nF
gk
jO
ad
ad
gv
ad
Ep
Ep
kK
kK
kK
ad
dx
ji
ji
Ze
DI
IF
IF
dG
dG
dG
dG
dG
"}
(26,1,1) = {"
ze
ad
Qb
ad
ad
qJ
vS
Vq
dG
dG
dG
dG
dG
dG
dG
dG
ei
sT
sT
PH
PH
dG
dG
sT
dG
dG
"}
(27,1,1) = {"
ab
qV
sZ
hN
la
Vd
iX
ei
ei
ei
ei
ei
ei
ei
ei
ei
ei
sT
sT
eu
PH
sT
sT
sT
sT
sT
"}
(28,1,1) = {"
ab
au
Js
bq
JA
JA
JA
dG
dG
dG
dG
dG
dG
dG
dG
dG
ei
ei
sT
eu
IF
dG
dG
sT
dG
dG
"}
(29,1,1) = {"
ab
av
ti
bb
ad
ad
ad
tB
tB
ad
ad
ad
ad
ad
ad
ad
ei
sT
sT
eu
IF
dG
dG
sT
dG
dG
"}
