//MAP CONVERTED BY dmm2tgm.py THIS HEADER COMMENT PREVENTS RECONVERSION, DO NOT REMOVE
"aa" = (
/turf/open/space/basic,
/area/space)
"ab" = (
/turf/template_noop,
/area/template_noop)
"ac" = (
/turf/open/floor/plasteel,
/area/engine/engineering)
"ad" = (
/turf/closed/wall/r_wall,
/area/engine/engineering)
"al" = (
/obj/structure/table,
/obj/item/clothing/gloves/color/yellow,
/obj/item/storage/toolbox/electrical{
	pixel_y = 5
	},
/turf/open/floor/plasteel,
/area/engine/engineering)
"an" = (
/obj/machinery/atmospherics/pipe/simple/supply/hidden/layer2{
	dir = 8
	},
/obj/machinery/atmospherics/pipe/simple/scrubbers/hidden/layer4{
	dir = 4
	},
/turf/open/floor/plasteel,
/area/engine/engineering)
"ap" = (
/obj/machinery/atmospherics/pipe/simple/supply/hidden/layer2{
	dir = 8
	},
/obj/machinery/atmospherics/pipe/simple/scrubbers/hidden/layer4{
	dir = 4
	},
/obj/structure/cable/yellow{
	icon_state = "1-4"
	},
/turf/open/floor/plasteel,
/area/engine/engineering)
"aq" = (
/obj/machinery/atmospherics/pipe/simple/supply/hidden/layer2{
	dir = 8
	},
/obj/machinery/atmospherics/pipe/simple/scrubbers/hidden/layer4{
	dir = 4
	},
/obj/structure/cable/yellow{
	icon_state = "4-8"
	},
/turf/open/floor/plasteel,
/area/engine/engineering)
"at" = (
/obj/structure/cable{
	icon_state = "1-2"
	},
/obj/machinery/atmospherics/pipe/simple/supply/hidden/layer2,
/obj/machinery/atmospherics/pipe/simple/scrubbers/hidden/layer4,
/turf/open/floor/plasteel,
/area/engine/engineering)
"au" = (
/obj/structure/cable/yellow{
	icon_state = "1-2"
	},
/obj/structure/cable/yellow{
	icon_state = "1-8"
	},
/obj/effect/turf_decal/stripes/corner{
	dir = 4
	},
/turf/open/floor/plating,
/area/engine/engineering)
"av" = (
/obj/machinery/atmospherics/pipe/simple/orange/hidden{
	dir = 9
	},
/turf/closed/wall,
/area/engine/engineering)
"aC" = (
/obj/machinery/atmospherics/pipe/simple/supply/hidden/layer2{
	dir = 8
	},
/obj/structure/cable/yellow{
	icon_state = "4-8"
	},
/obj/structure/cable/yellow{
	icon_state = "2-8"
	},
/obj/machinery/atmospherics/pipe/manifold/scrubbers/hidden/layer4{
	dir = 1
	},
/turf/open/floor/plasteel,
/area/engine/engineering)
"aQ" = (
/obj/structure/lattice,
/turf/open/space/basic,
/area/space/nearstation)
"aR" = (
/turf/open/floor/plating/airless,
/area/space/nearstation)
"aU" = (
/obj/structure/sign/warning/electricshock,
/turf/closed/wall/r_wall,
/area/engine/engineering)
"bb" = (
/turf/closed/wall,
/area/engine/engineering)
"bu" = (
/obj/structure/grille,
/turf/open/floor/plating/airless,
/area/engine/engineering)
"bB" = (
/obj/effect/turf_decal/stripes/line{
	dir = 10
	},
/turf/open/floor/plating,
/area/engine/engineering)
"bD" = (
/obj/machinery/atmospherics/pipe/simple/supply/hidden/layer2{
	dir = 8
	},
/obj/structure/cable/yellow{
	icon_state = "2-8"
	},
/obj/machinery/atmospherics/pipe/manifold/scrubbers/hidden/layer4{
	dir = 1
	},
/turf/open/floor/plasteel,
/area/engine/engineering)
"bE" = (
/obj/machinery/atmospherics/pipe/simple/scrubbers/hidden/layer4{
	dir = 4
	},
/obj/structure/cable/yellow{
	icon_state = "4-8"
	},
/obj/machinery/atmospherics/pipe/manifold/supply/hidden/layer2{
	dir = 1
	},
/turf/open/floor/plasteel,
/area/engine/engineering)
"bF" = (
/obj/structure/cable/yellow{
	icon_state = "1-2"
	},
/obj/machinery/atmospherics/components/unary/vent_scrubber/on/layer4{
	dir = 1
	},
/turf/open/floor/plasteel,
/area/engine/engineering)
"cb" = (
/obj/structure/cable/yellow{
	icon_state = "4-8"
	},
/turf/open/floor/plasteel,
/area/engine/engineering)
"cj" = (
/obj/machinery/light,
/turf/open/floor/plating/airless,
/area/engine/engineering)
"ck" = (
/obj/machinery/atmospherics/components/unary/portables_connector/visible{
	dir = 4
	},
/turf/open/floor/plasteel,
/area/engine/engineering)
"du" = (
/obj/structure/sign/warning/radiation/rad_area,
/turf/closed/wall/r_wall,
/area/engine/engineering)
"dL" = (
/obj/effect/decal/cleanable/vomit/old,
/obj/effect/turf_decal/stripes/line{
	dir = 6
	},
/turf/open/floor/plating,
/area/engine/engineering)
"dN" = (
/obj/structure/cable/yellow{
	icon_state = "1-2"
	},
/obj/effect/turf_decal/stripes/line{
	dir = 5
	},
/turf/open/floor/plating,
/area/engine/engineering)
"gK" = (
/obj/effect/turf_decal/stripes/line{
	dir = 1
	},
/turf/open/floor/plating,
/area/engine/engineering)
"gW" = (
/obj/effect/turf_decal/stripes/line{
	dir = 8
	},
/turf/open/floor/plating,
/area/engine/engineering)
"hc" = (
/obj/machinery/atmospherics/pipe/simple/scrubbers/visible/layer4,
/obj/structure/cable/yellow{
	icon_state = "1-2"
	},
/obj/structure/grille,
/obj/structure/window/plasma/fulltile,
/turf/open/floor/plating,
/area/engine/engineering)
"hK" = (
/obj/structure/grille,
/obj/structure/lattice,
/turf/open/space/basic,
/area/engine/engineering)
"hR" = (
/obj/structure/cable/yellow{
	icon_state = "1-2"
	},
/obj/structure/cable/yellow{
	icon_state = "1-8"
	},
/turf/open/floor/plating,
/area/engine/engineering)
"iI" = (
/obj/machinery/vending/wallgene{
	name = "Monkey Vendor";
	pixel_x = -28
	},
/turf/open/floor/plasteel,
/area/engine/engineering)
"iL" = (
/obj/machinery/door/firedoor/border_only{
	dir = 1
	},
/obj/machinery/door/firedoor/border_only,
/obj/machinery/door/airlock/engineering{
	name = "Engine Access";
	req_one_access_txt = "10;17;32"
	},
/turf/open/floor/plasteel,
/area/engine/engineering)
"kj" = (
/obj/structure/table,
/obj/item/storage/box/monkeycubes{
	pixel_x = -8;
	pixel_y = 10
	},
/obj/item/storage/box/monkeycubes{
	pixel_x = 8;
	pixel_y = 6
	},
/obj/item/storage/box/monkeycubes{
	pixel_x = -4;
	pixel_y = -3
	},
/turf/open/floor/plasteel,
/area/engine/engineering)
"kW" = (
/obj/structure/cable/yellow{
	icon_state = "1-2"
	},
/obj/structure/cable/yellow{
	icon_state = "1-4"
	},
/turf/open/floor/plating,
/area/engine/engineering)
"lf" = (
/obj/effect/turf_decal/stripes/line{
	dir = 9
	},
/turf/open/floor/plating,
/area/engine/engineering)
"lC" = (
/obj/machinery/light,
/turf/open/floor/plasteel,
/area/engine/engineering)
"lN" = (
/obj/item/toy/beach_ball,
/turf/open/floor/plasteel,
/area/engine/engineering)
"lO" = (
/obj/structure/cable/yellow,
/obj/machinery/power/stationarybike{
	dir = 4
	},
/obj/effect/turf_decal/stripes/line,
/turf/open/floor/plating,
/area/engine/engineering)
"oz" = (
/obj/effect/turf_decal/stripes/line{
	dir = 6
	},
/turf/open/floor/plating,
/area/engine/engineering)
"oF" = (
/obj/structure/lattice,
/obj/machinery/camera/emp_proof{
	c_tag = "Engineering Singularity Southeast";
	dir = 1;
	network = list("ss13","engine")
	},
/turf/open/floor/plating/airless,
/area/engine/engineering)
"ri" = (
/obj/machinery/atmospherics/components/unary/vent_pump/on/layer2{
	dir = 1
	},
/turf/open/floor/plasteel,
/area/engine/engineering)
"sU" = (
/obj/machinery/vending/cola/random,
/turf/open/floor/plasteel,
/area/engine/engineering)
"uj" = (
/obj/effect/turf_decal/stripes/line{
	dir = 4
	},
/turf/open/floor/plating,
/area/engine/engineering)
"uk" = (
/obj/effect/turf_decal/stripes/line{
	dir = 5
	},
/turf/open/floor/plating,
/area/engine/engineering)
"uU" = (
/obj/structure/grille,
/turf/open/space/basic,
/area/engine/engineering)
"va" = (
/obj/structure/cable/yellow{
	icon_state = "1-2"
	},
/obj/effect/turf_decal/stripes/line{
	dir = 9
	},
/turf/open/floor/plating,
/area/engine/engineering)
"vT" = (
/obj/structure/table,
/obj/item/extinguisher{
	pixel_x = 5;
	pixel_y = 2
	},
/obj/item/extinguisher{
	pixel_x = -10;
	pixel_y = 2
	},
/turf/open/floor/plasteel,
/area/engine/engineering)
"xe" = (
/obj/structure/cable/yellow{
	icon_state = "4-8"
	},
/obj/structure/cable/yellow{
	icon_state = "4-8"
	},
/turf/open/floor/plating,
/area/engine/engineering)
"xq" = (
/obj/machinery/vending/snack/orange,
/turf/open/floor/plasteel,
/area/engine/engineering)
"yi" = (
/turf/open/floor/plating/airless,
/area/engine/engineering)
"yP" = (
/obj/effect/turf_decal/stripes/line,
/turf/open/floor/plating,
/area/engine/engineering)
"Ad" = (
/obj/machinery/light{
	dir = 4;
	light_color = "#e8eaff"
	},
/turf/open/floor/plasteel,
/area/engine/engineering)
"Bn" = (
/obj/machinery/atmospherics/pipe/simple/supply/visible/layer2,
/obj/structure/grille,
/obj/structure/window/plasma/fulltile,
/turf/open/floor/plating,
/area/engine/engineering)
"BB" = (
/obj/machinery/light{
	dir = 8
	},
/turf/open/floor/plasteel,
/area/engine/engineering)
"BM" = (
/obj/structure/cable/yellow{
	icon_state = "4-8"
	},
/obj/structure/cable/yellow{
	icon_state = "4-8"
	},
/obj/structure/cable/yellow{
	icon_state = "2-8"
	},
/turf/open/floor/plating,
/area/engine/engineering)
"Ds" = (
/obj/structure/cable{
	icon_state = "1-2"
	},
/obj/machinery/atmospherics/pipe/simple/scrubbers/visible/layer4{
	dir = 5
	},
/obj/machinery/atmospherics/pipe/simple/supply/visible/layer2{
	dir = 5
	},
/turf/open/floor/plasteel,
/area/engine/engineering)
"DY" = (
/obj/structure/cable{
	icon_state = "1-2"
	},
/obj/machinery/atmospherics/pipe/manifold/supply/visible/layer2,
/obj/machinery/atmospherics/pipe/manifold/scrubbers/hidden/layer4,
/turf/open/floor/plasteel,
/area/engine/engineering)
"ED" = (
/mob/living/carbon/monkey,
/obj/effect/turf_decal/stripes/line{
	dir = 8
	},
/turf/open/floor/plating,
/area/engine/engineering)
"EH" = (
/obj/structure/cable/yellow{
	icon_state = "1-4"
	},
/obj/effect/turf_decal/stripes/corner{
	dir = 8
	},
/turf/open/floor/plating,
/area/engine/engineering)
"EK" = (
/obj/structure/cable/yellow{
	icon_state = "1-8"
	},
/obj/effect/turf_decal/stripes/corner,
/turf/open/floor/plating,
/area/engine/engineering)
"FN" = (
/obj/structure/lattice,
/turf/open/floor/plating/airless,
/area/engine/engineering)
"GM" = (
/obj/machinery/camera/emp_proof{
	c_tag = "Engineering Engine West";
	dir = 4;
	network = list("ss13","engine")
	},
/turf/open/floor/plasteel,
/area/engine/engineering)
"GR" = (
/obj/effect/decal/remains/human,
/turf/open/floor/plasteel,
/area/engine/engineering)
"GW" = (
/obj/machinery/atmospherics/pipe/simple/supply/hidden/layer2{
	dir = 8
	},
/obj/machinery/atmospherics/pipe/simple/scrubbers/hidden/layer4{
	dir = 4
	},
/obj/machinery/door/firedoor/border_only{
	dir = 8
	},
/obj/machinery/door/firedoor/border_only{
	dir = 4
	},
/obj/machinery/door/airlock/engineering{
	name = "AI Satellite Access";
	req_one_access_txt = "10;17;32"
	},
/turf/open/floor/plasteel,
/area/engine/engineering)
"GX" = (
/mob/living/carbon/monkey,
/turf/open/floor/plasteel,
/area/engine/engineering)
"IC" = (
/obj/machinery/light/floor,
/turf/open/floor/plating,
/area/engine/engineering)
"KB" = (
/obj/machinery/camera/emp_proof{
	c_tag = "Engineering Engine East";
	dir = 8;
	network = list("ss13","engine")
	},
/turf/open/floor/plasteel,
/area/engine/engineering)
"Nf" = (
/obj/structure/grille,
/obj/structure/grille,
/turf/open/floor/plating/airless,
/area/engine/engineering)
"NK" = (
/obj/machinery/monkey_recycler,
/turf/open/floor/plasteel,
/area/engine/engineering)
"PB" = (
/mob/living/carbon/monkey,
/obj/effect/turf_decal/stripes/line{
	dir = 4
	},
/turf/open/floor/plating,
/area/engine/engineering)
"RG" = (
/obj/structure/cable/yellow{
	icon_state = "4-8"
	},
/turf/open/floor/plating,
/area/engine/engineering)
"Sf" = (
/obj/structure/cable/yellow,
/obj/structure/cable/yellow,
/obj/machinery/power/stationarybike{
	dir = 4
	},
/obj/effect/turf_decal/stripes/line,
/turf/open/floor/plating,
/area/engine/engineering)
"Tm" = (
/obj/structure/grille,
/obj/structure/window/plasma/fulltile,
/turf/open/floor/plating,
/area/engine/engineering)
"Ut" = (
/turf/open/floor/plating,
/area/engine/engineering)
"UE" = (
/obj/machinery/atmospherics/pipe/simple/supply/hidden/layer2{
	dir = 8
	},
/obj/machinery/atmospherics/pipe/simple/scrubbers/hidden/layer4{
	dir = 4
	},
/obj/machinery/atmospherics/pipe/simple/scrubbers/visible/layer4{
	dir = 4
	},
/turf/open/floor/plasteel,
/area/engine/engineering)
"VL" = (
/obj/effect/turf_decal/stripes/line{
	dir = 4
	},
/obj/effect/decal/cleanable/food/plant_smudge,
/turf/open/floor/plating,
/area/engine/engineering)
"VZ" = (
/obj/structure/cable/yellow{
	icon_state = "1-2"
	},
/turf/open/floor/plating,
/area/engine/engineering)
"WM" = (
/obj/structure/cable/yellow{
	icon_state = "4-8"
	},
/obj/machinery/atmospherics/pipe/simple/scrubbers/hidden/layer4{
	dir = 4
	},
/obj/machinery/atmospherics/pipe/simple/supply/hidden/layer2{
	dir = 8
	},
/turf/open/floor/plasteel,
/area/engine/engineering)
"WN" = (
/obj/structure/sign/warning/securearea,
/turf/closed/wall/r_wall,
/area/engine/engineering)
"WY" = (
/obj/structure/cable/yellow{
	icon_state = "1-2"
	},
/obj/structure/cable/yellow{
	icon_state = "1-4"
	},
/obj/effect/turf_decal/stripes/corner{
	dir = 1
	},
/turf/open/floor/plating,
/area/engine/engineering)
"XK" = (
/obj/machinery/camera/emp_proof{
	c_tag = "Engineering Engine Southwest";
	dir = 1;
	network = list("ss13","engine")
	},
/turf/open/floor/plasteel,
/area/engine/engineering)
"Yy" = (
/obj/structure/cable/yellow{
	icon_state = "4-8"
	},
/obj/structure/cable/yellow{
	icon_state = "2-8"
	},
/turf/open/floor/plating,
/area/engine/engineering)

(1,1,1) = {"
ab
ab
ab
ab
ab
ab
ab
aa
aa
aa
aa
aa
aa
aa
aa
aa
aa
aa
aa
aa
aa
ab
ab
ab
ab
ab
"}
(2,1,1) = {"
ab
ab
ab
ab
ab
ab
ab
aa
aa
aa
aa
aa
aa
aa
aa
aa
aa
aa
aa
aa
aa
ab
ab
ab
ab
ab
"}
(3,1,1) = {"
ab
ab
ab
ab
ab
ab
ab
aa
aa
aa
aa
aa
aa
aa
aa
aa
aa
aa
aa
aa
aa
ab
ab
ab
ab
ab
"}
(4,1,1) = {"
ab
ab
ab
ab
ab
ab
ab
aa
aa
aa
aa
aa
aa
aa
aa
aa
aa
aa
aa
aa
aa
ab
ab
ab
ab
ab
"}
(5,1,1) = {"
ab
ab
ab
ab
ab
ab
ab
aQ
aa
aa
aa
aa
aa
aa
aa
aa
aa
aa
aa
aa
aa
ab
ab
ab
ab
ab
"}
(6,1,1) = {"
ab
ab
ab
ab
ab
ab
ab
aR
aQ
aa
aa
aa
aa
aQ
aa
aa
aa
aa
aa
aa
aa
ab
ab
ab
ab
ab
"}
(7,1,1) = {"
ab
ab
ab
ab
bb
bb
ad
ad
ad
ad
ad
ad
ad
du
ad
ad
ad
ad
aU
ad
WN
aQ
aQ
aa
aa
aa
"}
(8,1,1) = {"
ab
ab
al
bb
bb
kj
kj
vT
BB
GM
NK
iI
ac
ac
ac
ac
BB
ac
ac
ac
ad
aa
aa
aa
aa
aa
"}
(9,1,1) = {"
ab
ab
Ds
iL
ac
ac
ac
ac
ac
lN
ac
ac
ac
ac
ac
GR
ac
ac
ac
ac
ad
aR
aa
aa
aa
aa
"}
(10,1,1) = {"
ab
cb
UE
bb
ac
ac
ac
ac
ac
ac
ac
ac
ac
ac
ac
ac
ac
ac
ac
ac
ad
ad
bu
aa
aa
aa
"}
(11,1,1) = {"
aa
aa
ap
Tm
ac
ac
lf
gW
ED
gW
gW
gW
gW
gW
gW
gW
gW
gW
bB
ac
XK
ad
bu
aa
aa
aa
"}
(12,1,1) = {"
aa
aa
aC
hc
bF
va
WY
VZ
VZ
kW
VZ
VZ
kW
VZ
VZ
kW
VZ
VZ
EH
bB
ac
ad
bu
aa
aa
aa
"}
(13,1,1) = {"
aa
aa
aq
Tm
ac
gK
RG
Ut
Ut
RG
Ut
Ut
RG
Ut
Ut
RG
Ut
Ut
RG
yP
ac
ad
bu
aQ
aa
aa
"}
(14,1,1) = {"
aa
aa
bE
Bn
ri
gK
Yy
lO
Ut
Yy
lO
Ut
Yy
lO
Ut
Yy
lO
Ut
Yy
lO
lC
ad
du
aQ
aa
aa
"}
(15,1,1) = {"
aa
aa
WM
Tm
ac
gK
RG
Ut
IC
RG
Ut
Ut
RG
Ut
IC
RG
Ut
Ut
RG
yP
ac
ad
bu
aQ
aa
aa
"}
(16,1,1) = {"
aa
aa
aq
Tm
ac
gK
Yy
lO
Ut
Yy
lO
Ut
Yy
lO
Ut
Yy
lO
Ut
Yy
lO
ac
ad
uU
yi
aa
aa
"}
(17,1,1) = {"
aa
aa
aq
Tm
ac
gK
RG
Ut
Ut
RG
Ut
Ut
RG
Ut
Ut
RG
Ut
Ut
RG
yP
ac
ad
uU
yi
aa
aa
"}
(18,1,1) = {"
aa
aa
aq
Tm
ac
gK
Yy
lO
Ut
Yy
Sf
Ut
Yy
lO
Ut
Yy
lO
Ut
BM
lO
ac
ad
hK
yi
aa
aa
"}
(19,1,1) = {"
aa
aa
aq
Tm
ac
gK
RG
Ut
Ut
RG
Ut
Ut
RG
Ut
Ut
RG
Ut
Ut
xe
yP
ac
ad
hK
cj
aa
aa
"}
(20,1,1) = {"
aa
aa
aq
Tm
ac
gK
Yy
lO
Ut
Yy
lO
Ut
Yy
lO
Ut
Yy
lO
Ut
Yy
lO
ac
ad
hK
FN
aa
aa
"}
(21,1,1) = {"
aa
aa
aq
Tm
ac
gK
RG
Ut
IC
RG
Ut
Ut
RG
Ut
IC
RG
Ut
Ut
RG
yP
ac
ad
Nf
oF
aa
aa
"}
(22,1,1) = {"
aa
aa
bE
Bn
ri
gK
Yy
lO
Ut
Yy
lO
Ut
Yy
lO
Ut
Yy
lO
Ut
Yy
lO
lC
ad
du
aQ
aa
aa
"}
(23,1,1) = {"
aa
aa
aq
Tm
ac
gK
RG
Ut
Ut
RG
Ut
Ut
RG
Ut
Ut
RG
Ut
Ut
RG
yP
ac
ad
bu
aQ
aa
aa
"}
(24,1,1) = {"
aa
aa
bD
hc
bF
dN
au
VZ
VZ
hR
VZ
VZ
hR
VZ
VZ
hR
VZ
VZ
EK
oz
ac
ad
bu
aa
aa
aa
"}
(25,1,1) = {"
aa
aa
an
Tm
ac
ac
uk
VL
uj
uj
uj
uj
uj
uj
uj
PB
uj
uj
dL
ac
ac
ad
bu
aa
aa
aa
"}
(26,1,1) = {"
ac
ac
an
bb
ac
ac
GX
ac
ac
ac
ac
ac
ac
ac
ac
ac
ac
ac
ac
xq
ad
ad
bu
aa
aa
aa
"}
(27,1,1) = {"
ab
at
DY
iL
ac
ac
ac
ac
ac
ac
ac
ac
ac
ac
ac
ac
ac
ac
ac
sU
ad
aR
aa
aa
aa
aa
"}
(28,1,1) = {"
ab
ck
an
bb
bb
kj
kj
vT
Ad
KB
ac
ac
ac
ac
ac
ac
Ad
ac
ac
sU
ad
aQ
aa
aa
aa
aa
"}
(29,1,1) = {"
ab
av
GW
bb
bb
bb
ad
ad
ad
ad
ad
ad
ad
du
ad
ad
ad
ad
aU
ad
WN
aQ
aQ
aQ
aa
aa
"}
