//MAP CONVERTED BY dmm2tgm.py THIS HEADER COMMENT PREVENTS RECONVERSION, DO NOT REMOVE
"a" = (
/obj/effect/turf_decal/trimline/green/filled/line/lower,
/turf/open/floor/plasteel,
/area/template_noop)
"b" = (
/obj/machinery/atmospherics/pipe/simple/scrubbers/hidden/layer4{
	dir = 4
	},
/obj/effect/turf_decal/trimline/green/filled/corner/lower{
	dir = 4
	},
/turf/open/floor/plasteel,
/area/template_noop)
"e" = (
/obj/machinery/hydroponics/constructable,
/turf/open/floor/plasteel/dark,
/area/template_noop)
"g" = (
/obj/machinery/atmospherics/pipe/simple/supply/hidden/layer2,
/obj/machinery/atmospherics/pipe/simple/scrubbers/hidden/layer4,
/turf/open/floor/plasteel,
/area/template_noop)
"i" = (
/obj/structure/chair/stool,
/obj/effect/turf_decal/trimline/green/filled/line/lower{
	dir = 4
	},
/turf/open/floor/plasteel,
/area/template_noop)
"j" = (
/obj/machinery/atmospherics/pipe/simple/supply/hidden/layer2,
/obj/machinery/atmospherics/pipe/simple/scrubbers/hidden/layer4{
	dir = 9
	},
/turf/open/floor/plasteel,
/area/template_noop)
"l" = (
/obj/structure/sink{
	pixel_y = 20
	},
/obj/effect/turf_decal/trimline/green/filled/line/lower{
	dir = 8
	},
/turf/open/floor/plasteel,
/area/template_noop)
"n" = (
/obj/machinery/camera{
	c_tag = "Hydroponics North"
	},
/obj/machinery/hydroponics/constructable,
/turf/open/floor/plasteel/dark,
/area/template_noop)
"o" = (
/obj/machinery/vending/hydronutrients,
/turf/open/floor/plasteel,
/area/template_noop)
"p" = (
/obj/effect/turf_decal/trimline/green/filled/line/lower{
	dir = 8
	},
/turf/open/floor/plasteel,
/area/template_noop)
"s" = (
/obj/machinery/atmospherics/components/unary/vent_scrubber/on/layer4{
	dir = 1
	},
/obj/effect/turf_decal/trimline/green/filled/corner/lower,
/obj/effect/turf_decal/trimline/green/filled/corner/lower{
	dir = 1
	},
/turf/open/floor/plasteel,
/area/template_noop)
"t" = (
/obj/machinery/holopad,
/obj/effect/turf_decal/trimline/green/filled/line/lower{
	dir = 1
	},
/turf/open/floor/plasteel,
/area/template_noop)
"u" = (
/obj/machinery/seed_extractor,
/turf/open/floor/plasteel,
/area/template_noop)
"v" = (
/obj/structure/chair/stool,
/obj/effect/landmark/start/botanist,
/turf/open/floor/plasteel,
/area/template_noop)
"w" = (
/obj/machinery/disposal/bin,
/obj/structure/disposalpipe/trunk{
	dir = 8
	},
/turf/open/floor/plasteel,
/area/template_noop)
"x" = (
/obj/structure/sink{
	dir = 8;
	pixel_x = -12;
	pixel_y = 2
	},
/turf/open/floor/plasteel,
/area/template_noop)
"y" = (
/obj/effect/landmark/start/botanist,
/obj/effect/turf_decal/trimline/green/filled/line/lower,
/turf/open/floor/plasteel,
/area/template_noop)
"z" = (
/turf/open/floor/plasteel,
/area/template_noop)
"B" = (
/obj/machinery/light{
	dir = 8
	},
/obj/machinery/hydroponics/constructable,
/turf/open/floor/plasteel/dark,
/area/template_noop)
"C" = (
/obj/effect/turf_decal/trimline/green/filled/line/lower{
	dir = 1
	},
/turf/open/floor/plasteel,
/area/template_noop)
"D" = (
/turf/template_noop,
/area/template_noop)
"F" = (
/obj/effect/turf_decal/trimline/green/filled/corner/lower,
/obj/effect/turf_decal/trimline/green/filled/corner/lower{
	dir = 1
	},
/turf/open/floor/plasteel,
/area/template_noop)
"G" = (
/obj/machinery/camera{
	c_tag = "Hydroponics South";
	dir = 8
	},
/obj/machinery/hydroponics/constructable,
/turf/open/floor/plasteel/dark,
/area/template_noop)
"H" = (
/obj/structure/disposalpipe/segment{
	dir = 5
	},
/obj/machinery/atmospherics/pipe/simple/supply/hidden/layer2,
/obj/machinery/atmospherics/pipe/simple/scrubbers/hidden/layer4,
/turf/open/floor/plasteel,
/area/template_noop)
"I" = (
/obj/structure/table/glass,
/obj/item/stack/packageWrap,
/obj/item/stack/packageWrap,
/obj/item/hand_labeler,
/turf/open/floor/plasteel,
/area/template_noop)
"J" = (
/obj/effect/turf_decal/trimline/green/filled/line/lower{
	dir = 4
	},
/turf/open/floor/plasteel,
/area/template_noop)
"K" = (
/obj/machinery/vending/hydroseeds{
	slogan_delay = 700
	},
/turf/open/floor/plasteel,
/area/template_noop)
"L" = (
/obj/machinery/atmospherics/components/unary/vent_pump/on/layer2{
	dir = 1
	},
/obj/effect/turf_decal/trimline/green/filled/corner/lower{
	dir = 8
	},
/turf/open/floor/plasteel,
/area/template_noop)
"M" = (
/obj/item/kirbyplants/random,
/obj/effect/turf_decal/trimline/green/filled/line/lower,
/turf/open/floor/plasteel,
/area/template_noop)
"N" = (
/obj/structure/table/glass,
/obj/item/storage/box/syringes,
/obj/item/storage/box/beakers{
	pixel_x = 2;
	pixel_y = 2
	},
/obj/machinery/light{
	dir = 8
	},
/turf/open/floor/plasteel,
/area/template_noop)
"P" = (
/obj/machinery/atmospherics/pipe/simple/scrubbers/hidden/layer4{
	dir = 4
	},
/obj/effect/turf_decal/trimline/green/filled/corner/lower{
	dir = 1
	},
/turf/open/floor/plasteel,
/area/template_noop)
"R" = (
/obj/effect/turf_decal/trimline/green/filled/corner/lower{
	dir = 4
	},
/turf/open/floor/plasteel,
/area/template_noop)
"S" = (
/obj/machinery/light{
	dir = 4
	},
/obj/structure/reagent_dispensers/watertank/high,
/obj/item/reagent_containers/glass/bucket,
/turf/open/floor/plasteel,
/area/template_noop)
"T" = (
/obj/structure/reagent_dispensers/watertank/high,
/obj/item/reagent_containers/glass/bucket,
/turf/open/floor/plasteel,
/area/template_noop)
"V" = (
/obj/machinery/biogenerator,
/obj/machinery/light{
	dir = 4
	},
/turf/open/floor/plasteel,
/area/template_noop)
"Y" = (
/obj/machinery/atmospherics/pipe/simple/scrubbers/hidden/layer4{
	dir = 4
	},
/obj/effect/turf_decal/trimline/green/filled/line/lower{
	dir = 1
	},
/turf/open/floor/plasteel,
/area/template_noop)
"Z" = (
/obj/machinery/atmospherics/pipe/simple/scrubbers/hidden/layer4{
	dir = 6
	},
/obj/effect/turf_decal/trimline/green/filled/line/lower{
	dir = 8
	},
/turf/open/floor/plasteel,
/area/template_noop)

(1,1,1) = {"
e
B
e
C
z
N
I
T
x
"}
(2,1,1) = {"
l
p
Z
s
J
J
R
z
z
"}
(3,1,1) = {"
J
J
b
a
e
e
C
z
z
"}
(4,1,1) = {"
n
e
Y
y
e
e
C
z
D
"}
(5,1,1) = {"
e
e
Y
a
e
e
t
z
D
"}
(6,1,1) = {"
p
p
P
a
e
e
C
v
D
"}
(7,1,1) = {"
H
g
j
L
p
p
F
i
D
"}
(8,1,1) = {"
w
V
u
K
o
S
M
G
D
"}
