//MAP CONVERTED BY dmm2tgm.py THIS HEADER COMMENT PREVENTS RECONVERSION, DO NOT REMOVE
"a" = (
/obj/effect/turf_decal/tile/green,
/obj/effect/turf_decal/tile/green{
	dir = 8
	},
/turf/open/floor/plasteel,
/area/template_noop)
"c" = (
/obj/machinery/hydroponics/constructable,
/obj/effect/turf_decal/tile/black{
	dir = 1
	},
/obj/effect/turf_decal/tile/black{
	dir = 4
	},
/obj/effect/turf_decal/tile/black,
/obj/effect/turf_decal/tile/black{
	dir = 8
	},
/obj/machinery/light{
	dir = 4
	},
/turf/open/floor/plasteel,
/area/template_noop)
"e" = (
/obj/structure/sink{
	dir = 8;
	pixel_x = -12;
	pixel_y = 2
	},
/obj/effect/turf_decal/tile/green{
	dir = 1
	},
/obj/effect/turf_decal/tile/green{
	dir = 4
	},
/turf/open/floor/plasteel,
/area/template_noop)
"f" = (
/obj/effect/turf_decal/tile/green{
	dir = 1
	},
/obj/effect/turf_decal/tile/green{
	dir = 4
	},
/turf/open/floor/plasteel,
/area/template_noop)
"g" = (
/obj/machinery/hydroponics/constructable,
/obj/effect/turf_decal/tile/black{
	dir = 1
	},
/obj/effect/turf_decal/tile/black{
	dir = 4
	},
/obj/effect/turf_decal/tile/black,
/obj/effect/turf_decal/tile/black{
	dir = 8
	},
/obj/machinery/light{
	dir = 8
	},
/turf/open/floor/plasteel,
/area/template_noop)
"h" = (
/obj/structure/disposalpipe/segment{
	dir = 5
	},
/obj/machinery/atmospherics/pipe/simple/supply/hidden/layer2,
/obj/machinery/atmospherics/pipe/simple/scrubbers/hidden/layer4,
/obj/effect/turf_decal/tile/green,
/obj/effect/turf_decal/tile/green{
	dir = 8
	},
/obj/effect/turf_decal/tile/green{
	dir = 1
	},
/turf/open/floor/plasteel,
/area/template_noop)
"k" = (
/obj/machinery/hydroponics/constructable,
/obj/effect/turf_decal/tile/black{
	dir = 1
	},
/obj/effect/turf_decal/tile/black{
	dir = 4
	},
/obj/effect/turf_decal/tile/black,
/obj/effect/turf_decal/tile/black{
	dir = 8
	},
/obj/machinery/camera{
	c_tag = "Hydroponics North"
	},
/turf/open/floor/plasteel,
/area/template_noop)
"l" = (
/obj/effect/turf_decal/tile/green{
	dir = 4
	},
/turf/open/floor/plasteel,
/area/template_noop)
"m" = (
/obj/effect/landmark/start/botanist,
/obj/structure/chair/stool,
/turf/open/floor/plasteel,
/area/template_noop)
"n" = (
/obj/effect/turf_decal/tile/green{
	dir = 1
	},
/turf/open/floor/plasteel,
/area/template_noop)
"o" = (
/obj/effect/landmark/start/botanist,
/obj/effect/turf_decal/tile/green{
	dir = 4
	},
/turf/open/floor/plasteel,
/area/template_noop)
"p" = (
/turf/template_noop,
/area/template_noop)
"q" = (
/obj/structure/reagent_dispensers/watertank/high,
/obj/effect/turf_decal/tile/green{
	dir = 1
	},
/obj/effect/turf_decal/tile/green{
	dir = 4
	},
/obj/item/reagent_containers/glass/bucket,
/obj/machinery/camera{
	c_tag = "Hydroponics South";
	dir = 8
	},
/turf/open/floor/plasteel,
/area/template_noop)
"r" = (
/obj/machinery/seed_extractor,
/turf/open/floor/plasteel,
/area/template_noop)
"s" = (
/obj/machinery/atmospherics/pipe/simple/supply/hidden/layer2,
/obj/machinery/atmospherics/pipe/simple/scrubbers/hidden/layer4{
	dir = 9
	},
/obj/effect/turf_decal/tile/green{
	dir = 4
	},
/obj/effect/turf_decal/tile/green,
/turf/open/floor/plasteel,
/area/template_noop)
"t" = (
/obj/machinery/atmospherics/pipe/simple/scrubbers/hidden/layer4{
	dir = 4
	},
/obj/effect/turf_decal/tile/green,
/turf/open/floor/plasteel,
/area/template_noop)
"v" = (
/obj/machinery/vending/hydronutrients,
/turf/open/floor/plasteel,
/area/template_noop)
"x" = (
/obj/machinery/atmospherics/pipe/simple/supply/hidden/layer2,
/obj/machinery/atmospherics/pipe/simple/scrubbers/hidden/layer4,
/obj/effect/turf_decal/tile/green{
	dir = 1
	},
/obj/effect/turf_decal/tile/green{
	dir = 4
	},
/obj/effect/turf_decal/tile/green,
/turf/open/floor/plasteel,
/area/template_noop)
"y" = (
/obj/structure/reagent_dispensers/watertank/high,
/obj/item/reagent_containers/glass/bucket,
/turf/open/floor/plasteel,
/area/template_noop)
"B" = (
/obj/machinery/atmospherics/pipe/simple/scrubbers/hidden/layer4{
	dir = 4
	},
/obj/effect/turf_decal/tile/green,
/obj/effect/turf_decal/tile/green{
	dir = 8
	},
/turf/open/floor/plasteel,
/area/template_noop)
"C" = (
/obj/machinery/atmospherics/pipe/simple/scrubbers/hidden/layer4{
	dir = 4
	},
/obj/effect/turf_decal/tile/green{
	dir = 8
	},
/turf/open/floor/plasteel,
/area/template_noop)
"D" = (
/obj/machinery/biogenerator,
/obj/effect/turf_decal/tile/green{
	dir = 4
	},
/obj/effect/turf_decal/tile/green,
/turf/open/floor/plasteel,
/area/template_noop)
"E" = (
/turf/open/floor/plasteel,
/area/template_noop)
"H" = (
/obj/machinery/disposal/bin,
/obj/structure/disposalpipe/trunk{
	dir = 8
	},
/obj/effect/turf_decal/tile/green,
/obj/effect/turf_decal/tile/green{
	dir = 8
	},
/turf/open/floor/plasteel,
/area/template_noop)
"I" = (
/obj/structure/table/glass,
/obj/effect/turf_decal/tile/green{
	dir = 4
	},
/obj/effect/turf_decal/tile/green,
/obj/item/stack/packageWrap,
/obj/item/stack/packageWrap,
/obj/item/hand_labeler,
/turf/open/floor/plasteel,
/area/template_noop)
"J" = (
/obj/structure/sink{
	dir = 8;
	pixel_x = -12;
	pixel_y = 2
	},
/obj/effect/turf_decal/tile/green,
/obj/effect/turf_decal/tile/green{
	dir = 8
	},
/turf/open/floor/plasteel,
/area/template_noop)
"K" = (
/obj/machinery/hydroponics/constructable,
/obj/effect/turf_decal/tile/black{
	dir = 1
	},
/obj/effect/turf_decal/tile/black{
	dir = 4
	},
/obj/effect/turf_decal/tile/black,
/obj/effect/turf_decal/tile/black{
	dir = 8
	},
/turf/open/floor/plasteel,
/area/template_noop)
"L" = (
/obj/structure/table/glass,
/obj/effect/turf_decal/tile/green{
	dir = 4
	},
/obj/effect/turf_decal/tile/green,
/obj/item/storage/box/syringes,
/obj/item/storage/box/beakers{
	pixel_x = 2;
	pixel_y = 2
	},
/turf/open/floor/plasteel,
/area/template_noop)
"N" = (
/obj/effect/turf_decal/tile/green{
	dir = 1
	},
/obj/effect/turf_decal/tile/green{
	dir = 4
	},
/obj/machinery/holopad,
/turf/open/floor/plasteel,
/area/template_noop)
"O" = (
/obj/machinery/vending/hydroseeds{
	slogan_delay = 700
	},
/turf/open/floor/plasteel,
/area/template_noop)
"R" = (
/obj/effect/turf_decal/tile/green{
	dir = 1
	},
/obj/effect/turf_decal/tile/green{
	dir = 8
	},
/turf/open/floor/plasteel,
/area/template_noop)
"S" = (
/obj/effect/turf_decal/tile/green{
	dir = 8
	},
/turf/open/floor/plasteel,
/area/template_noop)
"U" = (
/obj/machinery/atmospherics/components/unary/vent_scrubber/on/layer4{
	dir = 1
	},
/obj/effect/turf_decal/tile/green{
	dir = 1
	},
/turf/open/floor/plasteel,
/area/template_noop)
"W" = (
/obj/machinery/atmospherics/pipe/simple/scrubbers/hidden/layer4{
	dir = 6
	},
/obj/effect/turf_decal/tile/green{
	dir = 1
	},
/obj/effect/turf_decal/tile/green{
	dir = 8
	},
/turf/open/floor/plasteel,
/area/template_noop)
"X" = (
/obj/machinery/atmospherics/components/unary/vent_pump/on/layer2{
	dir = 1
	},
/obj/effect/turf_decal/tile/green{
	dir = 4
	},
/obj/effect/turf_decal/tile/green,
/turf/open/floor/plasteel,
/area/template_noop)
"Y" = (
/obj/effect/turf_decal/tile/green{
	dir = 4
	},
/obj/effect/turf_decal/tile/green,
/turf/open/floor/plasteel,
/area/template_noop)

(1,1,1) = {"
y
J
g
f
a
g
K
K
e
"}
(2,1,1) = {"
r
S
W
U
S
R
R
R
n
"}
(3,1,1) = {"
D
l
t
L
I
o
E
E
E
"}
(4,1,1) = {"
k
f
B
K
K
f
E
v
p
"}
(5,1,1) = {"
K
f
B
K
K
N
E
O
p
"}
(6,1,1) = {"
K
f
C
R
R
n
E
m
p
"}
(7,1,1) = {"
h
x
s
X
Y
Y
Y
l
p
"}
(8,1,1) = {"
H
c
K
K
K
c
K
q
p
"}
