//MAP CONVERTED BY dmm2tgm.py THIS HEADER COMMENT PREVENTS RECONVERSION, DO NOT REMOVE
"a" = (
/obj/structure/sink{
	dir = 8;
	pixel_x = -12;
	pixel_y = 2
	},
/turf/open/floor/plasteel,
/area/template_noop)
"b" = (
/obj/machinery/atmospherics/pipe/simple/scrubbers/hidden/layer4{
	dir = 4
	},
/obj/machinery/hydroponics/constructable,
/obj/effect/turf_decal/tile/black{
	dir = 1
	},
/obj/effect/turf_decal/tile/black{
	dir = 4
	},
/obj/effect/turf_decal/tile/black,
/obj/effect/turf_decal/tile/black{
	dir = 8
	},
/turf/open/floor/plasteel,
/area/template_noop)
"c" = (
/obj/effect/turf_decal/tile/green{
	dir = 4
	},
/obj/effect/turf_decal/tile/green{
	dir = 1
	},
/obj/machinery/holopad,
/turf/open/floor/plasteel,
/area/template_noop)
"d" = (
/obj/machinery/hydroponics/constructable,
/obj/effect/turf_decal/tile/black{
	dir = 1
	},
/obj/effect/turf_decal/tile/black{
	dir = 4
	},
/obj/effect/turf_decal/tile/black,
/obj/effect/turf_decal/tile/black{
	dir = 8
	},
/turf/open/floor/plasteel,
/area/template_noop)
"e" = (
/obj/machinery/light{
	dir = 4
	},
/obj/structure/disposalpipe/trunk{
	dir = 8
	},
/obj/machinery/disposal/bin,
/obj/effect/turf_decal/tile/green{
	dir = 4
	},
/obj/effect/turf_decal/tile/green{
	dir = 1
	},
/turf/open/floor/plasteel,
/area/template_noop)
"f" = (
/obj/machinery/hydroponics/constructable,
/obj/effect/turf_decal/tile/black{
	dir = 4
	},
/obj/effect/turf_decal/tile/black,
/obj/effect/turf_decal/tile/black{
	dir = 8
	},
/obj/effect/turf_decal/tile/black{
	dir = 1
	},
/turf/open/floor/plasteel,
/area/template_noop)
"g" = (
/obj/machinery/atmospherics/pipe/simple/supply/hidden/layer2,
/obj/machinery/atmospherics/pipe/simple/scrubbers/hidden/layer4{
	dir = 9
	},
/obj/effect/turf_decal/tile/green{
	dir = 8
	},
/obj/effect/turf_decal/tile/green{
	dir = 1
	},
/turf/open/floor/plasteel,
/area/template_noop)
"h" = (
/obj/effect/turf_decal/tile/green{
	dir = 8
	},
/obj/effect/turf_decal/tile/green{
	dir = 1
	},
/turf/open/floor/plasteel,
/area/template_noop)
"k" = (
/obj/item/twohanded/required/kirbyplants/random,
/turf/open/floor/plasteel,
/area/template_noop)
"m" = (
/turf/template_noop,
/area/template_noop)
"n" = (
/obj/machinery/atmospherics/components/unary/vent_scrubber/on/layer4{
	dir = 1
	},
/obj/effect/turf_decal/tile/green,
/obj/effect/turf_decal/tile/green{
	dir = 4
	},
/obj/effect/turf_decal/tile/green{
	dir = 1
	},
/turf/open/floor/plasteel,
/area/template_noop)
"p" = (
/obj/machinery/atmospherics/pipe/simple/supply/hidden/layer2,
/obj/machinery/atmospherics/pipe/simple/scrubbers/hidden/layer4,
/obj/effect/turf_decal/tile/green{
	dir = 8
	},
/obj/effect/turf_decal/tile/green{
	dir = 1
	},
/obj/structure/disposalpipe/segment{
	dir = 5
	},
/obj/effect/turf_decal/tile/green{
	dir = 4
	},
/turf/open/floor/plasteel,
/area/template_noop)
"s" = (
/obj/effect/turf_decal/tile/green{
	dir = 1
	},
/turf/open/floor/plasteel,
/area/template_noop)
"t" = (
/obj/structure/reagent_dispensers/watertank/high,
/obj/item/reagent_containers/glass/bucket,
/turf/open/floor/plasteel,
/area/template_noop)
"u" = (
/obj/structure/sink{
	dir = 4;
	pixel_x = 11
	},
/turf/open/floor/plasteel,
/area/template_noop)
"v" = (
/obj/machinery/vending/hydronutrients,
/turf/open/floor/plasteel,
/area/template_noop)
"w" = (
/obj/machinery/biogenerator,
/turf/open/floor/plasteel,
/area/template_noop)
"x" = (
/obj/effect/turf_decal/tile/green{
	dir = 4
	},
/turf/open/floor/plasteel,
/area/template_noop)
"z" = (
/obj/effect/landmark/start/botanist,
/obj/effect/turf_decal/tile/green{
	dir = 8
	},
/obj/effect/turf_decal/tile/green,
/obj/effect/turf_decal/tile/green{
	dir = 4
	},
/obj/effect/turf_decal/tile/green{
	dir = 1
	},
/turf/open/floor/plasteel,
/area/template_noop)
"C" = (
/turf/open/floor/plasteel,
/area/template_noop)
"D" = (
/obj/machinery/atmospherics/pipe/simple/scrubbers/hidden/layer4{
	dir = 6
	},
/obj/machinery/hydroponics/constructable,
/obj/effect/turf_decal/tile/black{
	dir = 1
	},
/obj/effect/turf_decal/tile/black{
	dir = 4
	},
/obj/effect/turf_decal/tile/black,
/obj/effect/turf_decal/tile/black{
	dir = 8
	},
/turf/open/floor/plasteel,
/area/template_noop)
"F" = (
/obj/machinery/atmospherics/pipe/simple/supply/hidden/layer2,
/obj/machinery/atmospherics/pipe/simple/scrubbers/hidden/layer4,
/obj/effect/turf_decal/tile/green{
	dir = 8
	},
/obj/effect/turf_decal/tile/green{
	dir = 1
	},
/obj/structure/disposalpipe/segment{
	dir = 2
	},
/obj/effect/turf_decal/tile/green{
	dir = 4
	},
/obj/effect/turf_decal/tile/green,
/turf/open/floor/plasteel,
/area/template_noop)
"G" = (
/obj/effect/turf_decal/tile/green{
	dir = 8
	},
/obj/effect/turf_decal/tile/green,
/obj/effect/turf_decal/tile/green{
	dir = 4
	},
/obj/effect/turf_decal/tile/green{
	dir = 1
	},
/turf/open/floor/plasteel,
/area/template_noop)
"H" = (
/obj/effect/turf_decal/tile/green{
	dir = 4
	},
/obj/effect/turf_decal/tile/green,
/turf/open/floor/plasteel,
/area/template_noop)
"I" = (
/obj/effect/turf_decal/tile/green,
/obj/effect/turf_decal/tile/green{
	dir = 4
	},
/obj/effect/turf_decal/tile/green{
	dir = 1
	},
/obj/machinery/light{
	dir = 8
	},
/turf/open/floor/plasteel,
/area/template_noop)
"K" = (
/obj/structure/table/glass,
/obj/item/storage/box/syringes,
/obj/item/storage/box/beakers{
	pixel_x = 2;
	pixel_y = 2
	},
/obj/machinery/light{
	dir = 4
	},
/turf/open/floor/plasteel,
/area/template_noop)
"L" = (
/obj/structure/reagent_dispensers/watertank/high,
/obj/item/reagent_containers/glass/bucket,
/obj/machinery/camera{
	c_tag = "Hydroponics South";
	dir = 8
	},
/turf/open/floor/plasteel,
/area/template_noop)
"N" = (
/obj/machinery/hydroponics/constructable,
/obj/effect/turf_decal/tile/black{
	dir = 1
	},
/obj/effect/turf_decal/tile/black{
	dir = 4
	},
/obj/effect/turf_decal/tile/black,
/obj/effect/turf_decal/tile/black{
	dir = 8
	},
/obj/machinery/camera{
	c_tag = "Hydroponics North"
	},
/turf/open/floor/plasteel,
/area/template_noop)
"O" = (
/obj/machinery/vending/hydroseeds{
	slogan_delay = 700
	},
/turf/open/floor/plasteel,
/area/template_noop)
"P" = (
/obj/structure/table/glass,
/obj/item/stack/packageWrap,
/obj/item/stack/packageWrap,
/obj/item/hand_labeler,
/turf/open/floor/plasteel,
/area/template_noop)
"Q" = (
/obj/machinery/seed_extractor,
/turf/open/floor/plasteel,
/area/template_noop)
"R" = (
/obj/effect/turf_decal/tile/green,
/obj/effect/turf_decal/tile/green{
	dir = 4
	},
/turf/open/floor/plasteel,
/area/template_noop)
"T" = (
/obj/machinery/atmospherics/components/unary/vent_pump/on/layer2{
	dir = 1
	},
/obj/effect/turf_decal/tile/green{
	dir = 8
	},
/obj/effect/turf_decal/tile/green{
	dir = 1
	},
/turf/open/floor/plasteel,
/area/template_noop)
"W" = (
/obj/machinery/light{
	dir = 8
	},
/turf/open/floor/plasteel,
/area/template_noop)
"X" = (
/obj/effect/turf_decal/tile/green{
	dir = 4
	},
/obj/effect/turf_decal/tile/green{
	dir = 1
	},
/turf/open/floor/plasteel,
/area/template_noop)
"Y" = (
/obj/structure/chair/stool,
/obj/effect/landmark/start/botanist,
/turf/open/floor/plasteel,
/area/template_noop)

(1,1,1) = {"
d
I
H
x
C
W
a
O
v
"}
(2,1,1) = {"
d
z
D
n
R
x
C
C
C
"}
(3,1,1) = {"
d
G
b
G
d
X
C
C
C
"}
(4,1,1) = {"
N
G
b
G
d
X
C
w
m
"}
(5,1,1) = {"
d
G
b
G
d
c
C
Q
m
"}
(6,1,1) = {"
d
G
b
G
d
X
C
Y
m
"}
(7,1,1) = {"
F
p
g
T
h
s
C
C
m
"}
(8,1,1) = {"
f
e
k
u
P
K
t
L
m
"}
