//MAP CONVERTED BY dmm2tgm.py THIS HEADER COMMENT PREVENTS RECONVERSION, DO NOT REMOVE
"a" = (
/obj/machinery/hydroponics/constructable,
/obj/effect/turf_decal/tile/black{
	dir = 8
	},
/obj/effect/turf_decal/tile/black{
	dir = 1
	},
/obj/effect/turf_decal/tile/black{
	dir = 4
	},
/obj/effect/turf_decal/tile/black,
/turf/template_noop,
/area/hydroponics)
"b" = (
/obj/machinery/atmospherics/pipe/simple/scrubbers/hidden/layer4{
	dir = 4
	},
/turf/template_noop,
/area/hydroponics)
"c" = (
/obj/machinery/hydroponics/constructable,
/obj/effect/turf_decal/tile/black{
	dir = 8
	},
/obj/effect/turf_decal/tile/black{
	dir = 1
	},
/obj/effect/turf_decal/tile/black{
	dir = 4
	},
/obj/effect/turf_decal/tile/black,
/obj/machinery/light{
	dir = 4
	},
/turf/template_noop,
/area/hydroponics)
"d" = (
/obj/effect/turf_decal/tile/green{
	dir = 8
	},
/turf/template_noop,
/area/hydroponics)
"e" = (
/obj/machinery/vending/hydroseeds{
	slogan_delay = 700
	},
/turf/template_noop,
/area/hydroponics)
"f" = (
/obj/effect/turf_decal/tile/green{
	dir = 8
	},
/obj/effect/turf_decal/tile/green{
	dir = 1
	},
/obj/effect/turf_decal/tile/green{
	dir = 4
	},
/turf/template_noop,
/area/hydroponics)
"h" = (
/obj/machinery/atmospherics/components/unary/vent_scrubber/on/layer4{
	dir = 1
	},
/obj/effect/turf_decal/tile/green{
	dir = 1
	},
/turf/template_noop,
/area/hydroponics)
"i" = (
/obj/effect/turf_decal/tile/green{
	dir = 1
	},
/obj/effect/turf_decal/tile/green{
	dir = 4
	},
/turf/template_noop,
/area/hydroponics)
"j" = (
/obj/structure/table/glass,
/obj/item/storage/box/syringes,
/obj/item/storage/box/beakers{
	pixel_x = 2;
	pixel_y = 2
	},
/turf/template_noop,
/area/hydroponics)
"l" = (
/obj/effect/turf_decal/tile/green,
/turf/template_noop,
/area/hydroponics)
"p" = (
/obj/machinery/biogenerator,
/turf/template_noop,
/area/hydroponics)
"q" = (
/obj/structure/disposalpipe/segment{
	dir = 5
	},
/obj/machinery/atmospherics/pipe/simple/supply/hidden/layer2,
/obj/machinery/atmospherics/pipe/simple/scrubbers/hidden/layer4,
/obj/effect/turf_decal/tile/green{
	dir = 8
	},
/obj/effect/turf_decal/tile/green{
	dir = 1
	},
/obj/effect/turf_decal/tile/green,
/turf/template_noop,
/area/hydroponics)
"r" = (
/obj/effect/landmark/start/botanist,
/obj/structure/chair/stool,
/obj/effect/turf_decal/tile/green{
	dir = 8
	},
/obj/effect/turf_decal/tile/green{
	dir = 1
	},
/turf/template_noop,
/area/hydroponics)
"s" = (
/obj/effect/turf_decal/tile/green{
	dir = 4
	},
/obj/effect/turf_decal/tile/green,
/turf/template_noop,
/area/hydroponics)
"t" = (
/obj/effect/turf_decal/tile/green{
	dir = 8
	},
/obj/effect/turf_decal/tile/green{
	dir = 1
	},
/turf/template_noop,
/area/hydroponics)
"u" = (
/obj/structure/reagent_dispensers/watertank/high,
/obj/effect/turf_decal/tile/green{
	dir = 4
	},
/obj/effect/turf_decal/tile/green{
	dir = 1
	},
/obj/item/reagent_containers/glass/bucket,
/turf/template_noop,
/area/hydroponics)
"v" = (
/obj/effect/turf_decal/tile/green{
	dir = 8
	},
/obj/effect/turf_decal/tile/green{
	dir = 4
	},
/obj/effect/turf_decal/tile/green,
/turf/template_noop,
/area/hydroponics)
"w" = (
/obj/machinery/seed_extractor,
/turf/template_noop,
/area/hydroponics)
"x" = (
/obj/structure/sink{
	dir = 8;
	pixel_x = -12;
	pixel_y = 2
	},
/turf/template_noop,
/area/hydroponics)
"y" = (
/turf/template_noop,
/area/hydroponics)
"A" = (
/obj/structure/table/glass,
/obj/item/stack/packageWrap,
/obj/item/stack/packageWrap,
/obj/item/hand_labeler,
/turf/template_noop,
/area/hydroponics)
"C" = (
/obj/machinery/disposal/bin,
/obj/structure/disposalpipe/trunk{
	dir = 8
	},
/obj/effect/turf_decal/tile/green{
	dir = 8
	},
/obj/effect/turf_decal/tile/green,
/turf/template_noop,
/area/hydroponics)
"E" = (
/obj/effect/turf_decal/tile/green{
	dir = 4
	},
/turf/template_noop,
/area/hydroponics)
"H" = (
/obj/structure/reagent_dispensers/watertank/high,
/obj/effect/turf_decal/tile/green{
	dir = 1
	},
/obj/effect/turf_decal/tile/green{
	dir = 4
	},
/obj/item/reagent_containers/glass/bucket,
/turf/template_noop,
/area/hydroponics)
"J" = (
/obj/machinery/atmospherics/pipe/simple/scrubbers/hidden/layer4{
	dir = 6
	},
/obj/effect/turf_decal/tile/green{
	dir = 8
	},
/obj/effect/turf_decal/tile/green{
	dir = 1
	},
/turf/template_noop,
/area/hydroponics)
"K" = (
/obj/effect/turf_decal/tile/green{
	dir = 8
	},
/obj/effect/turf_decal/tile/green,
/turf/template_noop,
/area/hydroponics)
"L" = (
/obj/effect/landmark/start/botanist,
/turf/template_noop,
/area/hydroponics)
"M" = (
/obj/machinery/atmospherics/components/unary/vent_pump/on/layer2{
	dir = 1
	},
/obj/effect/turf_decal/tile/green{
	dir = 4
	},
/obj/effect/turf_decal/tile/green,
/turf/template_noop,
/area/hydroponics)
"N" = (
/obj/effect/turf_decal/tile/green,
/obj/effect/turf_decal/tile/green{
	dir = 8
	},
/turf/template_noop,
/area/hydroponics)
"O" = (
/obj/machinery/hydroponics/constructable,
/obj/effect/turf_decal/tile/black{
	dir = 4
	},
/obj/effect/turf_decal/tile/black,
/obj/effect/turf_decal/tile/black{
	dir = 1
	},
/obj/effect/turf_decal/tile/black{
	dir = 8
	},
/turf/template_noop,
/area/hydroponics)
"R" = (
/obj/structure/sink{
	dir = 8;
	pixel_x = -12;
	pixel_y = 2
	},
/obj/effect/turf_decal/tile/green{
	dir = 8
	},
/obj/effect/turf_decal/tile/green,
/turf/template_noop,
/area/hydroponics)
"U" = (
/obj/machinery/hydroponics/constructable,
/obj/effect/turf_decal/tile/black{
	dir = 8
	},
/obj/effect/turf_decal/tile/black{
	dir = 1
	},
/obj/effect/turf_decal/tile/black{
	dir = 4
	},
/obj/effect/turf_decal/tile/black,
/obj/machinery/light{
	dir = 8
	},
/turf/template_noop,
/area/hydroponics)
"V" = (
/obj/machinery/atmospherics/pipe/simple/supply/hidden/layer2,
/obj/machinery/atmospherics/pipe/simple/scrubbers/hidden/layer4{
	dir = 9
	},
/obj/effect/turf_decal/tile/green{
	dir = 4
	},
/obj/effect/turf_decal/tile/green,
/turf/template_noop,
/area/hydroponics)
"W" = (
/obj/machinery/vending/hydronutrients,
/turf/template_noop,
/area/hydroponics)
"X" = (
/obj/effect/turf_decal/tile/green{
	dir = 1
	},
/turf/template_noop,
/area/hydroponics)
"Y" = (
/obj/machinery/holopad,
/turf/template_noop,
/area/hydroponics)
"Z" = (
/obj/machinery/atmospherics/pipe/simple/supply/hidden/layer2,
/obj/machinery/atmospherics/pipe/simple/scrubbers/hidden/layer4,
/obj/effect/turf_decal/tile/green{
	dir = 1
	},
/obj/effect/turf_decal/tile/green{
	dir = 4
	},
/obj/effect/turf_decal/tile/green,
/turf/template_noop,
/area/hydroponics)

(1,1,1) = {"
R
U
a
i
K
U
a
H
x
"}
(2,1,1) = {"
v
f
J
h
d
t
t
X
y
"}
(3,1,1) = {"
a
i
b
j
A
L
l
s
E
"}
(4,1,1) = {"
a
i
b
w
W
y
N
O
y
"}
(5,1,1) = {"
a
i
b
p
e
Y
N
O
y
"}
(6,1,1) = {"
a
i
b
y
y
y
d
r
y
"}
(7,1,1) = {"
q
Z
V
M
s
s
s
E
y
"}
(8,1,1) = {"
C
c
a
a
a
c
a
u
y
"}
