//MAP CONVERTED BY dmm2tgm.py THIS HEADER COMMENT PREVENTS RECONVERSION, DO NOT REMOVE
"a" = (
/obj/machinery/holopad,
/turf/open/floor/plasteel,
/area/template_noop)
"b" = (
/obj/structure/table/glass,
/obj/item/stack/packageWrap,
/obj/item/stack/packageWrap,
/obj/item/hand_labeler,
/turf/open/floor/plasteel,
/area/template_noop)
"c" = (
/obj/machinery/atmospherics/pipe/simple/supply/hidden/layer2,
/obj/machinery/atmospherics/pipe/simple/scrubbers/hidden/layer4{
	dir = 9
	},
/obj/effect/turf_decal/trimline/green/filled/line/lower{
	dir = 4
	},
/turf/open/floor/plasteel,
/area/template_noop)
"d" = (
/obj/machinery/atmospherics/components/unary/vent_scrubber/on/layer4{
	dir = 1
	},
/obj/effect/turf_decal/trimline/green/filled/corner/lower{
	dir = 1
	},
/turf/open/floor/plasteel,
/area/template_noop)
"e" = (
/obj/structure/sink{
	dir = 8;
	pixel_x = -12;
	pixel_y = 2
	},
/obj/effect/turf_decal/trimline/green/filled/line/lower,
/turf/open/floor/plasteel,
/area/template_noop)
"f" = (
/obj/machinery/atmospherics/pipe/simple/scrubbers/hidden/layer4{
	dir = 4
	},
/turf/open/floor/plasteel,
/area/template_noop)
"j" = (
/obj/machinery/atmospherics/components/unary/vent_pump/on/layer2{
	dir = 1
	},
/obj/effect/turf_decal/trimline/green/filled/line/lower{
	dir = 4
	},
/turf/open/floor/plasteel,
/area/template_noop)
"k" = (
/obj/effect/turf_decal/trimline/green/filled/line/lower{
	dir = 8
	},
/turf/open/floor/plasteel,
/area/template_noop)
"l" = (
/obj/effect/turf_decal/trimline/green/filled/corner/lower{
	dir = 1
	},
/turf/open/floor/plasteel,
/area/template_noop)
"m" = (
/obj/effect/turf_decal/trimline/green/filled/line/lower{
	dir = 8
	},
/obj/effect/turf_decal/trimline/green/filled/corner/lower{
	dir = 4
	},
/turf/open/floor/plasteel,
/area/template_noop)
"o" = (
/obj/machinery/camera{
	c_tag = "Hydroponics North"
	},
/obj/machinery/hydroponics/constructable,
/turf/open/floor/plasteel/dark,
/area/template_noop)
"q" = (
/obj/structure/reagent_dispensers/watertank/high,
/obj/item/reagent_containers/glass/bucket,
/obj/effect/turf_decal/trimline/green/filled/line/lower{
	dir = 1
	},
/turf/open/floor/plasteel,
/area/template_noop)
"r" = (
/obj/machinery/disposal/bin,
/obj/structure/disposalpipe/trunk{
	dir = 8
	},
/obj/effect/turf_decal/trimline/green/filled/line/lower,
/turf/open/floor/plasteel,
/area/template_noop)
"s" = (
/obj/structure/table/glass,
/obj/item/storage/box/syringes,
/obj/item/storage/box/beakers{
	pixel_x = 2;
	pixel_y = 2
	},
/turf/open/floor/plasteel,
/area/template_noop)
"u" = (
/obj/machinery/light{
	dir = 8
	},
/obj/machinery/hydroponics/constructable,
/turf/open/floor/plasteel/dark,
/area/template_noop)
"v" = (
/obj/structure/reagent_dispensers/watertank/high,
/obj/item/reagent_containers/glass/bucket,
/obj/machinery/camera{
	c_tag = "Hydroponics South";
	dir = 8
	},
/obj/effect/turf_decal/trimline/green/filled/line/lower{
	dir = 1
	},
/turf/open/floor/plasteel,
/area/template_noop)
"w" = (
/obj/machinery/biogenerator,
/turf/open/floor/plasteel,
/area/template_noop)
"x" = (
/obj/effect/turf_decal/trimline/green/filled/line/lower{
	dir = 4
	},
/turf/open/floor/plasteel,
/area/template_noop)
"y" = (
/obj/effect/landmark/start/botanist,
/turf/open/floor/plasteel,
/area/template_noop)
"z" = (
/obj/machinery/light{
	dir = 4
	},
/obj/machinery/hydroponics/constructable,
/turf/open/floor/plasteel/dark,
/area/template_noop)
"A" = (
/obj/machinery/atmospherics/pipe/simple/supply/hidden/layer2,
/obj/machinery/atmospherics/pipe/simple/scrubbers/hidden/layer4,
/obj/effect/turf_decal/trimline/green/filled/line/lower{
	dir = 4
	},
/obj/effect/turf_decal/trimline/green/filled/corner/lower{
	dir = 1
	},
/turf/open/floor/plasteel,
/area/template_noop)
"D" = (
/obj/machinery/seed_extractor,
/turf/open/floor/plasteel,
/area/template_noop)
"E" = (
/obj/machinery/atmospherics/pipe/simple/scrubbers/hidden/layer4{
	dir = 6
	},
/obj/effect/turf_decal/trimline/green/filled/line/lower{
	dir = 8
	},
/turf/open/floor/plasteel,
/area/template_noop)
"F" = (
/obj/effect/turf_decal/trimline/green/filled/line/lower,
/turf/open/floor/plasteel,
/area/template_noop)
"H" = (
/obj/machinery/vending/hydroseeds{
	slogan_delay = 700
	},
/turf/open/floor/plasteel,
/area/template_noop)
"J" = (
/obj/effect/turf_decal/trimline/green/filled/line/lower{
	dir = 1
	},
/turf/open/floor/plasteel,
/area/template_noop)
"K" = (
/obj/machinery/vending/hydronutrients,
/turf/open/floor/plasteel,
/area/template_noop)
"M" = (
/obj/effect/turf_decal/trimline/green/filled/corner/lower{
	dir = 8
	},
/turf/open/floor/plasteel,
/area/template_noop)
"N" = (
/obj/effect/turf_decal/trimline/green/filled/corner/lower,
/turf/open/floor/plasteel,
/area/template_noop)
"Q" = (
/obj/structure/sink{
	dir = 8;
	pixel_x = -12;
	pixel_y = 2
	},
/turf/open/floor/plasteel,
/area/template_noop)
"R" = (
/obj/effect/landmark/start/botanist,
/obj/structure/chair/stool,
/obj/effect/turf_decal/trimline/green/filled/line/lower{
	dir = 8
	},
/turf/open/floor/plasteel,
/area/template_noop)
"S" = (
/obj/effect/turf_decal/trimline/green/filled/corner/lower{
	dir = 4
	},
/turf/open/floor/plasteel,
/area/template_noop)
"T" = (
/turf/open/floor/plasteel,
/area/template_noop)
"U" = (
/obj/effect/turf_decal/trimline/green/filled/line/lower{
	dir = 4
	},
/obj/effect/turf_decal/trimline/green/filled/corner/lower{
	dir = 8
	},
/turf/open/floor/plasteel,
/area/template_noop)
"V" = (
/obj/machinery/hydroponics/constructable,
/turf/open/floor/plasteel/dark,
/area/template_noop)
"W" = (
/turf/template_noop,
/area/template_noop)
"Y" = (
/obj/structure/disposalpipe/segment{
	dir = 5
	},
/obj/machinery/atmospherics/pipe/simple/supply/hidden/layer2,
/obj/machinery/atmospherics/pipe/simple/scrubbers/hidden/layer4,
/obj/effect/turf_decal/trimline/green/filled/line/lower{
	dir = 8
	},
/obj/effect/turf_decal/trimline/green/filled/corner/lower,
/turf/open/floor/plasteel,
/area/template_noop)

(1,1,1) = {"
e
u
V
J
F
u
V
q
Q
"}
(2,1,1) = {"
U
m
E
d
M
k
k
l
T
"}
(3,1,1) = {"
V
J
f
s
b
y
N
x
S
"}
(4,1,1) = {"
o
J
f
D
K
T
F
V
W
"}
(5,1,1) = {"
V
J
f
w
H
a
F
V
W
"}
(6,1,1) = {"
V
J
f
T
T
T
M
R
W
"}
(7,1,1) = {"
Y
A
c
j
x
x
x
S
W
"}
(8,1,1) = {"
r
z
V
V
V
z
V
v
W
"}
