//MAP CONVERTED BY dmm2tgm.py THIS HEADER COMMENT PREVENTS RECONVERSION, DO NOT REMOVE
"a" = (
/obj/machinery/atmospherics/pipe/simple/supply/hidden/layer1,
/obj/machinery/atmospherics/pipe/simple/scrubbers/hidden/layer3{
	dir = 9
	},
/turf/template_noop,
/area/hydroponics)
"b" = (
/obj/effect/landmark/start/botanist,
/obj/structure/chair/stool,
/turf/template_noop,
/area/hydroponics)
"e" = (
/obj/machinery/hydroponics/constructable,
/obj/effect/turf_decal/tile/black{
	dir = 1
	},
/obj/effect/turf_decal/tile/black{
	dir = 4
	},
/obj/effect/turf_decal/tile/black{
	dir = 8
	},
/obj/effect/turf_decal/tile/black,
/turf/template_noop,
/area/hydroponics)
"f" = (
/obj/effect/turf_decal/tile/green{
	dir = 1
	},
/obj/effect/turf_decal/tile/green{
	dir = 8
	},
/turf/template_noop,
/area/hydroponics)
"g" = (
/obj/effect/turf_decal/tile/green{
	dir = 8
	},
/obj/effect/turf_decal/tile/green,
/turf/template_noop,
/area/hydroponics)
"h" = (
/obj/machinery/vending/hydroseeds{
	slogan_delay = 700
	},
/turf/template_noop,
/area/hydroponics)
"k" = (
/obj/structure/table/glass,
/obj/effect/turf_decal/tile/green{
	dir = 8
	},
/obj/effect/turf_decal/tile/green,
/turf/template_noop,
/area/hydroponics)
"m" = (
/obj/effect/turf_decal/tile/green{
	dir = 8
	},
/turf/template_noop,
/area/hydroponics)
"n" = (
/obj/structure/reagent_dispensers/watertank/high,
/obj/effect/turf_decal/tile/green{
	dir = 1
	},
/obj/effect/turf_decal/tile/green{
	dir = 4
	},
/obj/item/reagent_containers/glass/bucket,
/turf/template_noop,
/area/hydroponics)
"o" = (
/turf/template_noop,
/area/hydroponics)
"q" = (
/obj/structure/reagent_dispensers/watertank/high,
/obj/item/reagent_containers/glass/bucket,
/obj/machinery/light{
	dir = 4
	},
/turf/template_noop,
/area/hydroponics)
"r" = (
/obj/structure/sink{
	dir = 8;
	pixel_x = -12;
	pixel_y = 2
	},
/turf/template_noop,
/area/hydroponics)
"t" = (
/obj/effect/turf_decal/tile/green{
	dir = 4
	},
/turf/template_noop,
/area/hydroponics)
"u" = (
/obj/effect/turf_decal/tile/green{
	dir = 4
	},
/obj/effect/turf_decal/tile/green,
/obj/machinery/holopad,
/turf/template_noop,
/area/hydroponics)
"w" = (
/obj/structure/table/glass,
/obj/item/storage/box/syringes,
/obj/item/storage/box/beakers{
	pixel_x = 2;
	pixel_y = 2
	},
/turf/template_noop,
/area/hydroponics)
"x" = (
/obj/machinery/atmospherics/pipe/simple/scrubbers/hidden/layer3{
	dir = 4
	},
/obj/effect/turf_decal/tile/green{
	dir = 1
	},
/obj/effect/turf_decal/tile/green{
	dir = 8
	},
/turf/template_noop,
/area/hydroponics)
"z" = (
/obj/machinery/atmospherics/pipe/simple/scrubbers/hidden/layer3{
	dir = 4
	},
/obj/machinery/hydroponics/constructable,
/obj/effect/turf_decal/tile/black{
	dir = 1
	},
/obj/effect/turf_decal/tile/black{
	dir = 4
	},
/obj/effect/turf_decal/tile/black{
	dir = 8
	},
/obj/effect/turf_decal/tile/black,
/turf/template_noop,
/area/hydroponics)
"C" = (
/obj/effect/turf_decal/tile/green{
	dir = 1
	},
/turf/template_noop,
/area/hydroponics)
"D" = (
/obj/effect/turf_decal/tile/green{
	dir = 1
	},
/obj/effect/turf_decal/tile/green{
	dir = 4
	},
/turf/template_noop,
/area/hydroponics)
"E" = (
/obj/machinery/atmospherics/pipe/simple/scrubbers/hidden/layer3{
	dir = 6
	},
/obj/effect/turf_decal/tile/green{
	dir = 1
	},
/obj/effect/turf_decal/tile/green{
	dir = 8
	},
/turf/template_noop,
/area/hydroponics)
"F" = (
/obj/structure/table/glass,
/obj/item/stack/packageWrap,
/obj/item/stack/packageWrap,
/obj/item/hand_labeler,
/turf/template_noop,
/area/hydroponics)
"H" = (
/obj/effect/turf_decal/tile/green{
	dir = 4
	},
/obj/effect/turf_decal/tile/green,
/turf/template_noop,
/area/hydroponics)
"I" = (
/obj/machinery/hydroponics/constructable,
/obj/effect/turf_decal/tile/black{
	dir = 1
	},
/obj/effect/turf_decal/tile/black{
	dir = 4
	},
/obj/effect/turf_decal/tile/black{
	dir = 8
	},
/obj/effect/turf_decal/tile/black,
/obj/machinery/light{
	dir = 8
	},
/turf/template_noop,
/area/hydroponics)
"K" = (
/obj/effect/landmark/start/botanist,
/obj/effect/turf_decal/tile/green{
	dir = 8
	},
/turf/template_noop,
/area/hydroponics)
"L" = (
/obj/machinery/atmospherics/components/unary/vent_scrubber/on/layer3{
	dir = 1
	},
/obj/effect/turf_decal/tile/green{
	dir = 1
	},
/turf/template_noop,
/area/hydroponics)
"N" = (
/obj/machinery/atmospherics/pipe/simple/scrubbers/hidden/layer3{
	dir = 4
	},
/obj/effect/turf_decal/tile/green{
	dir = 4
	},
/obj/effect/turf_decal/tile/green,
/turf/template_noop,
/area/hydroponics)
"P" = (
/obj/machinery/atmospherics/pipe/simple/supply/hidden/layer1,
/obj/machinery/atmospherics/pipe/simple/scrubbers/hidden/layer3,
/turf/template_noop,
/area/hydroponics)
"R" = (
/obj/machinery/seed_extractor,
/turf/template_noop,
/area/hydroponics)
"S" = (
/obj/machinery/atmospherics/components/unary/vent_pump/on/layer1{
	dir = 1
	},
/turf/template_noop,
/area/hydroponics)
"T" = (
/obj/item/twohanded/required/kirbyplants/random,
/turf/template_noop,
/area/hydroponics)
"U" = (
/obj/structure/disposalpipe/segment{
	dir = 5
	},
/obj/machinery/atmospherics/pipe/simple/supply/hidden/layer1,
/obj/machinery/atmospherics/pipe/simple/scrubbers/hidden/layer3,
/turf/template_noop,
/area/hydroponics)
"V" = (
/obj/machinery/disposal/bin,
/obj/structure/disposalpipe/trunk{
	dir = 8
	},
/turf/template_noop,
/area/hydroponics)
"W" = (
/obj/machinery/vending/hydronutrients,
/turf/template_noop,
/area/hydroponics)
"Y" = (
/obj/machinery/biogenerator,
/obj/machinery/light{
	dir = 4
	},
/turf/template_noop,
/area/hydroponics)

(1,1,1) = {"
k
I
e
D
g
I
e
n
r
"}
(2,1,1) = {"
K
f
E
L
m
f
f
C
o
"}
(3,1,1) = {"
H
H
N
H
H
u
t
o
o
"}
(4,1,1) = {"
e
e
z
e
e
e
D
F
o
"}
(5,1,1) = {"
e
e
z
e
e
e
D
w
o
"}
(6,1,1) = {"
f
f
x
f
f
f
C
b
o
"}
(7,1,1) = {"
U
P
a
S
o
o
o
o
o
"}
(8,1,1) = {"
V
Y
R
h
W
q
T
o
o
"}
