//MAP CONVERTED BY dmm2tgm.py THIS HEADER COMMENT PREVENTS RECONVERSION, DO NOT REMOVE
"f" = (
/obj/structure/bodycontainer/morgue{
	dir = 8
	},
/obj/machinery/camera{
	c_tag = "Medbay Morgue";
	dir = 8;
	network = list("ss13","medbay")
	},
/obj/machinery/airalarm{
	dir = 8;
	pixel_x = 24
	},
/turf/open/floor/plasteel/dark,
/area/template_noop)
"h" = (
/obj/structure/bodycontainer/morgue{
	dir = 1
	},
/turf/open/floor/plasteel/dark,
/area/template_noop)
"k" = (
/obj/structure/disposalpipe/segment{
	dir = 5
	},
/turf/open/floor/plasteel/dark,
/area/template_noop)
"n" = (
/obj/structure/disposalpipe/segment{
	dir = 6
	},
/obj/machinery/atmospherics/components/unary/vent_pump/on/layer2,
/obj/machinery/atmospherics/pipe/simple/scrubbers/hidden/layer4{
	dir = 1
	},
/turf/open/floor/plasteel/dark,
/area/template_noop)
"o" = (
/obj/structure/table,
/obj/item/storage/box/bodybags,
/obj/item/pen,
/obj/machinery/atmospherics/pipe/simple/scrubbers/hidden/layer4{
	dir = 1
	},
/turf/open/floor/plasteel/dark,
/area/template_noop)
"r" = (
/obj/structure/disposalpipe/segment{
	dir = 10
	},
/turf/open/floor/plasteel/dark,
/area/template_noop)
"A" = (
/obj/structure/bodycontainer/morgue{
	dir = 8
	},
/obj/machinery/light/small{
	dir = 4
	},
/turf/open/floor/plasteel/dark,
/area/template_noop)
"C" = (
/obj/machinery/atmospherics/components/unary/vent_scrubber/on/layer4,
/turf/open/floor/plasteel/dark,
/area/template_noop)
"F" = (
/obj/structure/disposalpipe/segment{
	dir = 1
	},
/obj/machinery/atmospherics/pipe/simple/supply/hidden/layer2{
	dir = 1
	},
/obj/machinery/atmospherics/pipe/simple/scrubbers/hidden/layer4{
	dir = 1
	},
/turf/open/floor/plasteel/dark,
/area/template_noop)
"H" = (
/obj/structure/bodycontainer/morgue,
/obj/machinery/light/small,
/turf/open/floor/plasteel/dark,
/area/template_noop)
"J" = (
/obj/structure/bodycontainer/morgue{
	dir = 2
	},
/turf/open/floor/plasteel/dark,
/area/template_noop)
"L" = (
/obj/machinery/light/small{
	dir = 8
	},
/turf/open/floor/plasteel/dark,
/area/template_noop)
"M" = (
/obj/structure/table,
/obj/item/paper/guides/jobs/medical/morgue{
	pixel_x = 5;
	pixel_y = 4
	},
/obj/machinery/atmospherics/pipe/simple/scrubbers/hidden/layer4{
	dir = 1
	},
/turf/open/floor/plasteel/dark,
/area/template_noop)
"Q" = (
/obj/structure/bodycontainer/morgue{
	dir = 8
	},
/turf/open/floor/plasteel/dark,
/area/template_noop)
"R" = (
/obj/structure/disposalpipe/segment{
	dir = 4
	},
/turf/open/floor/plasteel/dark,
/area/template_noop)
"V" = (
/turf/open/floor/plasteel/dark,
/area/template_noop)

(1,1,1) = {"
L
V
V
V
V
"}
(2,1,1) = {"
C
o
M
n
F
"}
(3,1,1) = {"
V
h
J
R
Q
"}
(4,1,1) = {"
V
h
J
R
H
"}
(5,1,1) = {"
V
V
V
r
k
"}
(6,1,1) = {"
V
A
f
Q
R
"}
