//MAP CONVERTED BY dmm2tgm.py THIS HEADER COMMENT PREVENTS RECONVERSION, DO NOT REMOVE
"a" = (
/turf/template_noop,
/area/space)
"c" = (
/obj/machinery/airalarm{
	dir = 8;
	pixel_x = 24
	},
/obj/effect/turf_decal/tile/red,
/turf/open/floor/plasteel/dark,
/area/security/execution/transfer)
"d" = (
/obj/effect/spawner/structure/window/reinforced/shutter,
/obj/structure/cable{
	icon_state = "0-4"
	},
/turf/open/floor/plating,
/area/security/execution/transfer)
"g" = (
/obj/machinery/flasher{
	id = "executionflash";
	pixel_y = 25
	},
/obj/effect/turf_decal/stripes/line{
	dir = 1
	},
/obj/structure/chair,
/turf/open/floor/plasteel/showroomfloor,
/area/security/execution/transfer)
"h" = (
/obj/structure/table,
/obj/item/storage/backpack/duffelbag/sec/surgery{
	pixel_x = 8;
	pixel_y = 2
	},
/obj/item/razor{
	pixel_x = -23;
	pixel_y = -2
	},
/obj/machinery/light,
/obj/item/clothing/suit/straight_jacket{
	pixel_x = -8;
	pixel_y = -1
	},
/turf/open/floor/plasteel/dark,
/area/security/execution/transfer)
"i" = (
/obj/machinery/door/poddoor/preopen{
	id = "executionfireblast";
	name = "blast door"
	},
/obj/machinery/door/firedoor/border_only,
/obj/machinery/door/firedoor/border_only{
	dir = 1
	},
/obj/effect/turf_decal/loading_area{
	dir = 1
	},
/obj/machinery/door/airlock/security/glass{
	name = "Transfer Chamber";
	req_access_txt = "2"
	},
/turf/open/floor/plasteel/kitchen_coldroom/freezerfloor,
/area/security/execution/transfer)
"j" = (
/obj/effect/turf_decal/stripes/line,
/turf/open/floor/plasteel/showroomfloor,
/area/security/execution/transfer)
"k" = (
/obj/effect/turf_decal/stripes/line{
	dir = 6
	},
/obj/effect/decal/cleanable/blood/old,
/turf/open/floor/plasteel/showroomfloor,
/area/security/execution/transfer)
"l" = (
/obj/machinery/atmospherics/components/unary/vent_pump/on/layer2{
	dir = 4
	},
/obj/effect/turf_decal/stripes/line{
	dir = 4
	},
/turf/open/floor/plasteel/white,
/area/security/execution/transfer)
"m" = (
/obj/effect/turf_decal/stripes/line{
	dir = 10
	},
/turf/open/floor/plasteel/showroomfloor,
/area/security/execution/transfer)
"o" = (
/obj/structure/chair{
	dir = 1
	},
/obj/machinery/button/door{
	id = "executionfireblast";
	name = "Transfer Area Lockdown";
	pixel_x = 25;
	pixel_y = -5;
	req_access_txt = "2"
	},
/obj/machinery/button/flasher{
	id = "executionflash";
	pixel_x = 24;
	pixel_y = 5
	},
/obj/structure/cable{
	icon_state = "1-8"
	},
/obj/effect/turf_decal/tile/red{
	dir = 1
	},
/obj/effect/turf_decal/tile/red{
	dir = 4
	},
/turf/open/floor/plasteel/dark,
/area/security/execution/transfer)
"q" = (
/turf/open/floor/plasteel/dark,
/area/security/execution/transfer)
"r" = (
/obj/structure/cable{
	icon_state = "2-4"
	},
/obj/machinery/atmospherics/pipe/simple/supply/hidden/layer2{
	dir = 8
	},
/obj/machinery/atmospherics/pipe/simple/scrubbers/hidden/layer4{
	dir = 4
	},
/obj/structure/cable{
	icon_state = "4-8"
	},
/obj/effect/turf_decal/tile/red{
	dir = 4
	},
/obj/effect/turf_decal/tile/red,
/turf/open/floor/plasteel/dark,
/area/security/execution/transfer)
"s" = (
/obj/structure/table/glass,
/obj/item/reagent_containers/spray/cleaner{
	pixel_x = -8;
	pixel_y = 2
	},
/obj/item/storage/box/bodybags{
	pixel_x = 6;
	pixel_y = 4
	},
/obj/item/pen{
	pixel_x = 6;
	pixel_y = 3
	},
/obj/effect/turf_decal/tile/red{
	dir = 1
	},
/obj/effect/turf_decal/tile/red{
	dir = 8
	},
/obj/effect/turf_decal/tile/red{
	dir = 4
	},
/turf/open/floor/plasteel/white,
/area/security/execution/transfer)
"t" = (
/obj/structure/table/glass,
/obj/effect/turf_decal/tile/red{
	dir = 1
	},
/obj/effect/turf_decal/tile/red{
	dir = 8
	},
/obj/machinery/light{
	dir = 8
	},
/obj/item/healthanalyzer{
	pixel_y = 18
	},
/obj/item/soap/nanotrasen,
/turf/open/floor/plasteel/white,
/area/security/execution/transfer)
"v" = (
/obj/structure/chair{
	dir = 1
	},
/obj/structure/cable{
	icon_state = "2-8"
	},
/obj/structure/cable{
	icon_state = "1-2"
	},
/obj/structure/cable{
	icon_state = "2-4"
	},
/obj/effect/turf_decal/tile/red{
	dir = 1
	},
/obj/effect/turf_decal/tile/red{
	dir = 4
	},
/turf/open/floor/plasteel/dark,
/area/security/execution/transfer)
"y" = (
/obj/machinery/door/poddoor/preopen{
	id = "executionfireblast";
	name = "blast door"
	},
/obj/machinery/door/firedoor/border_only,
/obj/machinery/door/firedoor/border_only{
	dir = 1
	},
/obj/structure/cable{
	icon_state = "0-2"
	},
/obj/effect/spawner/structure/window,
/turf/open/floor/plating,
/area/security/execution/transfer)
"z" = (
/turf/closed/wall/r_wall,
/area/security/execution/transfer)
"B" = (
/obj/structure/chair{
	dir = 1
	},
/obj/machinery/light_switch{
	pixel_x = 24
	},
/obj/effect/turf_decal/tile/red,
/obj/machinery/light{
	dir = 4
	},
/turf/open/floor/plasteel/dark,
/area/security/execution/transfer)
"C" = (
/obj/structure/chair{
	dir = 1
	},
/obj/machinery/firealarm{
	dir = 4;
	pixel_x = -26
	},
/obj/structure/cable{
	icon_state = "1-2"
	},
/obj/effect/turf_decal/tile/red{
	dir = 8
	},
/turf/open/floor/plasteel/dark,
/area/security/execution/transfer)
"D" = (
/obj/machinery/atmospherics/components/unary/vent_scrubber/on/layer4,
/turf/open/floor/plasteel/dark,
/area/security/execution/transfer)
"E" = (
/obj/structure/cable{
	icon_state = "4-8"
	},
/obj/effect/turf_decal/tile/red{
	dir = 1
	},
/obj/effect/turf_decal/tile/red{
	dir = 4
	},
/turf/open/floor/plasteel/dark,
/area/security/execution/transfer)
"G" = (
/obj/effect/turf_decal/stripes/line{
	dir = 5
	},
/obj/machinery/light/small{
	dir = 4
	},
/turf/open/floor/plasteel/showroomfloor,
/area/security/execution/transfer)
"I" = (
/obj/structure/table,
/obj/item/folder/red{
	pixel_x = 8;
	pixel_y = 2
	},
/obj/item/taperecorder{
	pixel_x = -5;
	pixel_y = 2
	},
/obj/effect/turf_decal/tile/red,
/turf/open/floor/plasteel/dark,
/area/security/execution/transfer)
"J" = (
/obj/effect/turf_decal/tile/red{
	dir = 1
	},
/obj/effect/turf_decal/tile/red{
	dir = 4
	},
/obj/effect/turf_decal/stripes/line{
	dir = 4
	},
/obj/structure/sink{
	pixel_y = 20
	},
/turf/open/floor/plasteel/white,
/area/security/execution/transfer)
"K" = (
/obj/effect/turf_decal/tile/red{
	dir = 8
	},
/obj/effect/turf_decal/tile/red,
/obj/effect/turf_decal/stripes/line{
	dir = 4
	},
/turf/open/floor/plasteel/white,
/area/security/execution/transfer)
"N" = (
/obj/machinery/power/apc{
	areastring = "/area/security/execution/transfer";
	dir = 4;
	name = "Prisoner Transfer Centre";
	pixel_x = 24
	},
/obj/structure/cable,
/obj/effect/turf_decal/tile/red{
	dir = 4
	},
/turf/open/floor/plasteel/dark,
/area/security/execution/transfer)
"O" = (
/obj/effect/turf_decal/stripes/line{
	dir = 9
	},
/obj/machinery/light/small{
	dir = 8
	},
/turf/open/floor/plasteel/showroomfloor,
/area/security/execution/transfer)
"Q" = (
/obj/structure/cable{
	icon_state = "4-8"
	},
/obj/machinery/atmospherics/pipe/simple/supply/hidden/layer2{
	dir = 8
	},
/obj/machinery/atmospherics/pipe/simple/scrubbers/hidden/layer4{
	dir = 5
	},
/turf/open/floor/plasteel/dark,
/area/security/execution/transfer)
"T" = (
/obj/structure/table,
/obj/item/flashlight/lamp{
	pixel_x = -4;
	pixel_y = 5
	},
/obj/item/restraints/handcuffs{
	pixel_x = 11;
	pixel_y = 6
	},
/obj/item/assembly/flash/handheld{
	pixel_x = -8;
	pixel_y = -3
	},
/obj/effect/turf_decal/tile/red{
	dir = 8
	},
/turf/open/floor/plasteel/dark,
/area/security/execution/transfer)
"U" = (
/obj/structure/cable{
	icon_state = "1-4"
	},
/obj/machinery/atmospherics/pipe/simple/supply/hidden/layer2{
	dir = 8
	},
/turf/open/floor/plasteel/dark,
/area/security/execution/transfer)
"V" = (
/obj/structure/cable{
	icon_state = "1-2"
	},
/turf/open/floor/plasteel/dark,
/area/security/execution/transfer)
"W" = (
/obj/effect/turf_decal/tile/red{
	dir = 8
	},
/obj/effect/turf_decal/tile/red{
	dir = 1
	},
/obj/effect/turf_decal/tile/red,
/obj/structure/rack,
/obj/item/gun/ballistic/shotgun/riot,
/obj/item/ammo_casing/shotgun{
	pixel_x = 2;
	pixel_y = -7
	},
/obj/item/ammo_casing/shotgun{
	pixel_x = 9;
	pixel_y = -8
	},
/turf/open/floor/plasteel/white,
/area/security/execution/transfer)
"Y" = (
/obj/machinery/atmospherics/pipe/simple/scrubbers/hidden/layer4{
	dir = 1
	},
/turf/open/floor/plasteel/dark,
/area/security/execution/transfer)

(1,1,1) = {"
a
a
a
a
z
z
z
z
z
"}
(2,1,1) = {"
a
a
a
a
z
s
t
W
z
"}
(3,1,1) = {"
z
z
z
d
z
J
l
K
z
"}
(4,1,1) = {"
O
m
y
v
C
V
U
q
T
"}
(5,1,1) = {"
g
j
i
E
D
Y
Q
q
h
"}
(6,1,1) = {"
G
k
y
o
B
c
r
N
I
"}
