//MAP CONVERTED BY dmm2tgm.py THIS HEADER COMMENT PREVENTS RECONVERSION, DO NOT REMOVE
"a" = (
/turf/template_noop,
/area/space)
"b" = (
/obj/effect/turf_decal/stripes/line{
	dir = 9
	},
/obj/machinery/light/small{
	dir = 1
	},
/turf/open/floor/plating,
/area/security/execution/transfer)
"c" = (
/obj/machinery/airalarm{
	dir = 8;
	pixel_x = 24
	},
/obj/effect/turf_decal/tile/red,
/turf/open/floor/plasteel/dark,
/area/security/execution/transfer)
"d" = (
/obj/effect/spawner/structure/window/reinforced/shutter,
/obj/structure/cable{
	icon_state = "0-4"
	},
/turf/open/floor/plating,
/area/security/execution/transfer)
"f" = (
/obj/effect/turf_decal/stripes/line{
	dir = 6
	},
/obj/effect/decal/cleanable/blood/old,
/turf/open/floor/plating,
/area/security/execution/transfer)
"h" = (
/obj/structure/table,
/obj/item/storage/backpack/duffelbag/sec/surgery{
	pixel_x = 8;
	pixel_y = 2
	},
/obj/item/razor{
	pixel_x = -23;
	pixel_y = -2
	},
/obj/machinery/light,
/obj/item/clothing/suit/straight_jacket{
	pixel_x = -8;
	pixel_y = -1
	},
/turf/open/floor/plasteel/dark,
/area/security/execution/transfer)
"i" = (
/obj/structure/cable{
	icon_state = "4-8"
	},
/obj/effect/turf_decal/tile/red{
	dir = 1
	},
/obj/effect/turf_decal/tile/red{
	dir = 4
	},
/obj/machinery/atmospherics/pipe/simple/supply/hidden/layer2{
	dir = 1
	},
/turf/open/floor/plasteel/dark,
/area/security/execution/transfer)
"n" = (
/obj/machinery/door/poddoor{
	id = "executionspaceblast";
	name = "blast door"
	},
/turf/open/floor/plating,
/area/security/execution/transfer)
"p" = (
/obj/effect/turf_decal/tile/red{
	dir = 1
	},
/obj/effect/turf_decal/tile/red{
	dir = 4
	},
/obj/structure/sink{
	pixel_y = 20
	},
/obj/effect/turf_decal/stripes/line{
	dir = 4
	},
/turf/open/floor/plasteel/white,
/area/security/execution/transfer)
"q" = (
/turf/open/floor/plasteel/dark,
/area/security/execution/transfer)
"r" = (
/obj/structure/cable{
	icon_state = "2-4"
	},
/obj/machinery/atmospherics/pipe/simple/supply/hidden/layer2{
	dir = 8
	},
/obj/machinery/atmospherics/pipe/simple/scrubbers/hidden/layer4{
	dir = 4
	},
/obj/structure/cable{
	icon_state = "4-8"
	},
/obj/effect/turf_decal/tile/red{
	dir = 4
	},
/obj/effect/turf_decal/tile/red,
/turf/open/floor/plasteel/dark,
/area/security/execution/transfer)
"s" = (
/obj/structure/table/glass,
/obj/item/reagent_containers/spray/cleaner{
	pixel_x = -8;
	pixel_y = 2
	},
/obj/item/storage/box/bodybags{
	pixel_x = 6;
	pixel_y = 4
	},
/obj/item/pen{
	pixel_x = 6;
	pixel_y = 3
	},
/obj/effect/turf_decal/tile/red{
	dir = 1
	},
/obj/effect/turf_decal/tile/red{
	dir = 8
	},
/obj/effect/turf_decal/tile/red{
	dir = 4
	},
/turf/open/floor/plasteel/white,
/area/security/execution/transfer)
"t" = (
/obj/machinery/door/poddoor/preopen{
	id = "executionfireblast";
	name = "blast door"
	},
/obj/machinery/door/firedoor/border_only,
/obj/machinery/door/firedoor/border_only{
	dir = 1
	},
/obj/effect/turf_decal/loading_area{
	dir = 1
	},
/obj/machinery/door/airlock/security/glass{
	name = "Transfer Chamber";
	req_access_txt = "2"
	},
/obj/machinery/atmospherics/pipe/simple/supply/hidden/layer2{
	dir = 1
	},
/turf/open/floor/plating,
/area/security/execution/transfer)
"v" = (
/obj/structure/chair{
	dir = 1
	},
/obj/structure/cable{
	icon_state = "2-8"
	},
/obj/structure/cable{
	icon_state = "1-2"
	},
/obj/structure/cable{
	icon_state = "2-4"
	},
/obj/effect/turf_decal/tile/red{
	dir = 1
	},
/obj/effect/turf_decal/tile/red{
	dir = 4
	},
/turf/open/floor/plasteel/dark,
/area/security/execution/transfer)
"w" = (
/obj/structure/cable{
	icon_state = "1-4"
	},
/obj/machinery/atmospherics/pipe/simple/supply/hidden/layer2{
	dir = 8
	},
/turf/open/floor/plasteel/dark,
/area/security/execution/transfer)
"y" = (
/obj/machinery/door/poddoor/preopen{
	id = "executionfireblast";
	name = "blast door"
	},
/obj/machinery/door/firedoor/border_only,
/obj/machinery/door/firedoor/border_only{
	dir = 1
	},
/obj/structure/cable{
	icon_state = "0-2"
	},
/obj/effect/spawner/structure/window,
/turf/open/floor/plating,
/area/security/execution/transfer)
"A" = (
/obj/machinery/atmospherics/components/unary/vent_pump/on/layer2{
	dir = 4
	},
/obj/effect/turf_decal/stripes/line{
	dir = 4
	},
/turf/open/floor/plasteel/white,
/area/security/execution/transfer)
"B" = (
/obj/structure/chair{
	dir = 1
	},
/obj/machinery/light_switch{
	pixel_x = 24
	},
/obj/effect/turf_decal/tile/red,
/obj/machinery/light{
	dir = 4
	},
/turf/open/floor/plasteel/dark,
/area/security/execution/transfer)
"C" = (
/obj/structure/chair{
	dir = 1
	},
/obj/machinery/firealarm{
	dir = 4;
	pixel_x = -26
	},
/obj/structure/cable{
	icon_state = "1-2"
	},
/obj/effect/turf_decal/tile/red{
	dir = 8
	},
/turf/open/floor/plasteel/dark,
/area/security/execution/transfer)
"D" = (
/obj/structure/chair{
	dir = 1
	},
/obj/machinery/button/door{
	id = "executionfireblast";
	name = "Transfer Area Lockdown";
	pixel_x = 25;
	pixel_y = -5;
	req_access_txt = "2"
	},
/obj/machinery/button/flasher{
	id = "executionflash";
	pixel_x = 24;
	pixel_y = 5
	},
/obj/structure/cable{
	icon_state = "1-8"
	},
/obj/effect/turf_decal/tile/red{
	dir = 1
	},
/obj/effect/turf_decal/tile/red{
	dir = 4
	},
/obj/machinery/button/door{
	id = "executionspaceblast";
	name = "Vent to Space";
	pixel_x = 25;
	pixel_y = -15;
	req_access_txt = "2"
	},
/turf/open/floor/plasteel/dark,
/area/security/execution/transfer)
"E" = (
/obj/structure/bed,
/obj/machinery/flasher{
	id = "executionflash";
	pixel_y = 25
	},
/obj/effect/turf_decal/stripes/line{
	dir = 1
	},
/obj/machinery/atmospherics/components/unary/vent_pump/on/layer2,
/turf/open/floor/plating,
/area/security/execution/transfer)
"F" = (
/obj/machinery/atmospherics/pipe/simple/scrubbers/hidden/layer4{
	dir = 1
	},
/obj/machinery/atmospherics/pipe/simple/supply/hidden/layer2{
	dir = 1
	},
/turf/open/floor/plasteel/dark,
/area/security/execution/transfer)
"G" = (
/obj/effect/turf_decal/stripes/line,
/obj/machinery/atmospherics/pipe/simple/supply/hidden/layer2,
/turf/open/floor/plating,
/area/security/execution/transfer)
"I" = (
/obj/structure/table,
/obj/item/folder/red{
	pixel_x = 8;
	pixel_y = 2
	},
/obj/item/taperecorder{
	pixel_x = -5;
	pixel_y = 2
	},
/obj/effect/turf_decal/tile/red,
/turf/open/floor/plasteel/dark,
/area/security/execution/transfer)
"J" = (
/obj/effect/turf_decal/tile/red{
	dir = 8
	},
/obj/effect/turf_decal/tile/red,
/obj/effect/turf_decal/stripes/line{
	dir = 4
	},
/turf/open/floor/plasteel/white,
/area/security/execution/transfer)
"K" = (
/obj/effect/turf_decal/stripes/line{
	dir = 10
	},
/turf/open/floor/plating,
/area/security/execution/transfer)
"N" = (
/obj/machinery/power/apc{
	areastring = "/area/security/execution/transfer";
	dir = 4;
	name = "Prisoner Transfer Centre";
	pixel_x = 24
	},
/obj/structure/cable,
/obj/effect/turf_decal/tile/red{
	dir = 4
	},
/turf/open/floor/plasteel/dark,
/area/security/execution/transfer)
"P" = (
/obj/structure/cable{
	icon_state = "4-8"
	},
/obj/machinery/atmospherics/pipe/simple/scrubbers/hidden/layer4{
	dir = 5
	},
/obj/machinery/atmospherics/pipe/manifold/supply/hidden/layer2,
/turf/open/floor/plasteel/dark,
/area/security/execution/transfer)
"R" = (
/obj/machinery/atmospherics/components/unary/vent_scrubber/on/layer4,
/obj/machinery/atmospherics/pipe/simple/supply/hidden/layer2{
	dir = 1
	},
/turf/open/floor/plasteel/dark,
/area/security/execution/transfer)
"S" = (
/obj/effect/turf_decal/stripes/line{
	dir = 5
	},
/obj/machinery/light/small{
	dir = 4
	},
/turf/open/floor/plating,
/area/security/execution/transfer)
"T" = (
/obj/structure/table,
/obj/item/flashlight/lamp{
	pixel_x = -4;
	pixel_y = 5
	},
/obj/item/restraints/handcuffs{
	pixel_x = 11;
	pixel_y = 6
	},
/obj/item/assembly/flash/handheld{
	pixel_x = -8;
	pixel_y = -3
	},
/obj/effect/turf_decal/tile/red{
	dir = 8
	},
/turf/open/floor/plasteel/dark,
/area/security/execution/transfer)
"V" = (
/obj/effect/turf_decal/tile/red{
	dir = 8
	},
/obj/effect/turf_decal/tile/red{
	dir = 1
	},
/obj/effect/turf_decal/tile/red,
/obj/machinery/portable_atmospherics/canister/air,
/turf/open/floor/plasteel/white,
/area/security/execution/transfer)
"W" = (
/obj/structure/table/glass,
/obj/effect/turf_decal/tile/red{
	dir = 1
	},
/obj/effect/turf_decal/tile/red{
	dir = 8
	},
/obj/machinery/light{
	dir = 8
	},
/obj/item/healthanalyzer{
	pixel_y = 18
	},
/obj/item/clothing/mask/breath{
	pixel_x = -6;
	pixel_y = 4
	},
/obj/item/tank/internals/emergency_oxygen{
	pixel_x = 6;
	pixel_y = -1
	},
/obj/item/clothing/suit/space/fragile,
/obj/item/clothing/head/helmet/space/fragile,
/turf/open/floor/plasteel/white,
/area/security/execution/transfer)
"X" = (
/obj/structure/cable{
	icon_state = "1-2"
	},
/turf/open/floor/plasteel/dark,
/area/security/execution/transfer)
"Y" = (
/turf/closed/wall/r_wall,
/area/security/execution/transfer)

(1,1,1) = {"
a
a
a
a
Y
Y
Y
Y
Y
"}
(2,1,1) = {"
a
a
a
a
Y
s
W
V
Y
"}
(3,1,1) = {"
n
n
Y
d
Y
p
A
J
Y
"}
(4,1,1) = {"
b
K
y
v
C
X
w
q
T
"}
(5,1,1) = {"
E
G
t
i
R
F
P
q
h
"}
(6,1,1) = {"
S
f
y
D
B
c
r
N
I
"}
