//MAP CONVERTED BY dmm2tgm.py THIS HEADER COMMENT PREVENTS RECONVERSION, DO NOT REMOVE
"b" = (
/obj/structure/cable{
	icon_state = "1-2"
	},
/obj/machinery/atmospherics/pipe/simple/scrubbers/hidden/layer4,
/obj/structure/disposalpipe/segment{
	dir = 10
	},
/obj/machinery/atmospherics/pipe/simple/supply/hidden/layer2,
/turf/open/floor/plating,
/area/maintenance/starboard/aft)
"c" = (
/turf/closed/wall,
/area/maintenance/starboard/aft)
"d" = (
/obj/structure/lattice,
/turf/open/space,
/area/space/nearstation)
"e" = (
/obj/structure/disposalpipe/segment,
/turf/open/floor/plating/airless,
/area/space/nearstation)
"f" = (
/turf/open/floor/plating,
/area/maintenance/aft)
"g" = (
/obj/structure/cable{
	icon_state = "1-2"
	},
/obj/machinery/atmospherics/pipe/simple/scrubbers/hidden/layer4,
/obj/structure/disposalpipe/segment,
/obj/machinery/atmospherics/pipe/simple/supply/hidden/layer2,
/turf/open/floor/plating,
/area/maintenance/starboard/aft)
"h" = (
/obj/effect/spawner/structure/window/reinforced/shutter,
/turf/open/floor/plating,
/area/maintenance/starboard/aft)
"i" = (
/obj/structure/disposalpipe/segment,
/obj/effect/spawner/structure/window/reinforced/shutter,
/turf/open/floor/plating,
/area/maintenance/starboard/aft)
"j" = (
/obj/structure/cable{
	icon_state = "1-4"
	},
/obj/machinery/atmospherics/pipe/simple/scrubbers/hidden/layer4{
	dir = 5
	},
/obj/structure/disposalpipe/segment,
/obj/machinery/atmospherics/pipe/simple/supply/hidden/layer2{
	dir = 5
	},
/turf/open/floor/plating,
/area/maintenance/starboard/aft)
"k" = (
/obj/structure/cable{
	icon_state = "4-8"
	},
/obj/machinery/atmospherics/pipe/simple/supply/hidden/layer2{
	dir = 8
	},
/obj/machinery/atmospherics/pipe/simple/scrubbers/hidden/layer4{
	dir = 4
	},
/turf/open/floor/plating,
/area/maintenance/starboard/aft)
"l" = (
/obj/structure/cable{
	icon_state = "4-8"
	},
/obj/effect/landmark/event_spawn,
/obj/machinery/atmospherics/pipe/simple/supply/hidden/layer2{
	dir = 8
	},
/obj/machinery/atmospherics/pipe/simple/scrubbers/hidden/layer4{
	dir = 4
	},
/turf/open/floor/plating,
/area/maintenance/starboard/aft)
"m" = (
/obj/structure/cable{
	icon_state = "4-8"
	},
/obj/machinery/atmospherics/pipe/simple/scrubbers/hidden/layer4{
	dir = 4
	},
/obj/structure/disposalpipe/segment,
/obj/machinery/atmospherics/pipe/simple/supply/hidden/layer2{
	dir = 8
	},
/turf/open/floor/plating,
/area/maintenance/starboard/aft)
"n" = (
/obj/structure/cable{
	icon_state = "4-8"
	},
/obj/machinery/atmospherics/pipe/simple/scrubbers/hidden/layer4{
	dir = 4
	},
/obj/structure/disposalpipe/segment{
	dir = 6
	},
/obj/machinery/atmospherics/pipe/simple/supply/hidden/layer2{
	dir = 8
	},
/turf/open/floor/plating,
/area/maintenance/starboard/aft)
"o" = (
/obj/machinery/door/airlock/maintenance{
	req_access_txt = "12"
	},
/obj/structure/cable{
	icon_state = "4-8"
	},
/obj/machinery/atmospherics/pipe/simple/supply/hidden/layer2{
	dir = 8
	},
/obj/machinery/atmospherics/pipe/simple/scrubbers/hidden/layer4{
	dir = 4
	},
/obj/structure/disposalpipe/segment{
	dir = 4
	},
/obj/machinery/door/firedoor/border_only{
	dir = 4
	},
/obj/machinery/door/firedoor/border_only{
	dir = 8
	},
/turf/open/floor/plating,
/area/maintenance/starboard/aft)
"p" = (
/obj/structure/disposalpipe/segment{
	dir = 5
	},
/turf/open/floor/plating,
/area/maintenance/starboard/aft)
"q" = (
/obj/structure/disposalpipe/segment{
	dir = 4
	},
/turf/open/floor/plating,
/area/maintenance/starboard/aft)
"r" = (
/obj/structure/chair,
/obj/item/storage/box/fancy/cigarettes,
/obj/structure/disposalpipe/segment{
	dir = 4
	},
/turf/open/floor/plating,
/area/maintenance/starboard/aft)
"s" = (
/obj/structure/chair,
/obj/structure/disposalpipe/junction/flip{
	dir = 4
	},
/turf/open/floor/plating,
/area/maintenance/starboard/aft)
"t" = (
/obj/structure/disposalpipe/segment{
	dir = 9
	},
/turf/open/floor/plating,
/area/maintenance/starboard/aft)
"u" = (
/turf/template_noop,
/area/template_noop)
"v" = (
/obj/effect/spawner/structure/window/reinforced/shutter,
/turf/open/floor/plating,
/area/maintenance/aft)
"w" = (
/obj/machinery/door/airlock/external{
	name = "Solar Maintenance";
	req_access_txt = "10; 13"
	},
/obj/effect/mapping_helpers/airlock/cyclelink_helper_target{
	dirx = -1;
	diry = 2
	},
/turf/open/floor/plating,
/area/maintenance/aft)
"x" = (
/obj/structure/lattice/catwalk,
/turf/open/space,
/area/space/nearstation)
"y" = (
/obj/structure/lattice/catwalk,
/turf/open/space/basic,
/area/space/nearstation)

(1,1,1) = {"
b
g
j
p
c
f
f
w
x
y
"}
(2,1,1) = {"
c
c
k
q
c
v
v
v
x
y
"}
(3,1,1) = {"
u
c
k
q
h
u
u
u
u
u
"}
(4,1,1) = {"
u
h
k
q
h
u
u
u
u
u
"}
(5,1,1) = {"
u
h
k
q
h
u
u
u
u
u
"}
(6,1,1) = {"
u
c
k
q
c
u
u
u
u
u
"}
(7,1,1) = {"
u
c
l
q
c
u
u
u
u
u
"}
(8,1,1) = {"
d
h
k
r
h
u
u
u
u
u
"}
(9,1,1) = {"
e
i
m
s
h
u
u
u
u
u
"}
(10,1,1) = {"
d
h
k
q
h
u
u
u
u
u
"}
(11,1,1) = {"
u
c
k
q
c
u
u
u
u
u
"}
(12,1,1) = {"
u
c
k
q
c
u
u
u
u
u
"}
(13,1,1) = {"
u
h
k
q
h
u
u
u
u
u
"}
(14,1,1) = {"
u
h
k
q
h
d
d
d
d
d
"}
(15,1,1) = {"
u
h
n
t
h
u
u
u
d
d
"}
(16,1,1) = {"
c
c
o
c
c
c
c
c
c
c
"}
