//MAP CONVERTED BY dmm2tgm.py THIS HEADER COMMENT PREVENTS RECONVERSION, DO NOT REMOVE
"a" = (
/obj/effect/decal/cleanable/dirt/dust,
/obj/effect/turf_decal/stripes{
	dir = 1
	},
/turf/open/floor/plating,
/area/template_noop)
"b" = (
/obj/effect/decal/cleanable/dirt/dust,
/obj/effect/turf_decal/stripes,
/turf/open/floor/plating,
/area/template_noop)
"d" = (
/obj/effect/turf_decal/stripes/corner{
	dir = 1
	},
/obj/effect/decal/cleanable/dirt,
/turf/open/floor/plating,
/area/template_noop)
"e" = (
/obj/effect/decal/cleanable/dirt/dust,
/obj/effect/turf_decal/stripes/corner{
	dir = 1
	},
/turf/open/floor/plasteel,
/area/template_noop)
"h" = (
/obj/effect/decal/cleanable/dirt/dust,
/obj/effect/turf_decal/stripes{
	dir = 1
	},
/turf/open/floor/plasteel,
/area/template_noop)
"j" = (
/obj/effect/decal/cleanable/dirt/dust,
/obj/effect/turf_decal/stripes/corner{
	dir = 8
	},
/turf/open/floor/plasteel,
/area/template_noop)
"k" = (
/obj/effect/turf_decal/stripes{
	dir = 8
	},
/obj/effect/decal/cleanable/dirt,
/turf/open/floor/plasteel,
/area/template_noop)
"l" = (
/obj/effect/decal/cleanable/dirt/dust,
/obj/effect/turf_decal/stripes{
	dir = 8
	},
/turf/open/floor/plasteel,
/area/template_noop)
"m" = (
/obj/effect/turf_decal/stripes{
	dir = 4
	},
/obj/structure/mecha_wreckage/ripley/mkii,
/obj/effect/decal/cleanable/oil,
/turf/open/floor/plating,
/area/template_noop)
"n" = (
/obj/effect/turf_decal/bot,
/obj/effect/spawner/lootdrop/tanks/highchance,
/turf/open/floor/plasteel/dark,
/area/template_noop)
"o" = (
/obj/effect/turf_decal/stripes{
	dir = 1
	},
/obj/machinery/light/broken,
/obj/effect/decal/cleanable/dirt,
/turf/open/floor/plating,
/area/template_noop)
"q" = (
/obj/effect/turf_decal/stripes/corner{
	dir = 4
	},
/obj/effect/turf_decal/stripes/corner,
/obj/effect/decal/cleanable/dirt,
/turf/open/floor/plating,
/area/template_noop)
"t" = (
/obj/effect/turf_decal/stripes,
/obj/machinery/light{
	dir = 1
	},
/obj/effect/decal/cleanable/dirt,
/obj/effect/spawner/lootdrop/trashbin,
/turf/open/floor/plating,
/area/template_noop)
"w" = (
/obj/effect/decal/cleanable/dirt/dust,
/obj/effect/turf_decal/stripes/corner{
	dir = 4
	},
/obj/effect/decal/cleanable/vomit/old,
/turf/open/floor/plating,
/area/template_noop)
"x" = (
/obj/effect/decal/cleanable/dirt/dust,
/obj/effect/turf_decal/stripes,
/obj/machinery/light/broken{
	dir = 1
	},
/turf/open/floor/plasteel,
/area/template_noop)
"y" = (
/obj/effect/decal/cleanable/dirt/dust,
/obj/effect/turf_decal/stripes{
	dir = 1
	},
/obj/effect/turf_decal/stripes,
/turf/open/floor/plasteel,
/area/template_noop)
"z" = (
/obj/effect/decal/cleanable/dirt/dust,
/obj/effect/turf_decal/stripes{
	dir = 4
	},
/turf/open/floor/plasteel,
/area/template_noop)
"A" = (
/obj/effect/turf_decal/bot,
/obj/effect/spawner/lootdrop/tanks/lowchance,
/turf/open/floor/plasteel/dark,
/area/template_noop)
"C" = (
/obj/effect/turf_decal/stripes{
	dir = 1
	},
/obj/machinery/light,
/obj/effect/decal/cleanable/dirt,
/obj/effect/spawner/lootdrop/trashbin,
/turf/open/floor/plasteel,
/area/template_noop)
"D" = (
/obj/effect/turf_decal/stripes{
	dir = 4
	},
/obj/effect/decal/cleanable/dirt,
/turf/open/floor/plasteel,
/area/template_noop)
"F" = (
/obj/effect/decal/cleanable/dirt/dust,
/obj/effect/turf_decal/stripes/corner{
	dir = 1
	},
/obj/effect/turf_decal/stripes/corner{
	dir = 8
	},
/obj/effect/spawner/lootdrop/glowstick,
/obj/effect/decal/cleanable/blood/old,
/turf/open/floor/plasteel,
/area/template_noop)
"H" = (
/obj/effect/decal/cleanable/dirt/dust,
/obj/effect/turf_decal/stripes/corner,
/turf/open/floor/plating,
/area/template_noop)
"J" = (
/obj/effect/turf_decal/stripes/corner{
	dir = 8
	},
/obj/effect/decal/cleanable/dirt,
/obj/effect/decal/cleanable/cobweb/cobweb2,
/turf/open/floor/plasteel,
/area/template_noop)
"L" = (
/obj/effect/decal/cleanable/dirt/dust,
/obj/effect/turf_decal/stripes/corner{
	dir = 4
	},
/turf/open/floor/plasteel,
/area/template_noop)
"M" = (
/obj/effect/decal/cleanable/dirt/dust,
/obj/effect/turf_decal/stripes,
/obj/effect/spawner/lootdrop/maintenance,
/turf/open/floor/plasteel,
/area/template_noop)
"N" = (
/obj/effect/decal/cleanable/dirt,
/obj/effect/turf_decal/stripes/corner{
	dir = 4
	},
/obj/effect/turf_decal/stripes/corner,
/obj/effect/spawner/lootdrop/gloves,
/obj/effect/decal/cleanable/oil/streak,
/obj/effect/decal/cleanable/robot_debris,
/turf/open/floor/plating,
/area/template_noop)
"Q" = (
/obj/effect/turf_decal/stripes/corner,
/obj/effect/decal/cleanable/dirt,
/turf/open/floor/plating,
/area/template_noop)
"R" = (
/obj/effect/decal/cleanable/dirt/dust,
/obj/effect/turf_decal/stripes,
/turf/open/floor/plasteel,
/area/template_noop)
"T" = (
/obj/effect/decal/cleanable/dirt/dust,
/obj/effect/turf_decal/bot,
/obj/effect/spawner/lootdrop/tanks/lowchance,
/turf/open/floor/plasteel/dark,
/area/template_noop)
"U" = (
/obj/effect/decal/cleanable/dirt/dust,
/obj/effect/turf_decal/stripes,
/obj/effect/turf_decal/stripes{
	dir = 1
	},
/turf/open/floor/plasteel,
/area/template_noop)
"V" = (
/obj/effect/turf_decal/stripes,
/obj/effect/turf_decal/stripes{
	dir = 1
	},
/obj/effect/decal/cleanable/dirt,
/turf/open/floor/plasteel,
/area/template_noop)
"W" = (
/obj/effect/decal/cleanable/dirt/dust,
/obj/effect/turf_decal/stripes{
	dir = 1
	},
/obj/effect/spawner/lootdrop/maintenance,
/turf/open/floor/plating,
/area/template_noop)
"X" = (
/obj/effect/decal/cleanable/dirt/dust,
/obj/effect/turf_decal/bot,
/obj/effect/spawner/lootdrop/tanks/highchance,
/turf/open/floor/plasteel/dark,
/area/template_noop)
"Y" = (
/obj/effect/decal/cleanable/dirt/dust,
/obj/effect/turf_decal/stripes/corner{
	dir = 8
	},
/obj/effect/turf_decal/stripes/corner{
	dir = 1
	},
/turf/open/floor/plating,
/area/template_noop)

(1,1,1) = {"
Q
D
q
z
w
"}
(2,1,1) = {"
t
n
y
T
o
"}
(3,1,1) = {"
b
T
U
T
W
"}
(4,1,1) = {"
R
T
U
T
a
"}
(5,1,1) = {"
j
l
F
l
e
"}
(6,1,1) = {"
H
m
N
z
L
"}
(7,1,1) = {"
R
A
U
T
h
"}
(8,1,1) = {"
M
A
U
A
h
"}
(9,1,1) = {"
x
T
V
X
C
"}
(10,1,1) = {"
J
k
Y
l
d
"}
