//MAP CONVERTED BY dmm2tgm.py THIS HEADER COMMENT PREVENTS RECONVERSION, DO NOT REMOVE
"a" = (
/turf/open/floor/plasteel,
/area/template_noop)
"c" = (
/obj/effect/decal/cleanable/blood,
/turf/open/floor/plasteel,
/area/template_noop)
"f" = (
/obj/effect/decal/cleanable/blood/tracks{
	dir = 4
	},
/obj/effect/decal/cleanable/dirt/dust,
/turf/open/floor/plasteel,
/area/template_noop)
"h" = (
/obj/item/caution{
	desc = "CAUTION! BIOHAZARD QUARANTINE!";
	name = "biohazard warning sign"
	},
/obj/effect/decal/cleanable/dirt/dust,
/turf/open/floor/plating,
/area/template_noop)
"i" = (
/obj/effect/decal/cleanable/dirt/dust,
/turf/open/floor/plasteel,
/area/template_noop)
"j" = (
/obj/effect/decal/cleanable/blood/gibs/limb,
/turf/open/floor/plasteel,
/area/template_noop)
"n" = (
/obj/effect/decal/cleanable/blood/old,
/turf/open/floor/plasteel,
/area/template_noop)
"r" = (
/obj/structure/sign/warning/biohazard,
/turf/closed/wall,
/area/template_noop)
"t" = (
/turf/closed/wall,
/area/template_noop)
"u" = (
/obj/machinery/door/airlock/maintenance_hatch,
/obj/effect/decal/cleanable/blood/tracks{
	dir = 4
	},
/obj/machinery/door/firedoor/border_only{
	dir = 8
	},
/obj/machinery/door/firedoor/border_only{
	dir = 4
	},
/turf/open/floor/plating,
/area/template_noop)
"v" = (
/obj/machinery/door/airlock/maintenance_hatch,
/obj/effect/decal/cleanable/dirt/dust,
/obj/machinery/door/firedoor/border_only{
	dir = 1
	},
/obj/machinery/door/firedoor/border_only,
/turf/open/floor/plasteel,
/area/template_noop)
"y" = (
/obj/item/caution{
	desc = "CAUTION! BIOHAZARD QUARANTINE!";
	name = "biohazard warning sign"
	},
/turf/open/floor/plating,
/area/template_noop)
"A" = (
/obj/item/caution{
	desc = "CAUTION! BIOHAZARD QUARANTINE!";
	name = "biohazard warning sign"
	},
/obj/effect/decal/cleanable/blood/tracks{
	dir = 4
	},
/obj/effect/decal/cleanable/dirt/dust,
/turf/open/floor/plating,
/area/template_noop)
"B" = (
/obj/effect/decal/cleanable/blood/tracks{
	dir = 4
	},
/obj/effect/decal/cleanable/blood/gibs/down,
/turf/open/floor/plating,
/area/template_noop)
"C" = (
/obj/effect/decal/cleanable/blood/tracks{
	dir = 4
	},
/obj/item/ammo_casing/spent,
/turf/open/floor/plating,
/area/template_noop)
"H" = (
/obj/item/ammo_casing/spent,
/obj/effect/decal/cleanable/dirt/dust,
/turf/open/floor/plasteel,
/area/template_noop)
"I" = (
/obj/machinery/power/floodlight,
/turf/open/floor/plating,
/area/template_noop)
"K" = (
/obj/structure/barricade/sandbags,
/obj/effect/decal/cleanable/blood/gibs/old,
/obj/effect/decal/cleanable/blood/old,
/turf/open/floor/plating,
/area/template_noop)
"L" = (
/obj/effect/decal/cleanable/dirt/dust,
/obj/effect/decal/cleanable/blood/old,
/turf/open/floor/plating,
/area/template_noop)
"M" = (
/obj/structure/barricade/sandbags,
/obj/effect/decal/cleanable/dirt/dust,
/turf/open/floor/plasteel,
/area/template_noop)
"N" = (
/turf/open/floor/plating,
/area/template_noop)
"O" = (
/obj/structure/barricade/sandbags,
/turf/open/floor/plasteel,
/area/template_noop)
"P" = (
/obj/effect/decal/cleanable/dirt/dust,
/obj/effect/decal/cleanable/dirt/dust,
/obj/item/clothing/gloves/color/yellow,
/mob/living/simple_animal/pet/dog/corgi/puppy{
	desc = "It's a corgi puppy! It's covered in blood...";
	name = "suspicious puppy"
	},
/obj/effect/decal/cleanable/blood/gibs/up,
/turf/open/floor/plating,
/area/template_noop)
"Q" = (
/obj/item/ammo_casing/spent,
/obj/item/ammo_casing/spent{
	pixel_y = 4
	},
/obj/effect/decal/cleanable/dirt/dust,
/turf/open/floor/plasteel,
/area/template_noop)
"T" = (
/obj/machinery/door/airlock/maintenance_hatch,
/obj/machinery/door/firedoor/border_only{
	dir = 8
	},
/obj/machinery/door/firedoor/border_only{
	dir = 4
	},
/turf/open/floor/plating,
/area/template_noop)
"U" = (
/obj/effect/decal/cleanable/dirt/dust,
/turf/open/floor/plating,
/area/template_noop)
"Y" = (
/obj/effect/decal/cleanable/dirt/dust,
/obj/structure/closet,
/obj/effect/spawner/lootdrop/maintenance/two,
/turf/open/floor/plating,
/area/template_noop)

(1,1,1) = {"
Y
r
U
h
a
"}
(2,1,1) = {"
L
t
r
t
i
"}
(3,1,1) = {"
a
t
P
t
n
"}
(4,1,1) = {"
y
t
f
r
y
"}
(5,1,1) = {"
i
t
A
v
N
"}
(6,1,1) = {"
U
t
B
t
U
"}
(7,1,1) = {"
T
r
u
t
t
"}
(8,1,1) = {"
c
j
C
H
U
"}
(9,1,1) = {"
i
M
K
I
U
"}
(10,1,1) = {"
N
O
Q
y
N
"}
