//MAP CONVERTED BY dmm2tgm.py THIS HEADER COMMENT PREVENTS RECONVERSION, DO NOT REMOVE
"a" = (
/obj/effect/turf_decal/stripes/line{
	dir = 6
	},
/turf/open/floor/plasteel,
/area/template_noop)
"b" = (
/obj/item/cautery,
/turf/open/floor/plating{
	icon_state = "platingdmg1"
	},
/area/template_noop)
"c" = (
/obj/structure/window/reinforced{
	dir = 8
	},
/turf/open/floor/plating,
/area/template_noop)
"d" = (
/obj/structure/window/reinforced{
	dir = 8
	},
/obj/effect/decal/cleanable/dirt,
/turf/open/floor/plating,
/area/template_noop)
"e" = (
/obj/effect/decal/cleanable/dirt,
/turf/open/floor/plating,
/area/template_noop)
"f" = (
/obj/structure/window/reinforced{
	dir = 8
	},
/obj/effect/decal/cleanable/dirt,
/turf/open/floor/plasteel,
/area/template_noop)
"g" = (
/obj/machinery/shower{
	dir = 4
	},
/obj/effect/decal/cleanable/dirt,
/turf/open/floor/plasteel/showroomfloor,
/area/template_noop)
"h" = (
/obj/structure/window/reinforced,
/obj/effect/turf_decal/stripes/line{
	dir = 1
	},
/obj/machinery/light/broken{
	dir = 1;
	icon_state = "tube-broken"
	},
/obj/effect/turf_decal/caution/stand_clear{
	dir = 1;
	icon_state = "stand_clear"
	},
/obj/effect/decal/cleanable/dirt,
/turf/open/floor/plasteel,
/area/template_noop)
"i" = (
/obj/structure/window/reinforced,
/obj/effect/decal/cleanable/dirt,
/turf/open/floor/plating,
/area/template_noop)
"j" = (
/obj/machinery/door/window/westleft,
/obj/machinery/door/window/eastleft,
/obj/effect/turf_decal/delivery,
/obj/effect/decal/cleanable/dirt,
/obj/machinery/door/firedoor/border_only{
	dir = 8
	},
/obj/machinery/door/firedoor/border_only{
	dir = 4
	},
/turf/open/floor/plasteel,
/area/template_noop)
"k" = (
/obj/structure/window/reinforced{
	dir = 8
	},
/turf/open/floor/plating{
	icon_state = "panelscorched"
	},
/area/template_noop)
"l" = (
/obj/effect/decal/cleanable/dirt,
/turf/open/floor/plasteel,
/area/template_noop)
"m" = (
/obj/effect/decal/cleanable/dirt,
/obj/item/storage/belt/medical,
/turf/open/floor/plasteel,
/area/template_noop)
"o" = (
/obj/structure/window/reinforced{
	dir = 8
	},
/turf/open/floor/plating{
	icon_state = "platingdmg1"
	},
/area/template_noop)
"p" = (
/turf/open/floor/plating{
	icon_state = "panelscorched"
	},
/area/template_noop)
"q" = (
/obj/machinery/door/window/westleft,
/turf/open/floor/plating{
	icon_state = "panelscorched"
	},
/area/template_noop)
"r" = (
/obj/effect/turf_decal/stripes/line{
	dir = 10
	},
/obj/item/geiger_counter,
/turf/open/floor/plasteel,
/area/template_noop)
"s" = (
/obj/structure/window/reinforced,
/obj/structure/window/reinforced{
	dir = 4
	},
/obj/effect/turf_decal/stripes/corner{
	dir = 1
	},
/obj/effect/decal/cleanable/dirt,
/turf/open/floor/plasteel,
/area/template_noop)
"u" = (
/obj/effect/decal/cleanable/ash,
/turf/open/floor/plating{
	icon_state = "panelscorched"
	},
/area/template_noop)
"y" = (
/obj/structure/table,
/obj/machinery/light,
/obj/item/surgical_drapes,
/obj/item/hemostat,
/turf/open/floor/plating{
	icon_state = "panelscorched"
	},
/area/template_noop)
"A" = (
/obj/structure/window/reinforced{
	dir = 4
	},
/obj/structure/window/reinforced{
	dir = 1
	},
/obj/effect/decal/cleanable/dirt,
/turf/open/floor/plating,
/area/template_noop)
"D" = (
/obj/structure/table/optable,
/obj/effect/decal/cleanable/blood/old,
/turf/open/floor/plating{
	icon_state = "panelscorched"
	},
/area/template_noop)
"G" = (
/obj/effect/turf_decal/stripes/line{
	dir = 8
	},
/obj/effect/turf_decal/caution/stand_clear{
	dir = 8;
	icon_state = "stand_clear"
	},
/turf/open/floor/plasteel,
/area/template_noop)
"H" = (
/obj/structure/window/reinforced{
	dir = 1
	},
/obj/effect/turf_decal/stripes/line,
/obj/machinery/light/broken,
/obj/effect/turf_decal/caution/stand_clear,
/obj/effect/decal/cleanable/dirt,
/turf/open/floor/plasteel,
/area/template_noop)
"I" = (
/obj/effect/decal/remains/human,
/turf/open/floor/plating{
	icon_state = "panelscorched"
	},
/area/template_noop)
"L" = (
/turf/open/floor/plating{
	icon_state = "platingdmg1"
	},
/area/template_noop)
"M" = (
/turf/open/floor/plasteel,
/area/template_noop)
"N" = (
/obj/item/stack/ore/uranium,
/turf/open/floor/plating,
/area/template_noop)
"O" = (
/obj/structure/window/reinforced{
	dir = 1
	},
/turf/open/floor/plating,
/area/template_noop)
"P" = (
/obj/effect/turf_decal/stripes/line{
	dir = 9
	},
/turf/open/floor/plasteel,
/area/template_noop)
"Q" = (
/obj/structure/window/reinforced{
	dir = 8
	},
/obj/effect/turf_decal/stripes/line{
	dir = 4
	},
/turf/open/floor/plasteel,
/area/template_noop)
"R" = (
/obj/structure/window/reinforced{
	dir = 8
	},
/turf/open/floor/plasteel,
/area/template_noop)
"S" = (
/obj/structure/window/reinforced{
	dir = 1
	},
/obj/effect/turf_decal/stripes/line,
/obj/effect/decal/cleanable/dirt,
/turf/open/floor/plasteel,
/area/template_noop)
"T" = (
/turf/open/floor/plating,
/area/template_noop)
"U" = (
/obj/effect/decal/cleanable/dirt,
/obj/structure/table_frame,
/turf/open/floor/plasteel,
/area/template_noop)
"W" = (
/obj/structure/closet/radiation,
/obj/machinery/light/built{
	dir = 1;
	icon_state = "tube-empty"
	},
/turf/open/floor/plasteel,
/area/template_noop)
"X" = (
/obj/structure/window/reinforced,
/obj/effect/turf_decal/stripes/line{
	dir = 1
	},
/turf/open/floor/plasteel,
/area/template_noop)

(1,1,1) = {"
g
l
M
l
U
"}
(2,1,1) = {"
R
m
l
p
D
"}
(3,1,1) = {"
W
M
u
p
y
"}
(4,1,1) = {"
d
k
q
f
k
"}
(5,1,1) = {"
e
b
G
r
l
"}
(6,1,1) = {"
P
s
j
A
e
"}
(7,1,1) = {"
X
I
T
L
O
"}
(8,1,1) = {"
h
p
p
N
H
"}
(9,1,1) = {"
i
T
L
L
S
"}
(10,1,1) = {"
e
o
c
Q
a
"}
