//MAP CONVERTED BY dmm2tgm.py THIS HEADER COMMENT PREVENTS RECONVERSION, DO NOT REMOVE
"a" = (
/obj/effect/turf_decal/stripes/line{
	dir = 4
	},
/obj/effect/decal/cleanable/cobweb,
/obj/effect/turf_decal/tile/red{
	dir = 8
	},
/obj/effect/turf_decal/tile/red{
	dir = 4
	},
/obj/effect/turf_decal/tile/red{
	dir = 1
	},
/turf/open/floor/plasteel,
/area/template_noop)
"b" = (
/obj/structure/window/reinforced{
	dir = 8
	},
/turf/open/floor/plasteel/dark,
/area/template_noop)
"c" = (
/obj/effect/turf_decal/stripes/line{
	dir = 8
	},
/obj/effect/decal/cleanable/dirt,
/obj/effect/turf_decal/tile/red{
	dir = 4
	},
/obj/effect/turf_decal/tile/red,
/obj/effect/turf_decal/tile/red{
	dir = 1
	},
/turf/open/floor/plasteel,
/area/template_noop)
"d" = (
/obj/structure/window/reinforced{
	dir = 4
	},
/turf/open/floor/plasteel/dark,
/area/template_noop)
"e" = (
/obj/structure/window/reinforced{
	dir = 8
	},
/obj/structure/window/reinforced,
/turf/open/floor/plasteel/dark,
/area/template_noop)
"f" = (
/obj/machinery/atmospherics/components/unary/outlet_injector{
	dir = 8;
	icon_state = "inje_map-2"
	},
/obj/effect/turf_decal/bot,
/obj/effect/decal/cleanable/dirt,
/turf/open/floor/plasteel/dark,
/area/template_noop)
"h" = (
/obj/structure/window/reinforced{
	dir = 8
	},
/obj/machinery/atmospherics/pipe/simple/general/visible{
	dir = 6
	},
/turf/open/floor/plasteel/dark,
/area/template_noop)
"i" = (
/obj/structure/window/reinforced{
	dir = 4
	},
/obj/machinery/atmospherics/pipe/simple/general/visible{
	dir = 10
	},
/obj/effect/decal/cleanable/dirt,
/turf/open/floor/plasteel/dark,
/area/template_noop)
"k" = (
/obj/machinery/atmospherics/components/unary/outlet_injector{
	dir = 4;
	icon_state = "inje_map-2"
	},
/obj/effect/turf_decal/bot,
/turf/open/floor/plasteel/dark,
/area/template_noop)
"l" = (
/obj/effect/turf_decal/stripes/line{
	dir = 8
	},
/obj/effect/decal/cleanable/dirt,
/turf/open/floor/plasteel,
/area/template_noop)
"m" = (
/obj/structure/window/reinforced{
	dir = 8
	},
/obj/machinery/atmospherics/pipe/simple/general/visible,
/turf/open/floor/plasteel/dark,
/area/template_noop)
"n" = (
/obj/structure/chair,
/obj/effect/decal/cleanable/dirt,
/turf/open/floor/plasteel/dark,
/area/template_noop)
"o" = (
/obj/structure/window/reinforced{
	dir = 4
	},
/obj/effect/decal/cleanable/dirt,
/turf/open/floor/plasteel/dark,
/area/template_noop)
"p" = (
/obj/effect/turf_decal/stripes/line{
	dir = 1
	},
/obj/effect/turf_decal/caution,
/obj/structure/fans/tiny/invisible,
/turf/open/floor/plasteel,
/area/template_noop)
"q" = (
/obj/structure/window/reinforced,
/obj/structure/window/reinforced{
	dir = 4
	},
/obj/machinery/atmospherics/pipe/simple/general/visible,
/turf/open/floor/plasteel/dark,
/area/template_noop)
"r" = (
/obj/effect/turf_decal/stripes/line{
	dir = 4
	},
/obj/effect/decal/cleanable/dirt,
/turf/open/floor/plasteel,
/area/template_noop)
"s" = (
/obj/machinery/atmospherics/components/binary/pump{
	dir = 1
	},
/obj/effect/turf_decal/stripes/line{
	dir = 1
	},
/turf/open/floor/plasteel,
/area/template_noop)
"u" = (
/obj/effect/turf_decal/stripes/line{
	dir = 1
	},
/turf/open/floor/plasteel,
/area/template_noop)
"v" = (
/obj/effect/turf_decal/stripes/corner{
	dir = 1
	},
/turf/open/floor/plasteel,
/area/template_noop)
"w" = (
/obj/structure/window/reinforced{
	dir = 8
	},
/obj/effect/decal/cleanable/dirt,
/turf/open/floor/plasteel/dark,
/area/template_noop)
"x" = (
/obj/effect/turf_decal/stripes/line{
	dir = 4
	},
/obj/effect/turf_decal/tile/red{
	dir = 8
	},
/obj/effect/turf_decal/tile/red{
	dir = 1
	},
/turf/open/floor/plasteel,
/area/template_noop)
"y" = (
/obj/machinery/atmospherics/components/unary/portables_connector{
	dir = 8;
	icon_state = "connector_map-2"
	},
/obj/effect/turf_decal/box,
/turf/open/floor/plasteel,
/area/template_noop)
"z" = (
/obj/structure/window/reinforced{
	dir = 4
	},
/obj/machinery/atmospherics/pipe/simple/general/visible,
/obj/effect/decal/cleanable/dirt,
/turf/open/floor/plasteel/dark,
/area/template_noop)
"A" = (
/obj/effect/turf_decal/stripes/line{
	dir = 8
	},
/obj/effect/decal/cleanable/dirt,
/obj/effect/turf_decal/tile/red{
	dir = 4
	},
/obj/effect/turf_decal/tile/red,
/turf/open/floor/plasteel,
/area/template_noop)
"B" = (
/obj/machinery/door/window/southleft,
/turf/open/floor/plasteel/dark,
/area/template_noop)
"C" = (
/obj/machinery/door/window/southleft,
/obj/effect/decal/cleanable/dirt,
/turf/open/floor/plasteel/dark,
/area/template_noop)
"D" = (
/obj/structure/window/reinforced,
/obj/structure/window/reinforced{
	dir = 4
	},
/obj/effect/decal/remains/human,
/turf/open/floor/plasteel/dark,
/area/template_noop)
"E" = (
/obj/effect/turf_decal/stripes/corner{
	dir = 4
	},
/obj/effect/decal/cleanable/dirt,
/turf/open/floor/plasteel,
/area/template_noop)
"F" = (
/obj/effect/turf_decal/stripes/line{
	dir = 1
	},
/obj/effect/decal/cleanable/dirt,
/turf/open/floor/plasteel,
/area/template_noop)
"H" = (
/obj/effect/decal/cleanable/dirt,
/turf/open/floor/plasteel,
/area/template_noop)
"I" = (
/obj/effect/turf_decal/stripes/corner{
	dir = 4
	},
/obj/effect/decal/cleanable/dirt,
/obj/effect/turf_decal/tile/red{
	dir = 8
	},
/obj/effect/turf_decal/tile/red{
	dir = 1
	},
/turf/open/floor/plasteel,
/area/template_noop)
"J" = (
/obj/machinery/atmospherics/components/unary/portables_connector{
	dir = 4;
	icon_state = "connector_map-2"
	},
/obj/effect/turf_decal/box,
/obj/effect/decal/cleanable/dirt,
/turf/open/floor/plasteel,
/area/template_noop)
"K" = (
/obj/effect/turf_decal/stripes/corner{
	dir = 1
	},
/obj/effect/turf_decal/tile/red{
	dir = 4
	},
/obj/effect/turf_decal/tile/red,
/turf/open/floor/plasteel,
/area/template_noop)
"L" = (
/obj/effect/decal/cleanable/dirt,
/obj/effect/turf_decal/tile/red{
	dir = 8
	},
/obj/effect/turf_decal/tile/red{
	dir = 1
	},
/obj/effect/turf_decal/tile/red,
/turf/open/floor/plasteel,
/area/template_noop)
"M" = (
/obj/machinery/atmospherics/pipe/simple/general/visible{
	dir = 5
	},
/obj/effect/decal/cleanable/dirt,
/obj/effect/turf_decal/tile/red{
	dir = 8
	},
/obj/effect/turf_decal/tile/red,
/turf/open/floor/plasteel,
/area/template_noop)
"N" = (
/obj/machinery/light,
/obj/machinery/atmospherics/pipe/simple/general/visible{
	dir = 4
	},
/obj/effect/turf_decal/tile/red{
	dir = 8
	},
/obj/effect/turf_decal/tile/red,
/turf/open/floor/plasteel,
/area/template_noop)
"O" = (
/obj/machinery/atmospherics/pipe/simple/general/visible{
	dir = 9
	},
/obj/effect/turf_decal/tile/red{
	dir = 8
	},
/obj/effect/turf_decal/tile/red,
/turf/open/floor/plasteel,
/area/template_noop)
"P" = (
/obj/effect/turf_decal/tile/red{
	dir = 8
	},
/obj/effect/turf_decal/tile/red{
	dir = 4
	},
/obj/effect/turf_decal/tile/red,
/turf/open/floor/plasteel,
/area/template_noop)
"Q" = (
/obj/effect/turf_decal/stripes/line{
	dir = 8
	},
/turf/open/floor/plasteel,
/area/template_noop)
"S" = (
/obj/effect/turf_decal/stripes/line{
	dir = 1
	},
/obj/effect/turf_decal/caution,
/obj/effect/decal/cleanable/dirt,
/obj/structure/fans/tiny/invisible,
/turf/open/floor/plasteel,
/area/template_noop)
"W" = (
/obj/structure/window/reinforced{
	dir = 8
	},
/obj/structure/window/reinforced,
/obj/machinery/atmospherics/pipe/simple/general/visible,
/obj/effect/decal/cleanable/dirt,
/turf/open/floor/plasteel/dark,
/area/template_noop)
"Y" = (
/obj/effect/turf_decal/stripes/line{
	dir = 4
	},
/turf/open/floor/plasteel,
/area/template_noop)

(1,1,1) = {"
a
x
r
I
L
"}
(2,1,1) = {"
h
m
W
s
M
"}
(3,1,1) = {"
f
n
C
p
N
"}
(4,1,1) = {"
d
o
D
u
y
"}
(5,1,1) = {"
Q
l
Q
v
H
"}
(6,1,1) = {"
Y
r
r
E
H
"}
(7,1,1) = {"
b
w
e
F
J
"}
(8,1,1) = {"
k
n
B
S
N
"}
(9,1,1) = {"
i
z
q
s
O
"}
(10,1,1) = {"
c
A
Q
K
P
"}
