//MAP CONVERTED BY dmm2tgm.py THIS HEADER COMMENT PREVENTS RECONVERSION, DO NOT REMOVE
"a" = (
/obj/item/food/headcheese,
/turf/open/floor/holofloor/chapel,
/area/shipbreak)
"c" = (
/obj/machinery/power/shuttle_engine/propulsion,
/turf/open/floor/plating,
/area/shipbreak)
"h" = (
/turf/open/floor/carpet/purple,
/area/shipbreak)
"m" = (
/obj/item/storage/fancy/candle_box,
/turf/open/floor/carpet/purple,
/area/shipbreak)
"n" = (
/obj/item/food/sustenance_bar/cheese,
/turf/open/floor/carpet/purple,
/area/shipbreak)
"q" = (
/obj/item/storage/fancy/candle_box,
/turf/open/floor/holofloor/chapel,
/area/shipbreak)
"r" = (
/obj/structure/chair/pew/right{
	dir = 1
	},
/turf/open/floor/carpet/purple,
/area/shipbreak)
"s" = (
/obj/structure/chair/pew/left{
	dir = 1
	},
/obj/item/food/baked_cheese_platter,
/turf/open/floor/carpet/purple,
/area/shipbreak)
"t" = (
/obj/structure/chair/pew/left{
	dir = 1
	},
/obj/item/food/burger/cheese,
/turf/open/floor/carpet/purple,
/area/shipbreak)
"A" = (
/obj/item/food/cheese/cheese_curds,
/turf/open/floor/holofloor/chapel{
	dir = 1
	},
/area/shipbreak)
"B" = (
/turf/template_noop,
/area/shipbreak)
"C" = (
/turf/open/floor/holofloor/chapel{
	dir = 1
	},
/area/shipbreak)
"E" = (
/obj/structure/chair/pew/left{
	dir = 1
	},
/turf/open/floor/carpet/purple,
/area/shipbreak)
"G" = (
/turf/open/floor/holofloor/chapel{
	dir = 8
	},
/area/shipbreak)
"I" = (
/obj/item/food/herby_cheese,
/turf/open/floor/holofloor/chapel,
/area/shipbreak)
"L" = (
/obj/machinery/power/shuttle_engine/heater,
/obj/structure/window/reinforced/tinted{
	dir = 1
	},
/turf/open/floor/plating,
/area/shipbreak)
"N" = (
/turf/open/floor/holofloor/chapel{
	dir = 4
	},
/area/shipbreak)
"P" = (
/obj/item/food/pizza/mothic_five_cheese,
/turf/open/floor/holofloor/chapel,
/area/shipbreak)
"R" = (
/obj/item/food/sandwich/cheese,
/turf/open/floor/holofloor/chapel{
	dir = 1
	},
/area/shipbreak)
"S" = (
/obj/structure/window/reinforced/shuttle,
/obj/structure/grille,
/turf/open/floor/plating,
/area/shipbreak)
"U" = (
/obj/item/food/cake/cheese,
/turf/open/floor/carpet/purple,
/area/shipbreak)
"W" = (
/obj/structure/fluff/divine/convertaltar,
/obj/item/food/bread/creamcheese,
/turf/open/floor/holofloor/chapel{
	dir = 4
	},
/area/shipbreak)

(1,1,1) = {"
B
B
B
B
B
B
B
B
B
B
B
B
"}
(2,1,1) = {"
B
S
S
S
S
S
S
S
S
S
S
B
"}
(3,1,1) = {"
B
S
A
G
s
h
h
t
R
G
L
c
"}
(4,1,1) = {"
B
S
W
q
r
U
h
r
N
I
L
c
"}
(5,1,1) = {"
B
S
C
G
E
h
m
E
C
G
L
c
"}
(6,1,1) = {"
B
S
N
P
r
n
h
r
N
a
L
c
"}
(7,1,1) = {"
B
S
S
S
S
S
S
S
S
S
S
B
"}
(8,1,1) = {"
B
B
B
B
B
B
B
B
B
B
B
B
"}
