//MAP CONVERTED BY dmm2tgm.py THIS HEADER COMMENT PREVENTS RECONVERSION, DO NOT REMOVE
"a" = (
/turf/closed/wall/mineral/bananium,
/area/shipbreak)
"k" = (
/obj/machinery/power/shuttle_engine/propulsion,
/turf/open/floor/plating,
/area/shipbreak)
"q" = (
/turf/open/floor/mineral/bananium/airless,
/area/shipbreak)
"u" = (
/obj/machinery/door/firedoor/border_only{
	dir = 1
	},
/obj/structure/grille,
/obj/effect/spawner/structure/window,
/turf/open/floor/plating/airless,
/area/shipbreak)
"x" = (
/obj/structure/closet/secure_closet/freezer/cream_pie,
/turf/open/floor/mineral/bananium/airless,
/area/shipbreak)
"B" = (
/obj/machinery/vending/autodrobe/all_access,
/turf/open/floor/mineral/bananium/airless,
/area/shipbreak)
"M" = (
/obj/machinery/door/airlock/bananium/glass,
/obj/machinery/door/firedoor/border_only{
	dir = 1
	},
/obj/machinery/door/firedoor/border_only,
/obj/effect/mine/sound/bwoink,
/turf/open/floor/mineral/bananium/airless,
/area/shipbreak)
"P" = (
/obj/structure/window/reinforced/tinted{
	dir = 1
	},
/obj/structure/window/reinforced/tinted{
	dir = 4
	},
/obj/structure/window/reinforced/tinted{
	dir = 8
	},
/obj/machinery/power/shuttle_engine/heater,
/turf/open/floor/plating,
/area/shipbreak)
"R" = (
/obj/machinery/computer{
	dir = 8
	},
/turf/open/floor/mineral/bananium/airless,
/area/shipbreak)
"T" = (
/obj/item/bikehorn,
/obj/structure/table/wood/fancy,
/obj/item/food/burger/clown,
/turf/open/floor/mineral/bananium/airless,
/area/shipbreak)
"Y" = (
/turf/template_noop,
/area/shipbreak)

(1,1,1) = {"
Y
Y
Y
Y
Y
a
a
P
k
Y
Y
Y
"}
(2,1,1) = {"
Y
Y
Y
Y
a
q
x
a
Y
Y
Y
Y
"}
(3,1,1) = {"
Y
Y
Y
a
T
q
a
Y
Y
Y
Y
Y
"}
(4,1,1) = {"
Y
Y
Y
u
q
q
M
Y
Y
Y
Y
Y
"}
(5,1,1) = {"
Y
Y
Y
u
q
q
M
Y
Y
Y
Y
Y
"}
(6,1,1) = {"
Y
Y
Y
a
R
q
a
Y
Y
Y
Y
Y
"}
(7,1,1) = {"
Y
Y
Y
Y
a
q
B
a
Y
Y
Y
Y
"}
(8,1,1) = {"
Y
Y
Y
Y
Y
a
a
P
k
Y
Y
Y
"}
