//MAP CONVERTED BY dmm2tgm.py THIS HEADER COMMENT PREVENTS RECONVERSION, DO NOT REMOVE
"ai" = (
/obj/effect/turf_decal/trimline/yellow/corner{
	dir = 4
	},
/turf/open/floor/mineral/plastitanium,
/area/shipbreak)
"an" = (
/turf/open/floor/mineral/plastitanium,
/area/shipbreak)
"aA" = (
/obj/machinery/atmospherics/pipe/smart/simple/dark,
/obj/effect/spawner/structure/window/reinforced,
/turf/open/floor/plating/airless,
/area/shipbreak)
"bj" = (
/obj/structure/window/reinforced,
/turf/open/floor/mineral/plastitanium,
/area/shipbreak)
"bl" = (
/obj/effect/turf_decal/trimline/yellow/corner{
	dir = 8
	},
/turf/open/floor/mineral/plastitanium,
/area/shipbreak)
"bq" = (
/obj/machinery/door/airlock/diamond,
/obj/machinery/door/firedoor/heavy,
/turf/open/floor/mineral/titanium/tiled/blue,
/area/shipbreak)
"bV" = (
/obj/effect/turf_decal/trimline/red/corner{
	dir = 8
	},
/obj/structure/cable,
/turf/open/floor/mineral/plastitanium,
/area/shipbreak)
"cl" = (
/obj/effect/turf_decal/trimline/yellow/filled/warning{
	dir = 8
	},
/obj/machinery/atmospherics/pipe/layer_manifold/visible{
	dir = 4
	},
/turf/open/floor/mineral/plastitanium,
/area/shipbreak)
"cO" = (
/obj/machinery/door/airlock/uranium/safe,
/turf/open/floor/mineral/uranium,
/area/shipbreak)
"da" = (
/obj/machinery/atmospherics/components/unary/vent_pump/siphon/monitored/miasma_output{
	dir = 1
	},
/turf/open/floor/engine/halon{
	initial_gas_mix = "halon=500;TEMP=298.15"
	},
/area/shipbreak)
"dc" = (
/obj/machinery/door/airlock/security,
/obj/machinery/door/firedoor/heavy,
/turf/open/floor/mineral/plastitanium/red,
/area/shipbreak)
"dn" = (
/obj/effect/turf_decal/trimline/blue/filled/warning{
	dir = 4
	},
/obj/structure/cable,
/turf/open/floor/mineral/plastitanium,
/area/shipbreak)
"du" = (
/obj/structure/extinguisher_cabinet/directional/east,
/obj/machinery/power/floodlight,
/obj/effect/decal/cleanable/dirt,
/turf/open/floor/mineral/plastitanium,
/area/shipbreak)
"ee" = (
/obj/machinery/air_sensor/miasma_tank,
/obj/machinery/light/floor/has_bulb,
/obj/machinery/igniter/incinerator_atmos{
	name = "gas stabilizer"
	},
/turf/open/floor/engine/halon{
	initial_gas_mix = "halon=500;TEMP=298.15"
	},
/area/shipbreak)
"eC" = (
/obj/effect/spawner/structure/window/reinforced,
/turf/open/floor/plating/airless,
/area/shipbreak)
"eK" = (
/obj/machinery/air_sensor/halon_tank,
/obj/machinery/light/floor/has_bulb,
/obj/machinery/igniter/incinerator_atmos{
	name = "gas stabilizer"
	},
/turf/open/floor/engine/healium{
	initial_gas_mix = "healium=500;TEMP=298.15"
	},
/area/shipbreak)
"eU" = (
/obj/effect/turf_decal/trimline/green/filled/warning{
	dir = 1
	},
/obj/structure/cable,
/turf/open/floor/mineral/plastitanium,
/area/shipbreak)
"fc" = (
/obj/structure/cable,
/obj/machinery/atmospherics/components/binary/valve{
	dir = 4
	},
/turf/open/floor/mineral/plastitanium,
/area/shipbreak)
"fU" = (
/obj/machinery/computer/atmos_control/miasma_tank{
	dir = 1
	},
/obj/structure/cable,
/turf/open/floor/mineral/plastitanium,
/area/shipbreak)
"gt" = (
/obj/effect/spawner/structure/window/reinforced/damaged,
/turf/open/floor/plating/airless,
/area/shipbreak)
"hb" = (
/obj/effect/turf_decal/trimline/yellow/corner,
/obj/effect/turf_decal/trimline/yellow/filled/corner{
	dir = 4
	},
/turf/open/floor/mineral/plastitanium,
/area/shipbreak)
"iB" = (
/turf/template_noop,
/area/shipbreak)
"iC" = (
/obj/effect/decal/cleanable/blood,
/obj/effect/decal/cleanable/dirt/dust,
/turf/open/floor/mineral/titanium/tiled/yellow,
/area/shipbreak)
"iH" = (
/obj/machinery/power/shuttle_engine/large{
	dir = 1
	},
/turf/template_noop,
/area/shipbreak)
"iZ" = (
/obj/effect/decal/cleanable/dirt/dust,
/turf/open/floor/mineral/titanium/tiled/blue,
/area/shipbreak)
"jb" = (
/obj/machinery/atmospherics/components/unary/portables_connector/visible{
	dir = 8
	},
/turf/open/floor/mineral/plastitanium,
/area/shipbreak)
"jq" = (
/obj/effect/turf_decal/trimline/yellow/arrow_cw{
	dir = 4
	},
/turf/open/floor/mineral/plastitanium,
/area/shipbreak)
"jP" = (
/obj/structure/table/reinforced/titaniumglass,
/obj/item/storage/belt/utility{
	pixel_y = 3
	},
/obj/item/pipe_dispenser,
/obj/item/clothing/glasses/meson,
/obj/item/clothing/glasses/meson,
/turf/open/floor/mineral/plastitanium,
/area/shipbreak)
"jS" = (
/obj/effect/turf_decal/trimline/yellow/filled/corner,
/turf/open/floor/mineral/plastitanium,
/area/shipbreak)
"ls" = (
/obj/machinery/atmospherics/components/unary/portables_connector/visible{
	dir = 4
	},
/turf/open/floor/mineral/plastitanium,
/area/shipbreak)
"lv" = (
/obj/effect/turf_decal/trimline/green/corner{
	dir = 1
	},
/obj/structure/cable,
/turf/open/floor/mineral/plastitanium,
/area/shipbreak)
"lX" = (
/obj/effect/turf_decal/trimline/neutral/corner{
	dir = 4
	},
/obj/structure/cable,
/turf/open/floor/mineral/plastitanium,
/area/shipbreak)
"md" = (
/obj/structure/window/reinforced{
	dir = 1
	},
/turf/open/floor/mineral/plastitanium,
/area/shipbreak)
"mo" = (
/obj/structure/window/reinforced,
/obj/machinery/power/shuttle_engine/heater{
	dir = 1
	},
/turf/open/floor/plating/airless,
/area/shipbreak)
"mG" = (
/obj/machinery/door/airlock/security,
/turf/open/floor/mineral/plastitanium/red,
/area/shipbreak)
"mQ" = (
/obj/structure/cable,
/turf/open/floor/mineral/plastitanium,
/area/shipbreak)
"mU" = (
/obj/effect/turf_decal/trimline/yellow/filled/warning{
	dir = 1
	},
/turf/open/floor/mineral/plastitanium,
/area/shipbreak)
"ne" = (
/obj/machinery/air_sensor/tritium_tank,
/obj/machinery/light/floor/has_bulb,
/obj/machinery/igniter/incinerator_atmos{
	name = "gas stabilizer"
	},
/turf/open/floor/engine/tritium{
	initial_gas_mix = "tritium=500;TEMP=298.15"
	},
/area/shipbreak)
"nm" = (
/obj/machinery/power/shuttle_engine/heater{
	dir = 1
	},
/obj/structure/window/reinforced,
/turf/open/floor/plating/airless,
/area/shipbreak)
"nR" = (
/obj/effect/turf_decal/trimline/green/filled/warning{
	dir = 9
	},
/obj/structure/cable,
/turf/open/floor/mineral/plastitanium,
/area/shipbreak)
"oK" = (
/obj/machinery/air_sensor/zauker_tank,
/obj/machinery/light/floor/has_bulb,
/obj/machinery/igniter/incinerator_atmos{
	name = "gas stabilizer"
	},
/turf/open/floor/engine/zauker{
	initial_gas_mix = "zauker=500;TEMP=298.15"
	},
/area/shipbreak)
"pi" = (
/obj/effect/turf_decal/vg_decals/numbers/eight,
/turf/open/floor/engine/healium{
	initial_gas_mix = "healium=500;TEMP=298.15"
	},
/area/shipbreak)
"pJ" = (
/turf/open/floor/engine/halon{
	initial_gas_mix = "halon=500;TEMP=298.15"
	},
/area/shipbreak)
"qv" = (
/obj/effect/turf_decal/trimline/green/corner{
	dir = 1
	},
/obj/structure/cable,
/obj/effect/decal/cleanable/dirt,
/turf/open/floor/mineral/plastitanium,
/area/shipbreak)
"qC" = (
/obj/effect/decal/cleanable/dirt/dust,
/turf/open/floor/mineral/plastitanium/red,
/area/shipbreak)
"qI" = (
/obj/effect/turf_decal/trimline/neutral/filled/corner{
	dir = 7
	},
/obj/structure/cable,
/obj/machinery/light/small/directional/east,
/turf/open/floor/mineral/plastitanium,
/area/shipbreak)
"qR" = (
/turf/open/floor/plating/airless,
/area/shipbreak)
"qX" = (
/obj/effect/turf_decal/trimline/yellow/filled/corner{
	dir = 8
	},
/turf/open/floor/mineral/plastitanium,
/area/shipbreak)
"rl" = (
/obj/effect/turf_decal/trimline/green/filled/warning{
	dir = 1
	},
/obj/structure/cable,
/obj/machinery/atmospherics/components/unary/portables_connector/visible{
	dir = 1
	},
/turf/open/floor/mineral/plastitanium,
/area/shipbreak)
"rs" = (
/obj/structure/closet/firecloset/full,
/obj/effect/decal/cleanable/dirt,
/turf/open/floor/mineral/plastitanium,
/area/shipbreak)
"rt" = (
/obj/machinery/atmospherics/components/unary/vent_pump/siphon/monitored/zauker_output,
/turf/open/floor/engine/zauker{
	initial_gas_mix = "zauker=500;TEMP=298.15"
	},
/area/shipbreak)
"rw" = (
/obj/effect/turf_decal/trimline/red/filled/warning{
	dir = 8
	},
/obj/structure/cable,
/turf/open/floor/mineral/plastitanium,
/area/shipbreak)
"sK" = (
/obj/machinery/atmospherics/components/unary/vent_pump/siphon/monitored/halon_output{
	dir = 1
	},
/turf/open/floor/engine/healium{
	initial_gas_mix = "healium=500;TEMP=298.15"
	},
/area/shipbreak)
"tp" = (
/obj/effect/turf_decal/trimline/yellow/filled/warning{
	dir = 4
	},
/turf/open/floor/mineral/plastitanium,
/area/shipbreak)
"tz" = (
/obj/item/grenade/chem_grenade/metalfoam{
	pixel_x = 3;
	pixel_y = 5
	},
/obj/item/grenade/chem_grenade/metalfoam{
	pixel_x = -2;
	pixel_y = 2
	},
/obj/item/grenade/chem_grenade/metalfoam{
	pixel_x = -6;
	pixel_y = -3
	},
/obj/structure/rack,
/obj/item/clothing/suit/utility/fire/atmos,
/obj/item/clothing/suit/utility/fire/atmos,
/obj/item/holosign_creator/atmos,
/turf/open/floor/mineral/plastitanium,
/area/shipbreak)
"tS" = (
/obj/effect/turf_decal/trimline/red/corner{
	dir = 8
	},
/obj/structure/cable,
/obj/effect/decal/cleanable/dirt,
/turf/open/floor/mineral/plastitanium,
/area/shipbreak)
"uq" = (
/obj/structure/window/reinforced,
/obj/machinery/power/port_gen/pacman/pre_loaded,
/obj/structure/cable,
/turf/open/floor/mineral/plastitanium,
/area/shipbreak)
"uU" = (
/obj/effect/turf_decal/trimline/neutral/filled/warning{
	dir = 5
	},
/obj/structure/cable,
/turf/open/floor/mineral/plastitanium,
/area/shipbreak)
"uW" = (
/obj/effect/turf_decal/trimline/yellow/filled/corner{
	dir = 8
	},
/obj/effect/decal/cleanable/dirt,
/turf/open/floor/mineral/plastitanium,
/area/shipbreak)
"wj" = (
/obj/effect/turf_decal/vg_decals/numbers/three,
/turf/open/floor/engine/tritium{
	initial_gas_mix = "tritium=500;TEMP=298.15"
	},
/area/shipbreak)
"wR" = (
/obj/effect/turf_decal/trimline/yellow/arrow_cw{
	dir = 8
	},
/turf/open/floor/mineral/plastitanium,
/area/shipbreak)
"wV" = (
/obj/effect/turf_decal/trimline/yellow,
/obj/effect/decal/cleanable/dirt/dust,
/turf/open/floor/mineral/titanium/tiled/yellow,
/area/shipbreak)
"wZ" = (
/obj/machinery/portable_atmospherics/scrubber/huge/movable,
/turf/open/floor/mineral/plastitanium,
/area/shipbreak)
"xt" = (
/obj/structure/window/reinforced,
/obj/structure/reagent_dispensers/foamtank,
/turf/open/floor/mineral/plastitanium,
/area/shipbreak)
"xN" = (
/obj/machinery/atmospherics/components/unary/vent_pump/siphon/monitored/tritium_output,
/turf/open/floor/engine/tritium{
	initial_gas_mix = "tritium=500;TEMP=298.15"
	},
/area/shipbreak)
"xY" = (
/obj/effect/turf_decal/trimline/green/filled/corner{
	dir = 8
	},
/obj/structure/cable,
/obj/machinery/light/small/directional/west,
/turf/open/floor/mineral/plastitanium,
/area/shipbreak)
"yt" = (
/turf/open/floor/mineral/titanium/tiled,
/area/shipbreak)
"yz" = (
/obj/effect/turf_decal/trimline/blue/filled/warning{
	dir = 6
	},
/obj/structure/cable,
/turf/open/floor/mineral/plastitanium,
/area/shipbreak)
"yL" = (
/turf/closed/wall/mineral/plastitanium/nodiagonal,
/area/shipbreak)
"yO" = (
/obj/effect/turf_decal/trimline/yellow/arrow_cw{
	dir = 4
	},
/obj/effect/decal/cleanable/dirt,
/turf/open/floor/mineral/plastitanium,
/area/shipbreak)
"yZ" = (
/obj/effect/turf_decal/trimline/neutral/filled/warning{
	dir = 4
	},
/obj/structure/cable,
/turf/open/floor/mineral/plastitanium,
/area/shipbreak)
"zq" = (
/obj/effect/turf_decal/trimline/yellow/filled/corner,
/obj/effect/decal/cleanable/dirt,
/turf/open/floor/mineral/plastitanium,
/area/shipbreak)
"zw" = (
/obj/effect/turf_decal/trimline/red/filled/corner,
/obj/structure/cable,
/obj/machinery/light/small/directional/south,
/turf/open/floor/mineral/plastitanium,
/area/shipbreak)
"zM" = (
/obj/effect/decal/cleanable/dirt/dust,
/turf/open/floor/mineral/uranium,
/area/shipbreak)
"AW" = (
/obj/machinery/power/shuttle_engine/heater{
	dir = 1
	},
/obj/structure/window/reinforced{
	dir = 1
	},
/turf/open/floor/plating/airless,
/area/shipbreak)
"AX" = (
/obj/effect/turf_decal/trimline/yellow/filled/corner{
	dir = 1
	},
/turf/open/floor/mineral/plastitanium,
/area/shipbreak)
"Ba" = (
/turf/open/floor/engine/zauker{
	initial_gas_mix = "zauker=500;TEMP=298.15"
	},
/area/shipbreak)
"Bj" = (
/obj/effect/turf_decal/trimline/yellow,
/obj/effect/decal/cleanable/dirt/dust,
/obj/effect/mob_spawn/corpse/human/charredskeleton{
	mob_name = "failed atmosian"
	},
/turf/open/floor/mineral/titanium/tiled/yellow,
/area/shipbreak)
"Bp" = (
/obj/effect/turf_decal/trimline/red/filled/warning,
/obj/structure/cable,
/turf/open/floor/mineral/plastitanium,
/area/shipbreak)
"By" = (
/obj/machinery/atmospherics/pipe/smart/simple/cyan,
/obj/effect/spawner/structure/window/reinforced,
/turf/open/floor/plating/airless,
/area/shipbreak)
"BJ" = (
/turf/open/floor/engine/healium{
	initial_gas_mix = "healium=500;TEMP=298.15"
	},
/area/shipbreak)
"BN" = (
/obj/structure/window/reinforced{
	dir = 1
	},
/obj/structure/table{
	pixel_y = -7
	},
/obj/item/food/donkpocket/pizza{
	pixel_x = -8;
	pixel_y = 0
	},
/obj/item/food/donkpocket/honk{
	pixel_x = -8;
	pixel_y = -2
	},
/obj/item/food/donkpocket/gondola{
	pixel_x = -8;
	pixel_y = -4
	},
/obj/item/food/donkpocket/berry{
	pixel_x = -8;
	pixel_y = -6
	},
/obj/item/trash/ready_donk{
	pixel_x = 6;
	pixel_y = -4
	},
/turf/open/floor/mineral/plastitanium,
/area/shipbreak)
"BT" = (
/obj/structure/fireaxecabinet,
/obj/item/flashlight/spotlight,
/obj/effect/holy,
/obj/effect/decal/cleanable/dirt/dust,
/turf/closed/wall/mineral/plastitanium/nodiagonal,
/area/shipbreak)
"Cg" = (
/obj/effect/turf_decal/trimline/neutral/filled/warning{
	dir = 1
	},
/obj/structure/cable,
/turf/open/floor/mineral/plastitanium,
/area/shipbreak)
"Cs" = (
/obj/effect/turf_decal/trimline/yellow/filled/corner{
	dir = 4
	},
/turf/open/floor/mineral/plastitanium,
/area/shipbreak)
"Df" = (
/obj/structure/window/reinforced{
	dir = 1
	},
/obj/structure/table{
	pixel_y = -7
	},
/obj/machinery/microwave{
	pixel_y = -4
	},
/obj/item/food/donkpocket/warm/spicy,
/turf/open/floor/mineral/plastitanium,
/area/shipbreak)
"Dy" = (
/obj/effect/turf_decal/trimline/blue/filled/warning,
/obj/structure/cable,
/obj/machinery/atmospherics/components/unary/portables_connector/visible,
/turf/open/floor/mineral/plastitanium,
/area/shipbreak)
"DV" = (
/obj/effect/decal/cleanable/dirt/dust,
/turf/open/floor/mineral/titanium/tiled/yellow,
/area/shipbreak)
"Ei" = (
/obj/effect/decal/cleanable/dirt/dust,
/turf/open/floor/mineral/titanium/tiled,
/area/shipbreak)
"Eq" = (
/obj/structure/closet/radiation,
/turf/open/floor/mineral/plastitanium,
/area/shipbreak)
"ER" = (
/turf/open/floor/engine/tritium{
	initial_gas_mix = "tritium=500;TEMP=298.15"
	},
/area/shipbreak)
"EX" = (
/obj/effect/turf_decal/trimline/red/filled/warning,
/obj/structure/cable,
/obj/machinery/atmospherics/components/unary/portables_connector/visible,
/turf/open/floor/mineral/plastitanium,
/area/shipbreak)
"Fj" = (
/obj/effect/turf_decal/trimline/yellow/filled/warning,
/obj/effect/decal/cleanable/dirt,
/turf/open/floor/mineral/plastitanium,
/area/shipbreak)
"Fv" = (
/obj/machinery/power/shuttle_engine/large,
/turf/template_noop,
/area/shipbreak)
"FG" = (
/obj/effect/turf_decal/trimline/blue/filled/corner{
	dir = 8
	},
/obj/structure/cable,
/obj/machinery/light/small/directional/south,
/turf/open/floor/mineral/plastitanium,
/area/shipbreak)
"FW" = (
/obj/structure/lattice/catwalk,
/turf/open/floor/catwalk_floor/iron_dark/airless,
/area/shipbreak)
"GE" = (
/obj/machinery/door/airlock/uranium/safe,
/obj/machinery/door/firedoor/heavy,
/turf/open/floor/mineral/uranium,
/area/shipbreak)
"Iv" = (
/turf/open/floor/mineral/titanium/tiled/blue,
/area/shipbreak)
"JU" = (
/obj/machinery/atmospherics/pipe/smart/simple/green,
/obj/effect/spawner/structure/window/reinforced/damaged,
/turf/open/floor/plating/airless,
/area/shipbreak)
"JV" = (
/obj/effect/turf_decal/trimline/neutral/filled/warning{
	dir = 1
	},
/obj/structure/cable,
/obj/machinery/atmospherics/components/unary/portables_connector/visible{
	dir = 1
	},
/turf/open/floor/mineral/plastitanium,
/area/shipbreak)
"JY" = (
/turf/open/floor/mineral/uranium,
/area/shipbreak)
"Kv" = (
/obj/machinery/door/airlock/freezer,
/obj/machinery/door/firedoor/heavy,
/turf/open/floor/mineral/titanium/tiled,
/area/shipbreak)
"KM" = (
/obj/effect/decal/cleanable/dirt,
/turf/open/floor/mineral/plastitanium,
/area/shipbreak)
"Lz" = (
/obj/machinery/portable_atmospherics/pump,
/turf/open/floor/mineral/plastitanium,
/area/shipbreak)
"LP" = (
/obj/machinery/computer/atmos_control/tritium_tank,
/obj/structure/cable,
/turf/open/floor/mineral/plastitanium,
/area/shipbreak)
"MM" = (
/obj/effect/turf_decal/trimline/yellow/corner{
	dir = 1
	},
/obj/effect/turf_decal/trimline/yellow/filled/corner{
	dir = 8
	},
/obj/item/wrench,
/turf/open/floor/mineral/plastitanium,
/area/shipbreak)
"MX" = (
/obj/machinery/door/airlock/external{
	dir = 4
	},
/turf/open/floor/plating,
/area/shipbreak)
"Na" = (
/obj/machinery/computer/atmos_control/halon_tank{
	dir = 1
	},
/obj/structure/cable,
/obj/effect/decal/cleanable/dirt,
/turf/open/floor/mineral/plastitanium,
/area/shipbreak)
"NF" = (
/obj/effect/turf_decal/trimline/green/filled/corner{
	dir = 4
	},
/obj/structure/cable,
/obj/machinery/light/small/directional/north,
/turf/open/floor/mineral/plastitanium,
/area/shipbreak)
"NH" = (
/obj/structure/cable,
/obj/structure/chair/comfy/shuttle/tactical{
	dir = 1
	},
/turf/open/floor/mineral/plastitanium,
/area/shipbreak)
"Ob" = (
/obj/machinery/power/shuttle_engine/heater,
/obj/structure/window/reinforced{
	dir = 1
	},
/turf/open/floor/plating/airless,
/area/shipbreak)
"Pd" = (
/obj/effect/turf_decal/trimline/blue/filled/corner{
	dir = 4
	},
/obj/structure/cable,
/obj/machinery/light/small/directional/east,
/turf/open/floor/mineral/plastitanium,
/area/shipbreak)
"PM" = (
/obj/structure/closet/firecloset/full,
/turf/open/floor/mineral/plastitanium,
/area/shipbreak)
"Qk" = (
/obj/machinery/door/airlock/diamond,
/turf/open/floor/mineral/titanium/tiled/blue,
/area/shipbreak)
"QE" = (
/obj/effect/turf_decal/trimline/neutral/filled/corner{
	dir = 1
	},
/obj/structure/cable,
/obj/machinery/light/small/directional/north,
/obj/effect/decal/cleanable/dirt,
/turf/open/floor/mineral/plastitanium,
/area/shipbreak)
"QJ" = (
/obj/effect/decal/cleanable/blood/splatter/over_window,
/obj/effect/spawner/structure/window/reinforced,
/turf/open/floor/plating/airless,
/area/shipbreak)
"QV" = (
/obj/structure/window/reinforced{
	dir = 1
	},
/obj/structure/cable,
/obj/structure/sign/poster/contraband/donk_co/directional/north,
/obj/machinery/computer/old,
/turf/open/floor/mineral/plastitanium,
/area/shipbreak)
"QY" = (
/obj/effect/turf_decal/trimline/yellow/filled/warning{
	dir = 4
	},
/obj/effect/decal/cleanable/dirt,
/turf/open/floor/mineral/plastitanium,
/area/shipbreak)
"RE" = (
/obj/effect/turf_decal/trimline/blue/corner,
/obj/structure/cable,
/turf/open/floor/mineral/plastitanium,
/area/shipbreak)
"RK" = (
/obj/effect/turf_decal/trimline/yellow/filled/warning{
	dir = 8
	},
/turf/open/floor/mineral/plastitanium,
/area/shipbreak)
"RT" = (
/obj/structure/cable,
/obj/effect/decal/cleanable/dirt,
/turf/open/floor/mineral/plastitanium,
/area/shipbreak)
"RV" = (
/obj/effect/turf_decal/trimline/green/filled/warning{
	dir = 8
	},
/obj/structure/cable,
/turf/open/floor/mineral/plastitanium,
/area/shipbreak)
"Sr" = (
/obj/machinery/atmospherics/pipe/smart/simple/scrubbers,
/obj/effect/spawner/structure/window/reinforced/damaged,
/turf/open/floor/plating/airless,
/area/shipbreak)
"SA" = (
/turf/open/floor/mineral/titanium/tiled/yellow,
/area/shipbreak)
"Tm" = (
/obj/effect/turf_decal/trimline/blue/filled/warning,
/obj/structure/cable,
/turf/open/floor/mineral/plastitanium,
/area/shipbreak)
"TC" = (
/turf/open/floor/mineral/plastitanium/red,
/area/shipbreak)
"UR" = (
/obj/machinery/door/airlock/freezer,
/obj/effect/decal/cleanable/dirt/dust,
/turf/open/floor/mineral/titanium/tiled,
/area/shipbreak)
"VU" = (
/obj/structure/rack,
/obj/item/clothing/suit/hazardvest,
/obj/item/clothing/suit/hazardvest,
/obj/item/clothing/gloves/color/black,
/obj/item/clothing/gloves/color/black,
/obj/item/clothing/mask/gas/atmos,
/obj/item/clothing/mask/gas/atmos,
/turf/open/floor/mineral/plastitanium,
/area/shipbreak)
"Wd" = (
/obj/structure/extinguisher_cabinet/directional/west,
/obj/machinery/suit_storage_unit/standard_unit{
	pixel_x = -2;
	pixel_y = 0
	},
/turf/open/floor/mineral/plastitanium,
/area/shipbreak)
"Wx" = (
/obj/effect/turf_decal/trimline/red/filled/corner{
	dir = 1
	},
/obj/structure/cable,
/obj/machinery/light/small/directional/west,
/turf/open/floor/mineral/plastitanium,
/area/shipbreak)
"Xj" = (
/obj/effect/turf_decal/trimline/yellow,
/turf/open/floor/mineral/titanium/tiled/yellow,
/area/shipbreak)
"Xq" = (
/obj/machinery/portable_atmospherics/canister,
/turf/open/floor/mineral/plastitanium,
/area/shipbreak)
"Xy" = (
/obj/machinery/power/smes/full{
	pixel_y = 5
	},
/obj/structure/cable,
/obj/structure/window/reinforced,
/turf/open/floor/mineral/plastitanium,
/area/shipbreak)
"XY" = (
/obj/effect/turf_decal/trimline/red/filled/warning{
	dir = 8
	},
/obj/structure/cable,
/obj/effect/decal/cleanable/dirt,
/turf/open/floor/mineral/plastitanium,
/area/shipbreak)
"Yg" = (
/obj/effect/turf_decal/vg_decals/numbers/zero,
/turf/open/floor/engine/zauker{
	initial_gas_mix = "zauker=500;TEMP=298.15"
	},
/area/shipbreak)
"Yq" = (
/obj/effect/turf_decal/trimline/yellow/filled/warning,
/turf/open/floor/mineral/plastitanium,
/area/shipbreak)
"ZB" = (
/obj/machinery/computer/atmos_control/zauker_tank,
/obj/structure/cable,
/turf/open/floor/mineral/plastitanium,
/area/shipbreak)
"ZF" = (
/obj/effect/turf_decal/trimline/red/filled/warning{
	dir = 10
	},
/obj/structure/cable,
/turf/open/floor/mineral/plastitanium,
/area/shipbreak)
"ZG" = (
/obj/effect/turf_decal/vg_decals/numbers/five,
/turf/open/floor/engine/halon{
	initial_gas_mix = "halon=500;TEMP=298.15"
	},
/area/shipbreak)

(1,1,1) = {"
iB
iB
iB
iB
iB
iB
iB
FW
FW
FW
yL
Ob
qR
Fv
iB
iB
iB
iB
iB
iB
iB
iB
iB
iB
iB
"}
(2,1,1) = {"
iB
iB
iB
iB
iB
iB
yL
yL
MX
yL
yL
Ob
qR
iB
iB
yL
yL
yL
yL
iB
iB
iB
iB
iB
iB
"}
(3,1,1) = {"
iB
iB
iB
iB
eC
eC
yL
Wd
an
tz
yL
yL
yL
yL
yL
yL
ls
jP
yL
gt
eC
iB
iB
iB
iB
"}
(4,1,1) = {"
iB
iB
iB
eC
eC
an
an
an
an
an
bl
wR
wR
wR
wR
MM
cl
RK
AX
an
eC
eC
iB
iB
iB
"}
(5,1,1) = {"
iB
iB
iB
eC
an
an
RE
dn
dn
dn
Pd
mQ
mQ
RT
qI
yZ
yZ
yZ
lX
KM
KM
eC
iB
iB
iB
"}
(6,1,1) = {"
iB
iB
yL
yL
Cs
RE
yz
eC
eC
eC
yL
an
KM
KM
yL
eC
eC
eC
uU
lX
zq
yL
yL
iB
iB
"}
(7,1,1) = {"
iB
iB
yL
PM
mU
Tm
eC
eC
pJ
pJ
yL
yL
bq
yL
yL
Ba
Ba
eC
eC
Cg
Yq
Eq
yL
iB
iB
"}
(8,1,1) = {"
iB
iB
yL
Xq
mU
Tm
eC
pJ
ZG
pJ
pJ
yL
Iv
yL
Ba
Ba
Yg
Ba
eC
Cg
Yq
Xq
yL
iB
iB
"}
(9,1,1) = {"
iB
iB
yL
yL
AX
Dy
By
da
pJ
ee
pJ
yL
iZ
yL
Ba
oK
Ba
rt
aA
JV
qX
yL
yL
iB
iB
"}
(10,1,1) = {"
iB
iH
mo
md
an
FG
yL
yL
pJ
pJ
yL
yL
Qk
yL
yL
Ba
Ba
yL
yL
QE
mQ
uq
Ob
iB
Fv
"}
(11,1,1) = {"
iB
iB
mo
Df
an
mQ
fU
yL
yL
yL
yL
DV
wV
SA
yL
yL
yL
yL
ZB
RT
ls
bj
AW
iB
iB
"}
(12,1,1) = {"
iB
iB
yL
QV
NH
mQ
KM
dc
TC
qC
mG
Xj
BT
Bj
UR
Ei
yt
Kv
an
RT
fc
Xy
yL
iB
iB
"}
(13,1,1) = {"
iB
iH
mo
BN
KM
RT
Na
yL
yL
yL
yL
SA
wV
iC
yL
yL
yL
yL
LP
RT
jb
bj
Ob
iB
Fv
"}
(14,1,1) = {"
iB
iB
mo
md
an
zw
yL
yL
BJ
BJ
yL
yL
cO
yL
yL
ER
ER
yL
yL
NF
an
xt
Ob
iB
iB
"}
(15,1,1) = {"
iB
iB
yL
yL
Cs
EX
Sr
sK
BJ
eK
BJ
yL
zM
yL
ER
ne
ER
xN
JU
rl
jS
yL
yL
iB
iB
"}
(16,1,1) = {"
iB
iB
yL
Xq
mU
Bp
eC
BJ
pi
BJ
BJ
yL
JY
yL
ER
ER
wj
ER
gt
eU
Yq
Xq
yL
iB
iB
"}
(17,1,1) = {"
iB
iB
yL
Eq
mU
Bp
eC
eC
BJ
BJ
yL
yL
GE
yL
yL
ER
ER
eC
eC
eU
Fj
rs
yL
iB
iB
"}
(18,1,1) = {"
iB
iB
yL
yL
AX
bV
ZF
eC
gt
eC
yL
an
an
an
yL
eC
eC
eC
nR
qv
uW
yL
yL
iB
iB
"}
(19,1,1) = {"
iB
iB
iB
QJ
KM
KM
tS
XY
rw
rw
Wx
RT
RT
mQ
xY
RV
RV
RV
lv
an
an
eC
iB
iB
iB
"}
(20,1,1) = {"
iB
iB
iB
eC
eC
KM
zq
QY
tp
hb
jq
yO
jq
jq
ai
an
KM
KM
an
an
eC
eC
iB
iB
iB
"}
(21,1,1) = {"
iB
iB
iB
iB
eC
eC
yL
wZ
Lz
yL
yL
yL
yL
yL
yL
VU
an
du
yL
eC
eC
iB
iB
iB
iB
"}
(22,1,1) = {"
iB
iB
iB
iB
iB
iB
yL
yL
yL
yL
iB
iB
iH
nm
yL
yL
MX
yL
yL
iB
iB
iB
iB
iB
iB
"}
(23,1,1) = {"
iB
iB
iB
iB
iB
iB
iB
iB
iB
iB
iB
iB
iB
nm
yL
FW
FW
FW
iB
iB
iB
iB
iB
iB
iB
"}
