// This map has been converted using maphash
"aiD" = (/obj/structure/flora/rock/pile,/turf/open/floor/plating/asteroid,/area/ruin/space/has_grav/abandonedzoo)
"arG" = (/turf/template_noop,/area/template_noop)
"aww" = (/obj/structure/flora/ausbushes/lavendergrass,/turf/open/floor/grass,/area/ruin/space/has_grav/abandonedzoo)
"aAA" = (/obj/structure/flora/ausbushes/sparsegrass,/turf/open/floor/plating,/area/ruin/space/has_grav/abandonedzoo)
"aJN" = (/obj/machinery/door/airlock/external,/obj/effect/mapping_helpers/airlock/cyclelink_helper,/obj/effect/turf_decal/tile/green{dir = 1},/obj/effect/turf_decal/tile/green,/obj/effect/turf_decal/tile/green{dir = 4},/obj/effect/turf_decal/tile/green{dir = 8},/turf/open/floor/plasteel/dark,/area/ruin/space/has_grav/abandonedzoo)
"aSh" = (/obj/structure/table/reinforced,/obj/item/surgicaldrill,/obj/item/hemostat,/obj/item/scalpel,/obj/item/surgical_drapes,/obj/item/retractor,/obj/item/cautery,/obj/item/circular_saw,/obj/machinery/light,/turf/open/floor/plasteel/dark/side,/area/ruin/space/has_grav/abandonedzoo)
"aYs" = (/obj/structure/cable{icon_state = "4-8"},/obj/effect/turf_decal/tile/green{dir = 1},/obj/effect/turf_decal/tile/green,/obj/effect/turf_decal/tile/green{dir = 4},/obj/effect/turf_decal/tile/green{dir = 8},/turf/open/floor/plasteel/dark,/area/ruin/space/has_grav/abandonedzoo)
"aYF" = (/obj/structure/flora/rock,/obj/machinery/light,/turf/open/floor/plating/asteroid,/area/ruin/space/has_grav/abandonedzoo)
"ber" = (/obj/structure/chair/office/light{dir = 8},/obj/effect/turf_decal/tile/green{dir = 1},/obj/effect/turf_decal/tile/green,/obj/effect/turf_decal/tile/green{dir = 4},/obj/effect/turf_decal/tile/green{dir = 8},/turf/open/floor/plasteel/dark,/area/ruin/space/has_grav/abandonedzoo)
"bge" = (/obj/structure/table/reinforced,/obj/item/grenade/chem_grenade/antiweed{pixel_x = 3; pixel_y = 5},/obj/item/grenade/chem_grenade/antiweed{pixel_x = 4},/obj/item/grenade/chem_grenade/antiweed{pixel_x = -3; pixel_y = -1},/obj/machinery/light{dir = 1},/turf/open/floor/plasteel/dark/side,/area/ruin/space/has_grav/abandonedzoo)
"bkK" = (/turf/open/floor/plating,/area/ruin/space/has_grav/abandonedzoo)
"boT" = (/obj/structure/grille,/obj/item/shard{icon_state = "medium"},/obj/structure/cable{icon_state = "4-8"},/turf/open/floor/plating/airless,/area/ruin/space/has_grav/abandonedzoo)
"brl" = (/obj/machinery/door/airlock/external,/obj/effect/mapping_helpers/airlock/cyclelink_helper{dir = 1},/obj/effect/turf_decal/tile/green{dir = 1},/obj/effect/turf_decal/tile/green,/obj/effect/turf_decal/tile/green{dir = 4},/obj/effect/turf_decal/tile/green{dir = 8},/turf/open/floor/plasteel/dark,/area/ruin/space/has_grav/abandonedzoo)
"bAq" = (/obj/machinery/light/small{dir = 8},/obj/effect/turf_decal/tile/green{dir = 1},/obj/effect/turf_decal/tile/green,/obj/effect/turf_decal/tile/green{dir = 4},/obj/effect/turf_decal/tile/green{dir = 8},/turf/open/floor/plasteel/dark,/area/ruin/space/has_grav/abandonedzoo)
"bKy" = (/obj/effect/turf_decal/tile/green{dir = 1},/obj/effect/turf_decal/tile/green,/obj/effect/turf_decal/tile/green{dir = 4},/obj/effect/turf_decal/tile/green{dir = 8},/turf/open/floor/plasteel/dark,/area/ruin/space/has_grav/abandonedzoo)
"bOr" = (/obj/structure/table/reinforced,/obj/item/reagent_containers/glass/bottle/random_virus,/obj/item/reagent_containers/dropper,/turf/open/floor/plasteel/dark/side,/area/ruin/space/has_grav/abandonedzoo)
"bPi" = (/obj/structure/cable{icon_state = "4-8"},/obj/machinery/door/airlock/highsecurity{name = "Bio Containment"; req_one_access_txt = "47"},/turf/open/floor/plasteel/dark/side,/area/ruin/space/has_grav/abandonedzoo)
"bRe" = (/obj/machinery/smartfridge/chemistry,/turf/open/floor/plasteel/dark/side,/area/ruin/space/has_grav/abandonedzoo)
"bRJ" = (/obj/item/shard,/turf/template_noop,/area/template_noop)
"cjK" = (/obj/item/clothing/mask/facehugger/dead,/turf/open/floor/plating/airless,/area/ruin/space/has_grav/abandonedzoo)
"cva" = (/obj/effect/spawner/structure/window/reinforced,/turf/open/floor/plating,/area/ruin/space/has_grav/abandonedzoo)
"cAi" = (/obj/machinery/shieldwallgen{active = 2; anchored = 1; power = 1},/obj/structure/cable{icon_state = "1-8"},/obj/structure/cable,/turf/open/floor/plating/airless,/area/ruin/space/has_grav/abandonedzoo)
"cSC" = (/obj/structure/flora/ausbushes/brflowers,/turf/open/floor/grass,/area/ruin/space/has_grav/abandonedzoo)
"dqZ" = (/obj/machinery/shieldwallgen{active = 2; anchored = 1; power = 1},/obj/structure/cable{icon_state = "0-4"},/turf/open/floor/plating/airless,/area/ruin/space/has_grav/abandonedzoo)
"dTo" = (/mob/living/simple_animal/hostile/asteroid/goldgrub{will_burrow = 0},/turf/open/floor/plating/asteroid,/area/ruin/space/has_grav/abandonedzoo)
"ect" = (/obj/machinery/light/small{dir = 4},/obj/effect/turf_decal/tile/green{dir = 1},/obj/effect/turf_decal/tile/green,/obj/effect/turf_decal/tile/green{dir = 4},/obj/effect/turf_decal/tile/green{dir = 8},/turf/open/floor/plasteel/dark,/area/ruin/space/has_grav/abandonedzoo)
"esc" = (/obj/structure/lattice,/turf/template_noop,/area/space/nearstation)
"eQE" = (/obj/structure/grille/broken,/turf/open/floor/plating/airless,/area/ruin/space/has_grav/abandonedzoo)
"eTB" = (/obj/effect/spawner/structure/window/reinforced,/obj/structure/cable{icon_state = "4-8"},/turf/open/floor/plating,/area/ruin/space/has_grav/abandonedzoo)
"fbN" = (/obj/structure/flora/ausbushes/palebush,/turf/open/floor/plating,/area/ruin/space/has_grav/abandonedzoo)
"feR" = (/obj/effect/spawner/structure/window/reinforced,/obj/structure/cable{icon_state = "1-2"},/turf/open/floor/plating,/area/ruin/space/has_grav/abandonedzoo)
"fCL" = (/turf/closed/mineral,/area/ruin/space/has_grav/abandonedzoo)
"gBN" = (/obj/machinery/shieldwallgen{active = 2; anchored = 1; power = 1},/obj/structure/cable{icon_state = "4-8"},/obj/structure/cable{icon_state = "1-8"},/obj/structure/cable{icon_state = "0-8"},/turf/open/floor/plating,/area/ruin/space/has_grav/abandonedzoo)
"hdR" = (/obj/structure/table/reinforced,/obj/item/reagent_containers/food/snacks/carrotfries,/turf/open/floor/plasteel/dark/side,/area/ruin/space/has_grav/abandonedzoo)
"hnU" = (/obj/structure/disposalpipe/segment,/turf/closed/wall/r_wall,/area/ruin/space/has_grav/abandonedzoo)
"hoT" = (/obj/machinery/computer/operating{dir = 8},/turf/open/floor/plasteel/dark/side,/area/ruin/space/has_grav/abandonedzoo)
"hBI" = (/obj/structure/cable{icon_state = "4-8"},/turf/closed/wall/r_wall,/area/ruin/space/has_grav/abandonedzoo)
"hOs" = (/mob/living/simple_animal/hostile/poison/bees,/mob/living/simple_animal/hostile/poison/bees,/mob/living/simple_animal/hostile/poison/bees,/mob/living/simple_animal/hostile/poison/bees,/mob/living/simple_animal/hostile/poison/bees,/mob/living/simple_animal/hostile/poison/bees,/turf/open/floor/grass,/area/ruin/space/has_grav/abandonedzoo)
"hPS" = (/obj/machinery/shieldwallgen{active = 2; anchored = 1; power = 1},/obj/structure/cable{icon_state = "0-2"},/obj/structure/cable{icon_state = "1-2"},/obj/structure/cable{icon_state = "2-8"},/obj/structure/cable{icon_state = "2-4"},/turf/open/floor/plating,/area/ruin/space/has_grav/abandonedzoo)
"iiZ" = (/obj/structure/alien/weeds/node,/obj/machinery/light{dir = 1},/turf/open/floor/plating/airless,/area/ruin/space/has_grav/abandonedzoo)
"itt" = (/obj/structure/flora/ausbushes/leafybush,/mob/living/simple_animal/hostile/poison/bees,/turf/open/floor/grass,/area/ruin/space/has_grav/abandonedzoo)
"iAh" = (/turf/closed/wall/r_wall,/area/ruin/space/has_grav/abandonedzoo)
"iBe" = (/obj/structure/table/reinforced,/obj/machinery/microwave,/obj/structure/cable{icon_state = "4-8"},/turf/open/floor/plasteel/dark/side,/area/ruin/space/has_grav/abandonedzoo)
"iMV" = (/obj/structure/flora/ausbushes/reedbush,/turf/open/floor/plating,/area/ruin/space/has_grav/abandonedzoo)
"iWv" = (/obj/structure/table/reinforced,/obj/machinery/computer/med_data/laptop{dir = 8; pixel_y = 1},/obj/structure/cable{icon_state = "4-8"},/turf/open/floor/plasteel/dark/side,/area/ruin/space/has_grav/abandonedzoo)
"jwf" = (/obj/structure/table/reinforced,/obj/item/reagent_containers/hypospray/medipen/stimpack,/obj/item/reagent_containers/glass/bottle/mutagen,/turf/open/floor/plasteel/dark/side,/area/ruin/space/has_grav/abandonedzoo)
"jEu" = (/obj/structure/table/reinforced,/obj/item/clipboard,/obj/item/clothing/mask/surgical,/obj/item/razor,/obj/machinery/light{dir = 8},/turf/open/floor/plasteel/dark/side,/area/ruin/space/has_grav/abandonedzoo)
"jPx" = (/obj/structure/alien/weeds,/turf/open/floor/plating/airless,/area/ruin/space/has_grav/abandonedzoo)
"jSY" = (/obj/structure/table/reinforced,/obj/item/gun/syringe,/turf/open/floor/plasteel/dark/side,/area/ruin/space/has_grav/abandonedzoo)
"jWP" = (/mob/living/simple_animal/hostile/poison/bees,/turf/open/floor/grass,/area/ruin/space/has_grav/abandonedzoo)
"knb" = (/obj/machinery/shieldwallgen{active = 2; anchored = 1; power = 1},/obj/structure/cable{icon_state = "0-8"},/turf/open/floor/plating/airless,/area/ruin/space/has_grav/abandonedzoo)
"kuS" = (/obj/structure/table/reinforced,/obj/machinery/reagentgrinder,/turf/open/floor/plasteel/dark/side,/area/ruin/space/has_grav/abandonedzoo)
"kDV" = (/obj/structure/table/optable,/turf/open/floor/plasteel/dark/side,/area/ruin/space/has_grav/abandonedzoo)
"kXL" = (/obj/structure/table/reinforced,/obj/structure/cable{icon_state = "4-8"},/obj/item/gun/energy/floragun,/turf/open/floor/plasteel/dark/side,/area/ruin/space/has_grav/abandonedzoo)
"kYf" = (/turf/open/floor/plating/asteroid,/area/ruin/space/has_grav/abandonedzoo)
"leS" = (/obj/structure/disposalpipe/segment,/turf/open/floor/plating/airless,/area/space/nearstation)
"mBq" = (/obj/structure/flora/ausbushes/sunnybush,/turf/open/floor/plating,/area/ruin/space/has_grav/abandonedzoo)
"mCw" = (/turf/open/floor/plasteel/dark/side,/area/ruin/space/has_grav/abandonedzoo)
"nap" = (/obj/structure/table/reinforced,/obj/item/storage/box/syringes{pixel_x = 5; pixel_y = 5},/obj/item/storage/box/beakers,/obj/machinery/light{dir = 4},/turf/open/floor/plasteel/dark/side,/area/ruin/space/has_grav/abandonedzoo)
"nND" = (/obj/machinery/power/apc/unlocked{dir = 8; environ = 0; equipment = 0; lighting = 0; name = "Worn-out APC"; pixel_x = -25},/obj/structure/cable{icon_state = "0-4"},/obj/structure/rack,/obj/item/melee/baton/cattleprod,/obj/effect/spawner/lootdrop/maintenance,/turf/open/floor/plasteel/dark/side,/area/ruin/space/has_grav/abandonedzoo)
"nUH" = (/obj/structure/closet/wardrobe/science_white,/obj/structure/disposalpipe/segment,/turf/open/floor/plasteel/dark/side,/area/ruin/space/has_grav/abandonedzoo)
"opM" = (/obj/structure/table/reinforced,/obj/item/folder,/turf/open/floor/plasteel/dark/side,/area/ruin/space/has_grav/abandonedzoo)
"oQe" = (/obj/structure/disposalpipe/segment{dir = 6},/turf/closed/wall/r_wall,/area/ruin/space/has_grav/abandonedzoo)
"oWP" = (/obj/machinery/shieldwallgen{active = 2; anchored = 1; power = 1},/obj/structure/cable{icon_state = "0-2"},/obj/structure/cable{icon_state = "2-8"},/turf/open/floor/plating/airless,/area/ruin/space/has_grav/abandonedzoo)
"oXC" = (/obj/machinery/light/small{dir = 8},/turf/open/floor/plasteel/dark/side,/area/ruin/space/has_grav/abandonedzoo)
"pdt" = (/obj/structure/disposalpipe/trunk{dir = 1},/obj/structure/disposaloutlet,/turf/open/floor/plating/airless,/area/space/nearstation)
"phc" = (/obj/structure/cable{icon_state = "1-2"},/obj/effect/turf_decal/tile/green{dir = 1},/obj/effect/turf_decal/tile/green,/obj/effect/turf_decal/tile/green{dir = 4},/obj/effect/turf_decal/tile/green{dir = 8},/turf/open/floor/plasteel/dark,/area/ruin/space/has_grav/abandonedzoo)
"pBK" = (/obj/structure/flora/rock,/turf/open/floor/plating/asteroid,/area/ruin/space/has_grav/abandonedzoo)
"qbj" = (/obj/structure/reagent_dispensers/watertank,/obj/machinery/light,/turf/open/floor/plasteel/dark/side,/area/ruin/space/has_grav/abandonedzoo)
"qsm" = (/obj/machinery/shieldwallgen,/turf/template_noop,/area/template_noop)
"qte" = (/obj/machinery/shieldwallgen{active = 2; anchored = 1; power = 1},/obj/structure/cable{icon_state = "2-4"},/obj/structure/cable{icon_state = "0-2"},/turf/open/floor/plating/airless,/area/ruin/space/has_grav/abandonedzoo)
"qvM" = (/obj/structure/alien/resin/wall,/turf/open/floor/plating/airless,/area/ruin/space/has_grav/abandonedzoo)
"qDy" = (/obj/structure/table/reinforced,/obj/item/cultivator,/obj/item/shovel,/turf/open/floor/plasteel/dark/side,/area/ruin/space/has_grav/abandonedzoo)
"qDI" = (/obj/structure/bed,/obj/item/bedsheet/green,/obj/structure/disposalpipe/segment,/obj/structure/cable{icon_state = "4-8"},/turf/open/floor/plasteel/dark/side,/area/ruin/space/has_grav/abandonedzoo)
"qTW" = (/obj/structure/cable{icon_state = "4-8"},/obj/structure/cable{icon_state = "2-8"},/obj/structure/cable{icon_state = "0-8"},/obj/machinery/shieldwallgen,/turf/open/floor/plating,/area/ruin/space/has_grav/abandonedzoo)
"rum" = (/obj/structure/rack,/obj/item/crowbar,/obj/item/shield/riot,/obj/machinery/light{dir = 1},/turf/open/floor/plasteel/dark/side,/area/ruin/space/has_grav/abandonedzoo)
"rRt" = (/obj/structure/flora/ausbushes/genericbush,/turf/open/floor/grass,/area/ruin/space/has_grav/abandonedzoo)
"smU" = (/obj/structure/cable{icon_state = "0-8"},/obj/machinery/shieldwallgen,/turf/open/floor/plating/airless,/area/ruin/space/has_grav/abandonedzoo)
"sFL" = (/obj/structure/cable{icon_state = "2-8"},/obj/structure/cable{icon_state = "1-2"},/obj/structure/rack,/obj/item/clothing/suit/space/hardsuit/medical,/obj/item/tank/internals/emergency_oxygen/double,/turf/open/floor/plasteel/dark/side,/area/ruin/space/has_grav/abandonedzoo)
"sQa" = (/obj/item/stack/cable_coil/cut/red,/obj/item/stack/tile/plasteel{pixel_x = 3; pixel_y = -4},/obj/item/wirecutters,/turf/open/floor/plating,/area/ruin/space/has_grav/abandonedzoo)
"sSc" = (/obj/machinery/space_heater,/obj/structure/disposalpipe/segment{dir = 9},/obj/machinery/light{dir = 8},/turf/open/floor/plasteel/dark/side,/area/ruin/space/has_grav/abandonedzoo)
"sSi" = (/obj/structure/window/reinforced{dir = 4},/obj/structure/lattice,/turf/template_noop,/area/space/nearstation)
"sUi" = (/obj/machinery/light/small{dir = 4},/turf/open/floor/plasteel/dark/side,/area/ruin/space/has_grav/abandonedzoo)
"tbv" = (/obj/structure/reagent_dispensers/fueltank,/turf/open/floor/plasteel/dark/side,/area/ruin/space/has_grav/abandonedzoo)
"tdL" = (/obj/machinery/disposal/bin,/obj/structure/disposalpipe/trunk,/turf/open/floor/plasteel/dark/side,/area/ruin/space/has_grav/abandonedzoo)
"teL" = (/turf/open/floor/plating/airless,/area/ruin/space/has_grav/abandonedzoo)
"tmr" = (/obj/item/shard,/turf/open/floor/plating/airless,/area/ruin/space/has_grav/abandonedzoo)
"tFE" = (/obj/structure/window/reinforced{dir = 8},/obj/structure/lattice,/turf/template_noop,/area/space/nearstation)
"tMF" = (/mob/living/simple_animal/crab{faction = list("carp")},/turf/open/floor/plating,/area/ruin/space/has_grav/abandonedzoo)
"tPT" = (/obj/structure/table/reinforced,/obj/item/gun/energy/temperature{pin = /obj/item/firing_pin},/turf/open/floor/plasteel/dark/side,/area/ruin/space/has_grav/abandonedzoo)
"ugJ" = (/obj/machinery/light,/mob/living/simple_animal/hostile/poison/bees,/turf/open/floor/grass,/area/ruin/space/has_grav/abandonedzoo)
"uuD" = (/obj/structure/cable{icon_state = "1-4"},/obj/structure/cable,/obj/machinery/shieldwallgen,/turf/open/floor/plating/airless,/area/ruin/space/has_grav/abandonedzoo)
"vmc" = (/obj/machinery/power/smes/magical{desc = "A high-capacity superconducting magnetic energy storage (SMES) unit."; name = "power storage unit"},/obj/structure/cable,/obj/structure/cable{icon_state = "1-2"},/turf/open/floor/plasteel/dark/side,/area/ruin/space/has_grav/abandonedzoo)
"vvo" = (/obj/structure/cable{icon_state = "1-2"},/turf/closed/wall/r_wall,/area/ruin/space/has_grav/abandonedzoo)
"vKE" = (/obj/structure/grille/broken,/obj/item/shard{icon_state = "small"},/turf/open/floor/plating/airless,/area/ruin/space/has_grav/abandonedzoo)
"vMX" = (/obj/machinery/door/airlock/hatch{name = "Bio-Research Station"},/obj/effect/turf_decal/tile/green{dir = 1},/obj/effect/turf_decal/tile/green,/obj/effect/turf_decal/tile/green{dir = 4},/obj/effect/turf_decal/tile/green{dir = 8},/turf/open/floor/plasteel/dark,/area/ruin/space/has_grav/abandonedzoo)
"wdZ" = (/obj/machinery/shieldwallgen{active = 2; anchored = 1; power = 1},/obj/structure/cable{icon_state = "1-2"},/obj/structure/cable{icon_state = "1-8"},/obj/structure/cable,/obj/structure/cable{icon_state = "1-4"},/turf/open/floor/plating,/area/ruin/space/has_grav/abandonedzoo)
"wiU" = (/obj/structure/flora/ausbushes/grassybush,/turf/open/floor/grass,/area/ruin/space/has_grav/abandonedzoo)
"wtR" = (/obj/structure/flora/ausbushes/ywflowers,/turf/open/floor/grass,/area/ruin/space/has_grav/abandonedzoo)
"wyW" = (/obj/machinery/light{dir = 1},/mob/living/simple_animal/hostile/carp,/turf/open/floor/plating,/area/ruin/space/has_grav/abandonedzoo)
"wEf" = (/obj/structure/flora/ausbushes/ppflowers,/turf/open/floor/grass,/area/ruin/space/has_grav/abandonedzoo)
"wRH" = (/obj/machinery/power/terminal,/obj/structure/cable{icon_state = "1-2"},/obj/effect/turf_decal/tile/green{dir = 1},/obj/effect/turf_decal/tile/green,/obj/effect/turf_decal/tile/green{dir = 4},/obj/effect/turf_decal/tile/green{dir = 8},/turf/open/floor/plasteel/dark,/area/ruin/space/has_grav/abandonedzoo)
"xQM" = (/mob/living/simple_animal/hostile/asteroid/basilisk,/turf/open/floor/plating/asteroid,/area/ruin/space/has_grav/abandonedzoo)

(1,1,1) = {"
dqZ
cva
cva
cva
cva
dqZ
arG
arG
arG
arG
arG
arG
dqZ
cva
cva
cva
cva
dqZ
arG
"}
(2,1,1) = {"
eTB
fCL
kYf
aiD
fCL
eTB
sSi
sSi
sSi
sSi
sSi
sSi
eTB
mBq
bkK
iMV
bkK
eTB
arG
"}
(3,1,1) = {"
eTB
fCL
dTo
kYf
kYf
bPi
mCw
sUi
mCw
mCw
sUi
mCw
bPi
bkK
bkK
tMF
bkK
eTB
arG
"}
(4,1,1) = {"
eTB
kYf
fCL
kYf
aYF
eTB
iAh
iAh
vMX
vMX
iAh
iAh
eTB
wyW
bkK
bkK
bkK
eTB
arG
"}
(5,1,1) = {"
eTB
pBK
kYf
xQM
aiD
eTB
iAh
nND
bKy
bKy
tbv
iAh
eTB
fbN
aAA
bkK
bkK
eTB
arG
"}
(6,1,1) = {"
oWP
feR
feR
feR
feR
hPS
vvo
sFL
phc
wRH
vmc
vvo
wdZ
feR
feR
feR
feR
cAi
arG
"}
(7,1,1) = {"
arG
arG
arG
iAh
iAh
hBI
iAh
rum
bKy
bKy
qbj
iAh
hBI
oQe
hnU
leS
leS
pdt
arG
"}
(8,1,1) = {"
arG
arG
arG
cva
jEu
kXL
opM
bRe
bKy
bKy
tdL
nUH
qDI
sSc
iAh
iAh
iAh
arG
arG
"}
(9,1,1) = {"
arG
arG
arG
cva
bKy
aYs
ber
bKy
bKy
bKy
bKy
bKy
aYs
bKy
aJN
bAq
brl
arG
arG
"}
(10,1,1) = {"
arG
arG
arG
cva
bKy
aYs
bKy
bKy
bKy
bKy
bKy
bKy
sQa
bKy
aJN
ect
brl
arG
arG
"}
(11,1,1) = {"
arG
arG
arG
cva
nap
iWv
bOr
jSY
bKy
bKy
jwf
hdR
iBe
kuS
iAh
iAh
iAh
arG
arG
"}
(12,1,1) = {"
arG
arG
arG
iAh
iAh
hBI
iAh
bge
bKy
bKy
aSh
iAh
hBI
iAh
iAh
arG
arG
arG
arG
"}
(13,1,1) = {"
qte
feR
feR
feR
feR
gBN
iAh
tPT
bKy
bKy
kDV
iAh
qTW
feR
feR
feR
feR
uuD
arG
"}
(14,1,1) = {"
eTB
rRt
jWP
jWP
wtR
eTB
iAh
qDy
bKy
bKy
hoT
iAh
eTB
jPx
jPx
cjK
qvM
eTB
arG
"}
(15,1,1) = {"
eTB
hOs
hOs
aww
ugJ
eTB
iAh
iAh
vMX
vMX
iAh
iAh
eTB
iiZ
qvM
qvM
teL
boT
arG
"}
(16,1,1) = {"
eTB
jWP
wiU
itt
hOs
bPi
mCw
oXC
mCw
mCw
oXC
mCw
bPi
cjK
jPx
teL
tmr
eQE
bRJ
"}
(17,1,1) = {"
eTB
aww
jWP
cSC
wEf
eTB
tFE
tFE
tFE
tFE
tFE
tFE
eTB
jPx
jPx
teL
teL
esc
arG
"}
(18,1,1) = {"
knb
cva
cva
cva
cva
knb
arG
arG
arG
arG
arG
arG
smU
cva
cva
vKE
esc
arG
arG
"}
(19,1,1) = {"
arG
arG
arG
arG
arG
arG
arG
arG
arG
arG
arG
arG
arG
arG
arG
arG
arG
qsm
arG
"}
