//MAP CONVERTED BY dmm2tgm.py THIS HEADER COMMENT PREVENTS RECONVERSION, DO NOT REMOVE
"a" = (
/obj/machinery/computer/arcade,
/turf/open/floor/wood/airless,
/area/ruin/space/assistantpod)
"c" = (
/obj/structure/grille/broken,
/obj/effect/decal/cleanable/insectguts,
/turf/open/floor/plating/airless,
/area/ruin/space/assistantpod)
"d" = (
/obj/structure/lattice,
/obj/item/shard,
/turf/template_noop,
/area/template_noop)
"e" = (
/obj/structure/lattice,
/turf/template_noop,
/area/template_noop)
"f" = (
/obj/item/trash/floursack,
/turf/open/floor/wood/airless,
/area/ruin/space/assistantpod)
"g" = (
/obj/structure/bookcase/random/fiction,
/turf/open/floor/wood/airless,
/area/ruin/space/assistantpod)
"h" = (
/obj/item/card/id/gold{
	access = list("Maintenance");
	access_txt = "Mainenance";
	assignment = "Assistant";
	pixel_x = -4;
	pixel_y = -1
	},
/obj/structure/sign/poster/contraband/grey_tide{
	pixel_x = 26;
	pixel_y = 1
	},
/turf/open/floor/plating/airless,
/area/ruin/space/assistantpod)
"j" = (
/obj/structure/chair/stool,
/obj/effect/decal/cleanable/blood/gibs/old,
/obj/effect/decal/cleanable/dirt/dust,
/turf/open/floor/wood/airless,
/area/ruin/space/assistantpod)
"k" = (
/obj/item/trash/popcorn,
/obj/effect/decal/cleanable/generic,
/turf/open/floor/plasteel/dark/airless,
/area/ruin/space/assistantpod)
"l" = (
/obj/item/pickaxe/emergency,
/turf/template_noop,
/area/template_noop)
"m" = (
/obj/item/book/manual/wiki/engineering_hacking,
/turf/open/floor/carpet{
	initial_gas_mix = "TEMP=2.7"
	},
/area/ruin/space/assistantpod)
"n" = (
/obj/effect/decal/cleanable/dirt/dust,
/obj/item/card/emagfake,
/turf/open/floor/plasteel/dark/airless,
/area/ruin/space/assistantpod)
"o" = (
/obj/structure/window/reinforced/spawner/east,
/obj/structure/shuttle/engine/heater{
	dir = 8
	},
/obj/structure/window/reinforced/spawner/east{
	dir = 2
	},
/obj/structure/window/reinforced/spawner/east{
	dir = 1
	},
/turf/open/floor/plating/airless,
/area/ruin/space/assistantpod)
"p" = (
/obj/structure/sign/poster/contraband/lusty_xenomorph,
/turf/closed/wall/mineral/plastitanium,
/area/ruin/space/assistantpod)
"q" = (
/obj/structure/grille,
/obj/effect/spawner/structure/window/hollow/reinforced,
/turf/open/floor/plating/airless,
/area/ruin/space/assistantpod)
"r" = (
/mob/living/simple_animal/hostile/carp,
/turf/template_noop,
/area/template_noop)
"s" = (
/obj/item/stack/sheet/metal,
/turf/template_noop,
/area/template_noop)
"u" = (
/obj/structure/bed,
/obj/effect/decal/cleanable/cobweb/cobweb2,
/obj/item/bedsheet/grey,
/turf/open/floor/carpet{
	initial_gas_mix = "TEMP=2.7"
	},
/area/ruin/space/assistantpod)
"v" = (
/obj/structure/table/wood/fancy/exoticpurple,
/obj/item/bikehorn/golden{
	pixel_x = -6;
	pixel_y = 8
	},
/obj/item/toy/figure/assistant{
	pixel_x = 73;
	pixel_y = 2
	},
/turf/open/floor/plasteel/dark/airless,
/area/ruin/space/assistantpod)
"w" = (
/turf/closed/wall/mineral/plastitanium,
/area/ruin/space/assistantpod)
"y" = (
/obj/structure/bed,
/obj/item/bedsheet/clown,
/turf/open/floor/carpet{
	initial_gas_mix = "TEMP=2.7"
	},
/area/ruin/space/assistantpod)
"z" = (
/obj/structure/door_assembly/door_assembly_hatch,
/obj/effect/decal/cleanable/glass,
/turf/open/floor/plasteel/dark/airless,
/area/ruin/space/assistantpod)
"B" = (
/turf/template_noop,
/area/template_noop)
"C" = (
/obj/structure/window/reinforced/spawner/east,
/obj/structure/window/reinforced/spawner/east{
	dir = 2
	},
/obj/structure/window/reinforced/spawner/east{
	dir = 1
	},
/obj/structure/shuttle/engine/heater{
	dir = 8
	},
/turf/open/floor/plating/airless,
/area/ruin/space/assistantpod)
"E" = (
/obj/structure/statue/sandstone/assistant,
/turf/open/floor/carpet{
	initial_gas_mix = "TEMP=2.7"
	},
/area/ruin/space/assistantpod)
"G" = (
/obj/structure/table/wood/poker,
/obj/item/toy/cards/cardhand{
	pixel_x = -5;
	pixel_y = 8
	},
/obj/item/toy/cards/deck{
	pixel_x = 2;
	pixel_y = 1
	},
/obj/item/radio{
	pixel_x = 11;
	pixel_y = 14
	},
/turf/open/floor/wood/airless,
/area/ruin/space/assistantpod)
"H" = (
/turf/open/floor/plating/asteroid/airless,
/area/ruin/space/assistantpod)
"J" = (
/obj/structure/shuttle/engine/propulsion{
	dir = 8
	},
/turf/template_noop,
/area/template_noop)
"L" = (
/obj/effect/decal/cleanable/vomit/old,
/turf/open/floor/wood/airless,
/area/ruin/space/assistantpod)
"M" = (
/obj/structure/chair/stool,
/obj/effect/decal/cleanable/blood/old,
/obj/item/paper/crumpled/bloody/fluff{
	text = "It's too late... the clown and I were happy living out here, but I guess nothing can be perfect forever, huh? We are running out of snacks, and we are stranded here without EVA suits... we have heard over the radio that there has been a massive carp migration, I just hope we can hold out for long enough..."
	},
/turf/open/floor/wood/airless,
/area/ruin/space/assistantpod)
"N" = (
/turf/closed/mineral/random,
/area/ruin/space/assistantpod)
"O" = (
/obj/structure/shuttle/engine/propulsion{
	dir = 8
	},
/turf/open/floor/plating/asteroid/airless,
/area/ruin/space/assistantpod)
"P" = (
/obj/structure/closet/secure_closet/freezer/fridge/open,
/obj/item/reagent_containers/food/snacks/pie/plain,
/obj/item/reagent_containers/food/snacks/meat/slab/spider{
	pixel_x = -5;
	pixel_y = 6
	},
/obj/item/reagent_containers/food/snacks/meat/slab/monkey{
	pixel_x = 5;
	pixel_y = -4
	},
/obj/effect/decal/cleanable/food/flour,
/turf/open/floor/plasteel/freezer/airless,
/area/ruin/space/assistantpod)
"Q" = (
/obj/structure/table/wood/fancy/royalblue,
/obj/item/toy/figure/clown{
	pixel_x = -8;
	pixel_y = 2
	},
/turf/open/floor/plating/airless,
/area/ruin/space/assistantpod)
"R" = (
/obj/effect/mob_spawn/human/clown/corpse,
/turf/template_noop,
/area/template_noop)
"S" = (
/obj/effect/decal/cleanable/dirt/dust,
/mob/living/simple_animal/bot/honkbot{
	on = 0
	},
/turf/open/floor/wood/airless,
/area/ruin/space/assistantpod)
"U" = (
/obj/structure/table/wood/fancy/exoticblue,
/obj/item/storage/toolbox/mechanical/old{
	pixel_y = 6
	},
/obj/structure/sign/poster/contraband/clown{
	pixel_x = -27
	},
/turf/open/floor/plating/airless,
/area/ruin/space/assistantpod)
"V" = (
/obj/effect/decal/cleanable/ash,
/obj/effect/decal/cleanable/blood/old,
/obj/item/clothing/gloves/color/yellow,
/turf/open/floor/plating/airless,
/area/ruin/space/assistantpod)
"W" = (
/obj/structure/table,
/obj/machinery/microwave,
/turf/open/floor/plasteel/freezer/airless,
/area/ruin/space/assistantpod)
"X" = (
/obj/effect/mob_spawn/human/corpse/assistant,
/obj/effect/decal/cleanable/blood/gibs/old,
/turf/open/floor/carpet{
	initial_gas_mix = "TEMP=2.7"
	},
/area/ruin/space/assistantpod)
"Y" = (
/obj/item/shard,
/turf/template_noop,
/area/template_noop)
"Z" = (
/obj/effect/decal/cleanable/blood/old,
/turf/open/floor/plasteel/dark/airless,
/area/ruin/space/assistantpod)

(1,1,1) = {"
B
B
B
B
B
B
B
B
B
B
B
B
B
B
B
B
B
B
B
B
"}
(2,1,1) = {"
B
B
B
B
B
B
B
B
B
B
B
B
B
B
B
B
B
B
B
B
"}
(3,1,1) = {"
B
B
B
B
B
B
B
B
B
B
B
B
B
B
B
B
B
B
B
B
"}
(4,1,1) = {"
B
B
B
B
B
B
B
B
B
B
B
B
B
B
B
s
B
B
B
B
"}
(5,1,1) = {"
B
B
B
B
B
B
B
B
B
B
B
Y
B
r
B
B
B
B
B
B
"}
(6,1,1) = {"
B
B
B
B
B
B
H
H
B
B
B
B
B
B
B
B
B
B
B
B
"}
(7,1,1) = {"
B
B
B
B
B
N
N
O
H
J
B
B
R
B
B
B
B
e
B
B
"}
(8,1,1) = {"
B
B
B
B
B
N
N
C
w
o
w
B
B
B
B
B
B
B
B
B
"}
(9,1,1) = {"
B
B
B
B
B
N
g
k
U
v
w
B
e
B
B
B
r
B
B
B
"}
(10,1,1) = {"
B
B
B
B
N
N
a
M
n
Z
z
B
B
B
B
B
B
B
B
B
"}
(11,1,1) = {"
B
B
B
B
N
W
L
G
S
Q
w
B
B
d
e
B
B
B
B
B
"}
(12,1,1) = {"
B
B
B
B
N
P
f
j
V
p
w
B
B
B
B
B
B
B
B
B
"}
(13,1,1) = {"
B
B
B
B
N
N
N
E
X
m
q
B
B
B
B
B
B
B
B
B
"}
(14,1,1) = {"
B
B
B
B
N
N
N
u
y
h
c
B
B
l
B
B
d
B
B
B
"}
(15,1,1) = {"
B
B
B
B
B
B
N
N
N
w
N
B
e
B
r
B
B
B
B
B
"}
(16,1,1) = {"
B
B
B
B
B
B
B
B
N
N
B
B
B
e
B
B
B
B
B
B
"}
(17,1,1) = {"
B
B
B
B
B
B
B
B
B
B
B
B
B
B
B
B
B
B
B
B
"}
(18,1,1) = {"
B
B
B
B
B
B
B
B
B
B
B
B
B
B
B
B
B
B
B
B
"}
(19,1,1) = {"
B
B
B
B
B
B
B
B
B
B
B
B
B
B
B
B
B
B
B
B
"}
(20,1,1) = {"
B
B
B
B
B
B
B
B
B
B
B
B
B
B
B
B
B
B
B
B
"}
