//MAP CONVERTED BY dmm2tgm.py THIS HEADER COMMENT PREVENTS RECONVERSION, DO NOT REMOVE
"a" = (
/turf/template_noop,
/area/template_noop)
"b" = (
/turf/open/misc/asteroid/airless,
/area/ruin/space)
"c" = (
/turf/closed/mineral/random,
/area/ruin/space)
"d" = (
/turf/closed/mineral/random/high_chance,
/area/ruin/space)
"l" = (
/obj/effect/spawner/random/maintenance,
/turf/open/misc/asteroid/airless,
/area/ruin/space)
"H" = (
/obj/effect/spawner/random/trash/garbage,
/turf/open/misc/asteroid/airless,
/area/ruin/space)
"N" = (
/obj/effect/spawner/random/maintenance,
/turf/closed/mineral/random,
/area/ruin/space)
"X" = (
/obj/effect/spawner/random/trash/graffiti,
/turf/open/misc/asteroid/airless,
/area/ruin/space)

(1,1,1) = {"
a
a
a
a
a
a
a
a
a
a
a
a
a
a
a
a
b
a
"}
(2,1,1) = {"
a
a
a
l
b
b
b
a
a
a
a
a
a
a
a
a
a
a
"}
(3,1,1) = {"
a
a
b
b
b
b
b
a
b
b
b
b
a
a
a
a
a
a
"}
(4,1,1) = {"
a
b
b
b
b
b
b
b
b
b
b
X
b
a
a
b
a
a
"}
(5,1,1) = {"
a
b
b
b
c
c
c
c
b
b
b
b
b
b
a
a
a
a
"}
(6,1,1) = {"
b
b
b
b
c
c
c
c
d
d
d
d
d
b
a
a
a
a
"}
(7,1,1) = {"
b
b
b
c
c
c
c
c
d
d
d
d
d
H
b
b
a
a
"}
(8,1,1) = {"
b
b
c
c
c
c
d
c
c
c
c
c
c
b
b
b
a
a
"}
(9,1,1) = {"
b
b
b
c
c
c
d
c
c
c
c
d
d
d
c
b
b
a
"}
(10,1,1) = {"
a
b
b
b
c
c
d
d
c
N
d
d
c
c
c
b
b
a
"}
(11,1,1) = {"
a
X
b
b
c
c
c
d
d
d
d
d
c
c
c
b
b
a
"}
(12,1,1) = {"
a
a
b
b
d
d
c
d
d
d
d
c
c
c
b
c
b
a
"}
(13,1,1) = {"
a
a
b
b
d
d
d
c
c
c
c
c
c
c
c
c
b
b
"}
(14,1,1) = {"
a
a
b
b
b
b
b
c
c
c
c
c
c
d
c
c
c
b
"}
(15,1,1) = {"
a
a
a
a
b
b
l
c
d
c
c
d
d
d
c
c
c
b
"}
(16,1,1) = {"
a
a
a
a
a
a
b
b
b
c
c
d
d
d
b
b
b
b
"}
(17,1,1) = {"
a
b
a
a
a
a
b
b
H
b
b
b
b
b
b
b
a
a
"}
(18,1,1) = {"
a
b
b
a
a
a
a
a
b
b
b
b
b
b
b
a
a
a
"}
(19,1,1) = {"
a
a
a
a
a
a
a
a
b
b
b
b
b
b
l
a
a
a
"}
(20,1,1) = {"
b
a
a
a
a
a
a
a
a
a
a
a
a
a
a
a
a
a
"}
