//MAP CONVERTED BY dmm2tgm.py THIS HEADER COMMENT PREVENTS RECONVERSION, DO NOT REMOVE
"a" = (
/turf/template_noop,
/area/template_noop)
"b" = (
/turf/closed/mineral/random,
/area/ruin/space/has_grav)
"c" = (
/turf/closed/mineral/random/high_chance,
/area/ruin/space/has_grav)
"d" = (
/turf/open/misc/asteroid/airless,
/area/ruin/space/has_grav)
"e" = (
/obj/effect/spawner/random/maintenance,
/turf/open/misc/asteroid/airless,
/area/ruin/space/has_grav)
"m" = (
/obj/effect/spawner/random/trash/garbage,
/turf/closed/mineral/random/high_chance,
/area/ruin/space/has_grav)
"s" = (
/obj/effect/spawner/random/maintenance,
/turf/closed/mineral/random,
/area/ruin/space/has_grav)
"x" = (
/obj/effect/spawner/random/trash/soap,
/turf/open/misc/asteroid/airless,
/area/ruin/space/has_grav)
"F" = (
/obj/effect/spawner/random/trash/garbage,
/turf/open/misc/asteroid/airless,
/area/ruin/space/has_grav)
"H" = (
/obj/effect/spawner/random/trash/graffiti,
/turf/open/misc/asteroid/airless,
/area/ruin/space/has_grav)
"K" = (
/obj/effect/spawner/random/maintenance/two,
/turf/open/misc/asteroid/airless,
/area/ruin/space/has_grav)

(1,1,1) = {"
a
a
a
a
a
a
a
a
a
a
a
a
a
a
a
a
a
a
a
a
a
a
a
a
a
a
a
a
a
a
b
c
c
c
a
a
a
a
"}
(2,1,1) = {"
a
a
a
a
a
a
a
a
a
a
a
a
a
a
a
a
a
a
a
a
a
a
a
a
a
a
a
a
a
a
b
c
c
c
c
b
a
a
"}
(3,1,1) = {"
a
a
a
a
a
b
b
c
c
a
a
a
a
a
a
a
a
a
a
a
a
a
a
a
a
a
a
a
d
d
d
b
c
c
c
b
b
b
"}
(4,1,1) = {"
a
a
a
a
a
b
b
b
b
b
a
a
a
a
a
a
a
a
a
a
a
a
a
a
a
a
d
d
d
d
d
b
b
b
b
b
b
b
"}
(5,1,1) = {"
a
a
a
c
c
c
b
b
b
b
b
b
b
a
a
a
a
a
a
a
a
a
a
a
a
a
d
F
d
d
d
b
b
b
b
b
b
b
"}
(6,1,1) = {"
a
a
a
c
c
c
c
b
s
b
b
b
b
c
c
c
a
a
a
a
a
a
a
a
b
b
d
d
d
d
b
b
b
b
b
b
b
b
"}
(7,1,1) = {"
a
a
a
c
c
c
c
b
b
b
b
b
b
c
c
c
a
a
a
a
a
a
a
b
d
d
H
d
b
c
c
c
c
b
b
b
b
b
"}
(8,1,1) = {"
a
a
b
c
c
c
b
b
b
d
d
F
d
b
b
b
a
a
a
a
a
a
a
d
d
d
b
b
b
c
c
c
c
b
b
c
c
a
"}
(9,1,1) = {"
a
a
b
b
b
b
s
d
d
d
d
d
d
d
d
b
a
a
a
a
a
a
b
d
d
b
b
b
b
c
c
c
c
b
b
c
c
a
"}
(10,1,1) = {"
a
b
b
b
b
b
c
d
d
d
a
a
d
d
d
c
a
a
a
a
a
a
d
d
x
b
c
c
c
c
c
c
c
b
b
b
b
a
"}
(11,1,1) = {"
a
b
b
b
b
b
d
d
a
a
a
a
d
d
d
b
a
a
a
a
a
a
d
d
b
b
c
c
c
c
d
d
d
b
b
b
a
a
"}
(12,1,1) = {"
a
b
s
b
b
d
H
a
a
a
a
a
a
a
a
a
a
a
a
a
a
a
d
d
c
c
c
d
d
d
d
d
d
b
b
b
b
a
"}
(13,1,1) = {"
a
b
b
b
c
d
d
a
a
a
a
a
a
a
a
a
a
a
a
a
a
b
d
d
c
c
b
d
d
c
d
d
d
b
b
b
b
a
"}
(14,1,1) = {"
a
b
b
b
c
d
a
a
a
a
a
a
a
a
a
a
a
a
a
a
a
d
d
b
c
c
b
d
d
b
d
d
d
b
b
b
b
a
"}
(15,1,1) = {"
b
b
b
d
d
d
a
a
a
a
a
b
a
a
a
a
a
a
a
a
a
d
d
b
c
c
b
b
b
b
d
d
d
b
b
b
b
a
"}
(16,1,1) = {"
b
b
b
K
d
d
a
a
a
a
a
a
a
a
a
a
a
a
a
a
a
d
d
b
c
c
b
b
d
d
d
d
d
b
b
b
b
b
"}
(17,1,1) = {"
b
b
b
d
d
d
a
a
a
a
a
a
a
a
a
b
b
b
a
a
a
d
d
b
b
b
b
b
d
d
d
d
b
b
b
b
c
c
"}
(18,1,1) = {"
c
c
d
d
d
a
a
b
b
a
a
a
a
a
a
b
b
b
b
a
a
H
d
b
b
b
b
d
d
d
c
b
b
c
c
b
c
c
"}
(19,1,1) = {"
c
c
d
d
d
a
a
b
b
b
a
a
a
a
b
b
c
c
b
a
a
b
d
b
b
b
b
d
d
d
b
b
b
c
c
b
c
c
"}
(20,1,1) = {"
c
c
d
d
d
a
a
b
b
b
a
a
a
a
b
b
b
a
a
a
a
b
d
d
K
b
b
d
d
d
d
b
b
b
b
b
c
c
"}
(21,1,1) = {"
c
c
b
d
d
a
a
a
a
a
a
a
a
a
a
a
a
a
a
a
a
b
d
d
d
c
c
c
b
d
d
b
b
b
b
b
b
b
"}
(22,1,1) = {"
b
b
b
d
d
a
a
a
a
a
a
a
a
a
a
a
a
a
a
a
a
a
F
d
d
m
c
c
b
d
d
b
b
b
b
b
b
b
"}
(23,1,1) = {"
a
b
b
d
d
d
a
a
a
a
a
a
a
a
b
a
a
a
a
a
a
a
a
a
d
d
d
d
d
d
d
b
b
b
b
b
b
a
"}
(24,1,1) = {"
a
b
b
c
d
d
d
d
a
a
a
a
a
a
a
a
a
a
a
a
a
a
a
a
b
c
d
d
d
d
d
b
b
b
b
b
b
a
"}
(25,1,1) = {"
a
b
b
b
b
d
d
d
a
a
a
a
a
a
a
a
a
a
a
a
a
a
a
a
a
a
d
d
d
d
d
c
c
b
a
a
a
a
"}
(26,1,1) = {"
a
b
b
b
b
F
d
d
a
a
a
a
a
a
a
a
a
a
a
a
a
a
a
a
a
a
a
a
a
a
a
a
a
a
a
a
a
a
"}
(27,1,1) = {"
a
b
b
c
c
b
b
b
a
a
a
b
b
a
a
a
a
a
a
a
a
b
a
a
a
a
a
a
a
a
a
a
a
a
a
a
a
a
"}
(28,1,1) = {"
a
a
b
c
c
b
b
b
b
b
b
b
b
a
a
a
a
d
d
d
b
b
b
a
a
a
a
a
a
a
a
a
a
a
a
a
a
a
"}
(29,1,1) = {"
a
a
a
a
a
a
b
b
b
b
b
a
a
a
a
a
a
d
d
d
c
b
b
a
a
a
a
a
a
a
a
a
a
a
a
a
a
a
"}
(30,1,1) = {"
a
a
a
a
a
a
a
a
a
a
a
a
a
a
a
a
a
d
d
d
b
b
b
b
b
b
a
a
a
a
a
a
a
a
a
a
a
a
"}
(31,1,1) = {"
a
a
a
a
a
a
a
a
a
a
a
a
a
a
a
d
d
d
d
d
b
b
b
b
b
b
b
a
a
a
a
a
a
a
a
a
a
a
"}
(32,1,1) = {"
a
a
a
a
a
a
a
a
a
a
a
a
a
a
a
d
d
d
b
b
b
b
b
b
b
b
c
a
a
a
a
a
a
a
a
a
a
a
"}
(33,1,1) = {"
a
a
a
a
a
a
a
a
a
a
a
a
a
a
d
d
d
d
H
d
d
c
c
c
b
b
c
b
a
a
a
a
a
a
a
b
b
a
"}
(34,1,1) = {"
a
a
a
a
a
a
a
a
a
a
a
a
a
a
d
e
d
d
d
d
d
d
e
d
b
b
b
b
a
a
a
a
a
a
b
b
b
a
"}
(35,1,1) = {"
a
a
a
a
a
a
a
a
a
a
a
b
b
b
d
d
d
b
b
b
d
d
d
d
b
b
b
c
a
a
a
a
a
b
b
b
b
a
"}
(36,1,1) = {"
a
a
a
a
a
a
a
a
a
a
b
c
c
c
b
b
b
b
b
b
b
d
d
b
b
b
a
a
a
a
a
a
a
b
b
b
a
a
"}
(37,1,1) = {"
a
a
a
a
a
a
a
a
a
b
c
c
c
c
b
b
b
b
b
b
c
c
b
b
b
b
a
a
a
a
a
a
a
a
a
a
a
a
"}
(38,1,1) = {"
a
a
a
a
a
a
a
a
a
a
a
c
c
c
b
a
a
a
b
b
b
b
b
a
a
a
a
a
a
a
a
a
a
a
a
a
a
a
"}
