// This map has been converted using maphash
"arG" = (/turf/template_noop,/area/template_noop)
"aMQ" = (/turf/closed/mineral,/area/ruin/unpowered/no_grav)
"ilK" = (/turf/open/floor/plating/asteroid/airless,/area/ruin/unpowered/no_grav)
"vmk" = (/obj/effect/decal/remains/human,/turf/open/floor/plating/asteroid/airless,/area/ruin/unpowered/no_grav)
"vvW" = (/obj/item/pickaxe/diamond,/turf/open/floor/plating/asteroid/airless,/area/ruin/unpowered/no_grav)
"xxg" = (/turf/closed/mineral/random/high_chance,/area/ruin/unpowered/no_grav)

(1,1,1) = {"
arG
arG
ilK
arG
arG
arG
arG
arG
ilK
aMQ
aMQ
aMQ
aMQ
ilK
arG
arG
arG
arG
"}
(2,1,1) = {"
arG
arG
arG
arG
arG
arG
arG
ilK
ilK
xxg
xxg
aMQ
aMQ
aMQ
aMQ
aMQ
arG
arG
"}
(3,1,1) = {"
ilK
ilK
arG
ilK
ilK
ilK
arG
ilK
ilK
xxg
xxg
aMQ
aMQ
xxg
xxg
xxg
ilK
arG
"}
(4,1,1) = {"
ilK
ilK
ilK
ilK
aMQ
aMQ
ilK
ilK
aMQ
xxg
xxg
aMQ
aMQ
xxg
xxg
xxg
ilK
arG
"}
(5,1,1) = {"
ilK
ilK
aMQ
aMQ
aMQ
aMQ
aMQ
aMQ
aMQ
aMQ
aMQ
aMQ
aMQ
xxg
xxg
xxg
aMQ
arG
"}
(6,1,1) = {"
arG
ilK
aMQ
aMQ
aMQ
aMQ
aMQ
aMQ
aMQ
aMQ
ilK
aMQ
aMQ
aMQ
aMQ
aMQ
ilK
arG
"}
(7,1,1) = {"
arG
arG
ilK
ilK
aMQ
xxg
aMQ
aMQ
ilK
ilK
ilK
ilK
aMQ
aMQ
aMQ
aMQ
ilK
arG
"}
(8,1,1) = {"
arG
ilK
ilK
aMQ
aMQ
aMQ
aMQ
ilK
ilK
ilK
vvW
ilK
ilK
aMQ
aMQ
ilK
ilK
ilK
"}
(9,1,1) = {"
arG
ilK
ilK
aMQ
aMQ
aMQ
aMQ
ilK
ilK
vmk
ilK
ilK
ilK
aMQ
aMQ
aMQ
ilK
ilK
"}
(10,1,1) = {"
arG
ilK
ilK
aMQ
aMQ
ilK
ilK
ilK
ilK
ilK
ilK
ilK
aMQ
aMQ
aMQ
aMQ
aMQ
ilK
"}
(11,1,1) = {"
arG
ilK
ilK
aMQ
aMQ
aMQ
aMQ
aMQ
ilK
ilK
aMQ
aMQ
aMQ
aMQ
xxg
xxg
ilK
ilK
"}
(12,1,1) = {"
arG
arG
ilK
xxg
xxg
aMQ
aMQ
aMQ
aMQ
aMQ
aMQ
aMQ
aMQ
aMQ
xxg
xxg
ilK
ilK
"}
(13,1,1) = {"
arG
arG
ilK
xxg
xxg
aMQ
aMQ
aMQ
xxg
aMQ
aMQ
aMQ
aMQ
aMQ
aMQ
ilK
ilK
arG
"}
(14,1,1) = {"
arG
arG
ilK
xxg
xxg
aMQ
aMQ
aMQ
aMQ
aMQ
aMQ
aMQ
aMQ
ilK
ilK
ilK
arG
arG
"}
(15,1,1) = {"
ilK
arG
ilK
aMQ
aMQ
aMQ
aMQ
aMQ
aMQ
aMQ
aMQ
aMQ
aMQ
ilK
arG
arG
arG
ilK
"}
(16,1,1) = {"
arG
arG
ilK
ilK
ilK
aMQ
aMQ
aMQ
aMQ
aMQ
aMQ
ilK
ilK
arG
arG
arG
arG
arG
"}
(17,1,1) = {"
arG
arG
arG
ilK
ilK
aMQ
aMQ
xxg
xxg
aMQ
aMQ
ilK
ilK
arG
arG
arG
arG
arG
"}
(18,1,1) = {"
arG
arG
arG
arG
arG
arG
aMQ
xxg
xxg
arG
arG
arG
arG
arG
arG
arG
arG
arG
"}
(19,1,1) = {"
arG
arG
ilK
arG
arG
arG
arG
arG
arG
arG
arG
arG
ilK
arG
arG
arG
ilK
arG
"}
