// This map has been converted using maphash
"arG" = (/turf/template_noop,/area/template_noop)
"chf" = (/turf/closed/wall,/area/ruin/unpowered)
"esc" = (/obj/structure/lattice,/turf/template_noop,/area/space/nearstation)
"ikq" = (/obj/structure/alien/weeds/node,/obj/structure/table,/turf/open/floor/plating/airless,/area/ruin/unpowered)
"iBr" = (/obj/structure/alien/resin/membrane,/turf/open/floor/plating/airless,/area/ruin/unpowered)
"iTh" = (/obj/structure/alien/weeds,/obj/effect/decal/remains/robot,/turf/open/floor/plating/airless,/area/ruin/unpowered)
"jut" = (/obj/structure/alien/weeds,/obj/structure/table,/turf/open/floor/plating/airless,/area/ruin/unpowered)
"khL" = (/obj/structure/alien/weeds,/obj/structure/table_frame,/turf/open/floor/plating/airless,/area/ruin/unpowered)
"kpd" = (/obj/structure/alien/weeds/node,/turf/open/floor/plating/airless,/area/ruin/unpowered)
"mQC" = (/obj/structure/girder,/obj/structure/alien/weeds,/turf/open/floor/plating/airless,/area/ruin/unpowered)
"npW" = (/obj/structure/alien/weeds,/obj/structure/bed/nest,/obj/effect/decal/remains/human,/turf/open/floor/plating/airless,/area/ruin/unpowered)
"oHI" = (/turf/open/floor/plating/airless,/area/ruin/unpowered)
"rWV" = (/obj/structure/alien/weeds,/obj/structure/bed/nest,/obj/effect/decal/remains/xeno,/turf/open/floor/plating/airless,/area/ruin/unpowered)
"soI" = (/obj/structure/alien/resin/wall,/turf/open/floor/plating/airless,/area/ruin/unpowered)
"tMT" = (/obj/structure/girder,/turf/open/floor/plating/airless,/area/ruin/unpowered)
"uaJ" = (/obj/structure/alien/weeds,/obj/structure/alien/resin/membrane,/turf/open/floor/plating/airless,/area/ruin/unpowered)
"vdI" = (/obj/structure/alien/weeds,/turf/open/floor/plating/airless,/area/ruin/unpowered)
"ygO" = (/obj/structure/alien/weeds,/obj/structure/bed/nest,/turf/open/floor/plating/airless,/area/ruin/unpowered)

(1,1,1) = {"
arG
arG
arG
arG
arG
arG
arG
arG
arG
arG
arG
arG
arG
arG
arG
arG
arG
arG
arG
arG
arG
arG
arG
arG
esc
esc
esc
arG
arG
"}
(2,1,1) = {"
arG
arG
arG
arG
arG
arG
arG
arG
arG
arG
arG
arG
arG
arG
arG
arG
arG
arG
arG
arG
arG
arG
arG
esc
tMT
tMT
tMT
chf
arG
"}
(3,1,1) = {"
arG
arG
arG
arG
arG
arG
arG
arG
arG
arG
arG
arG
arG
arG
arG
arG
arG
arG
arG
arG
arG
arG
esc
esc
chf
oHI
oHI
chf
arG
"}
(4,1,1) = {"
arG
arG
arG
arG
arG
arG
arG
arG
arG
arG
arG
arG
arG
arG
arG
arG
arG
arG
arG
arG
arG
esc
esc
oHI
oHI
oHI
oHI
chf
esc
"}
(5,1,1) = {"
arG
arG
arG
arG
arG
arG
arG
arG
arG
arG
arG
arG
arG
arG
arG
arG
arG
arG
arG
arG
arG
arG
esc
oHI
oHI
oHI
oHI
chf
esc
"}
(6,1,1) = {"
arG
arG
arG
arG
arG
arG
arG
arG
arG
arG
arG
arG
arG
arG
arG
arG
arG
arG
arG
arG
arG
arG
chf
oHI
oHI
oHI
oHI
tMT
esc
"}
(7,1,1) = {"
arG
arG
arG
arG
arG
arG
arG
arG
arG
arG
arG
arG
arG
arG
arG
arG
arG
arG
arG
arG
arG
chf
oHI
oHI
oHI
chf
oHI
esc
esc
"}
(8,1,1) = {"
arG
arG
arG
arG
arG
arG
arG
arG
arG
arG
arG
arG
arG
arG
arG
arG
arG
arG
arG
arG
esc
esc
oHI
oHI
oHI
esc
esc
esc
arG
"}
(9,1,1) = {"
arG
arG
arG
arG
arG
arG
arG
arG
arG
arG
arG
arG
arG
arG
arG
arG
arG
arG
arG
arG
esc
esc
esc
esc
esc
esc
arG
arG
arG
"}
(10,1,1) = {"
arG
arG
arG
arG
arG
esc
esc
arG
arG
arG
arG
arG
arG
arG
arG
arG
arG
arG
arG
esc
esc
arG
esc
esc
esc
arG
arG
arG
arG
"}
(11,1,1) = {"
arG
arG
arG
arG
esc
esc
esc
esc
esc
arG
arG
arG
esc
esc
esc
esc
esc
esc
arG
arG
arG
arG
arG
arG
arG
arG
arG
arG
arG
"}
(12,1,1) = {"
arG
arG
arG
esc
esc
esc
esc
soI
chf
arG
arG
esc
esc
esc
esc
esc
esc
arG
arG
arG
arG
arG
arG
arG
arG
arG
arG
arG
arG
"}
(13,1,1) = {"
arG
arG
arG
esc
esc
esc
soI
vdI
vdI
mQC
arG
chf
uaJ
tMT
esc
esc
arG
arG
arG
arG
arG
arG
arG
arG
arG
arG
arG
arG
arG
"}
(14,1,1) = {"
arG
arG
esc
esc
esc
soI
vdI
vdI
vdI
chf
chf
chf
vdI
chf
esc
arG
arG
arG
arG
arG
arG
arG
arG
arG
arG
arG
arG
arG
arG
"}
(15,1,1) = {"
arG
arG
esc
esc
esc
soI
vdI
ygO
vdI
chf
jut
jut
vdI
chf
esc
arG
arG
arG
arG
arG
arG
arG
arG
arG
arG
arG
arG
arG
arG
"}
(16,1,1) = {"
arG
arG
esc
esc
mQC
vdI
kpd
vdI
vdI
mQC
vdI
kpd
vdI
chf
chf
chf
chf
arG
arG
arG
arG
arG
arG
arG
arG
arG
arG
arG
arG
"}
(17,1,1) = {"
arG
arG
arG
chf
vdI
vdI
vdI
vdI
vdI
chf
npW
vdI
vdI
chf
kpd
vdI
mQC
esc
arG
arG
arG
arG
arG
arG
arG
arG
arG
arG
arG
"}
(18,1,1) = {"
arG
arG
arG
chf
chf
chf
chf
chf
vdI
chf
vdI
npW
vdI
chf
vdI
vdI
iBr
esc
esc
arG
arG
arG
arG
arG
arG
arG
arG
arG
arG
"}
(19,1,1) = {"
arG
arG
esc
chf
khL
vdI
vdI
vdI
vdI
vdI
vdI
vdI
vdI
vdI
vdI
vdI
vdI
iBr
oHI
esc
arG
arG
arG
arG
arG
arG
arG
arG
arG
"}
(20,1,1) = {"
arG
esc
esc
chf
kpd
vdI
vdI
vdI
vdI
vdI
vdI
vdI
vdI
vdI
vdI
vdI
rWV
uaJ
esc
esc
arG
arG
arG
arG
arG
arG
arG
arG
arG
"}
(21,1,1) = {"
esc
esc
esc
chf
chf
chf
chf
chf
vdI
chf
vdI
vdI
vdI
chf
vdI
vdI
vdI
uaJ
esc
esc
arG
arG
arG
arG
arG
arG
arG
arG
arG
"}
(22,1,1) = {"
esc
esc
esc
uaJ
vdI
vdI
vdI
vdI
vdI
chf
vdI
vdI
ygO
chf
ygO
khL
uaJ
esc
esc
arG
arG
arG
arG
arG
arG
arG
arG
arG
arG
"}
(23,1,1) = {"
esc
esc
esc
chf
ygO
vdI
kpd
vdI
vdI
chf
vdI
kpd
vdI
chf
chf
chf
kpd
esc
esc
arG
arG
arG
arG
arG
arG
arG
arG
arG
arG
"}
(24,1,1) = {"
arG
arG
esc
chf
npW
vdI
vdI
vdI
vdI
mQC
ygO
vdI
vdI
soI
oHI
esc
esc
esc
esc
arG
arG
arG
arG
arG
arG
arG
arG
arG
arG
"}
(25,1,1) = {"
arG
arG
esc
chf
chf
chf
vdI
vdI
vdI
chf
vdI
ygO
soI
oHI
tMT
esc
esc
esc
arG
arG
arG
arG
arG
arG
arG
arG
arG
arG
arG
"}
(26,1,1) = {"
arG
arG
arG
arG
esc
chf
chf
vdI
iTh
chf
chf
chf
oHI
esc
esc
esc
arG
arG
arG
arG
arG
arG
arG
arG
arG
arG
arG
arG
arG
"}
(27,1,1) = {"
arG
arG
arG
arG
esc
esc
chf
jut
ikq
chf
arG
arG
esc
esc
arG
arG
arG
arG
arG
arG
arG
arG
arG
arG
arG
arG
arG
arG
arG
"}
(28,1,1) = {"
arG
arG
arG
arG
esc
esc
iBr
iBr
tMT
tMT
arG
arG
arG
arG
arG
arG
arG
arG
arG
arG
arG
arG
arG
arG
arG
arG
arG
arG
arG
"}
(29,1,1) = {"
arG
arG
arG
arG
esc
esc
esc
esc
esc
esc
arG
arG
arG
arG
arG
arG
arG
arG
arG
arG
arG
arG
arG
arG
arG
arG
arG
arG
arG
"}
(30,1,1) = {"
arG
arG
arG
arG
esc
esc
esc
esc
esc
arG
arG
arG
arG
arG
arG
arG
arG
arG
arG
arG
arG
arG
arG
arG
arG
arG
arG
arG
arG
"}
(31,1,1) = {"
arG
arG
arG
arG
arG
esc
esc
esc
arG
arG
arG
arG
arG
arG
arG
arG
arG
arG
arG
arG
arG
arG
arG
arG
arG
arG
arG
arG
arG
"}
