//MAP CONVERTED BY dmm2tgm.py THIS HEADER COMMENT PREVENTS RECONVERSION, DO NOT REMOVE
"a" = (
/turf/template_noop,
/area/template_noop)
"b" = (
/obj/structure/window/reinforced/spawner/directional/east,
/turf/template_noop,
/area/template_noop)
"c" = (
/obj/machinery/door/airlock/external/ruin,
/turf/open/floor/plating,
/area/ruin/space/has_grav/powered/dinner_for_two)
"d" = (
/obj/structure/window/reinforced/spawner/directional/west,
/turf/template_noop,
/area/template_noop)
"e" = (
/obj/structure/window/reinforced/spawner/directional/east,
/obj/structure/window/reinforced/spawner/directional/west,
/turf/open/floor/plating,
/area/ruin/space/has_grav/powered/dinner_for_two)
"f" = (
/turf/closed/wall,
/area/ruin/space/has_grav/powered/dinner_for_two)
"g" = (
/obj/effect/spawner/structure/window/reinforced,
/turf/open/floor/plating,
/area/ruin/space/has_grav/powered/dinner_for_two)
"h" = (
/obj/machinery/light/small/directional/north,
/turf/open/floor/iron,
/area/ruin/space/has_grav/powered/dinner_for_two)
"i" = (
/turf/open/floor/iron,
/area/ruin/space/has_grav/powered/dinner_for_two)
"j" = (
/obj/machinery/light/small/directional/east,
/turf/open/floor/iron,
/area/ruin/space/has_grav/powered/dinner_for_two)
"k" = (
/obj/structure/window/reinforced/spawner/directional/south,
/turf/template_noop,
/area/template_noop)
"l" = (
/obj/structure/window/reinforced/spawner/directional/south,
/obj/structure/window/reinforced/spawner/directional/north,
/turf/open/floor/plating,
/area/ruin/space/has_grav/powered/dinner_for_two)
"m" = (
/obj/structure/chair{
	dir = 4
	},
/turf/open/floor/iron,
/area/ruin/space/has_grav/powered/dinner_for_two)
"n" = (
/obj/structure/table,
/obj/item/flashlight/flare/candle{
	pixel_y = 5
	},
/obj/effect/spawner/random/food_or_drink/three_course_meal{
	pixel_x = 10;
	pixel_y = 5
	},
/obj/effect/spawner/random/food_or_drink/three_course_meal{
	pixel_x = -10;
	pixel_y = 5
	},
/obj/item/food/grown/berries/poison{
	pixel_y = 25;
	pixel_x = 25
	},
/turf/open/floor/iron,
/area/ruin/space/has_grav/powered/dinner_for_two)
"o" = (
/obj/structure/chair{
	dir = 8
	},
/turf/open/floor/iron,
/area/ruin/space/has_grav/powered/dinner_for_two)
"p" = (
/obj/structure/window/reinforced/spawner/directional/north,
/turf/template_noop,
/area/template_noop)
"q" = (
/obj/machinery/light/small/directional/west,
/turf/open/floor/iron,
/area/ruin/space/has_grav/powered/dinner_for_two)
"r" = (
/obj/machinery/light/small/directional/south,
/turf/open/floor/iron,
/area/ruin/space/has_grav/powered/dinner_for_two)
"P" = (
/obj/item/knife/venom,
/turf/open/floor/iron,
/area/ruin/space/has_grav/powered/dinner_for_two)
"Y" = (
/obj/effect/mob_spawn/corpse/human/skeleton,
/turf/open/floor/iron,
/area/ruin/space/has_grav/powered/dinner_for_two)

(1,1,1) = {"
a
a
a
a
a
a
a
k
c
p
a
a
a
a
a
a
a
"}
(2,1,1) = {"
a
a
a
a
a
a
a
k
l
p
a
a
a
a
a
a
a
"}
(3,1,1) = {"
a
a
a
a
a
a
a
k
l
p
a
a
a
a
a
a
a
"}
(4,1,1) = {"
a
a
a
a
a
a
a
k
l
p
a
a
a
a
a
a
a
"}
(5,1,1) = {"
a
a
a
a
a
a
f
g
c
g
f
a
a
a
a
a
a
"}
(6,1,1) = {"
a
a
a
a
a
f
i
i
i
i
q
f
a
a
a
a
a
"}
(7,1,1) = {"
a
a
a
a
f
h
i
i
i
i
i
i
f
a
a
a
a
"}
(8,1,1) = {"
b
b
b
b
g
i
i
Y
m
P
i
i
g
b
b
b
b
"}
(9,1,1) = {"
c
e
e
e
c
i
i
i
n
i
i
i
c
e
e
e
c
"}
(10,1,1) = {"
d
d
d
d
g
i
i
i
o
Y
i
i
g
d
d
d
d
"}
(11,1,1) = {"
a
a
a
a
f
i
i
i
i
i
i
r
f
a
a
a
a
"}
(12,1,1) = {"
a
a
a
a
a
f
j
i
i
i
i
f
a
a
a
a
a
"}
(13,1,1) = {"
a
a
a
a
a
a
f
g
c
g
f
a
a
a
a
a
a
"}
(14,1,1) = {"
a
a
a
a
a
a
a
k
l
p
a
a
a
a
a
a
a
"}
(15,1,1) = {"
a
a
a
a
a
a
a
k
l
p
a
a
a
a
a
a
a
"}
(16,1,1) = {"
a
a
a
a
a
a
a
k
l
p
a
a
a
a
a
a
a
"}
(17,1,1) = {"
a
a
a
a
a
a
a
k
c
p
a
a
a
a
a
a
a
"}
