// This map has been converted using maphash
"ajl" = (/obj/effect/spawner/structure/window/reinforced,/turf/open/floor/plating,/area/ruin/space/has_grav/powered/dinner_for_two)
"arG" = (/turf/template_noop,/area/template_noop)
"buA" = (/obj/machinery/door/airlock/external,/obj/effect/mapping_helpers/airlock/cyclelink_helper,/turf/open/floor/plating,/area/ruin/space/has_grav/powered/dinner_for_two)
"dfJ" = (/obj/structure/chair{dir = 8},/obj/effect/decal/remains/human,/turf/open/floor/plasteel,/area/ruin/space/has_grav/powered/dinner_for_two)
"exV" = (/turf/closed/wall,/area/ruin/space/has_grav/powered/dinner_for_two)
"gjT" = (/obj/machinery/light/small,/turf/open/floor/plasteel,/area/ruin/space/has_grav/powered/dinner_for_two)
"hlI" = (/obj/structure/window/reinforced,/obj/structure/lattice,/turf/template_noop,/area/space/nearstation)
"hRK" = (/obj/machinery/door/airlock/external,/obj/effect/mapping_helpers/airlock/cyclelink_helper{dir = 8},/turf/open/floor/plating,/area/ruin/space/has_grav/powered/dinner_for_two)
"hZX" = (/obj/structure/window/reinforced,/obj/structure/window/reinforced{dir = 1},/turf/open/floor/plating,/area/ruin/space/has_grav/powered/dinner_for_two)
"jbx" = (/obj/machinery/light/small{dir = 8},/turf/open/floor/plasteel,/area/ruin/space/has_grav/powered/dinner_for_two)
"jHb" = (/obj/machinery/door/airlock/external,/obj/effect/mapping_helpers/airlock/cyclelink_helper{dir = 1},/turf/open/floor/plating,/area/ruin/space/has_grav/powered/dinner_for_two)
"mey" = (/obj/structure/window/reinforced{dir = 4},/obj/structure/window/reinforced{dir = 8},/turf/open/floor/plating,/area/ruin/space/has_grav/powered/dinner_for_two)
"pzV" = (/obj/machinery/light/small{dir = 4},/turf/open/floor/plasteel,/area/ruin/space/has_grav/powered/dinner_for_two)
"qte" = (/turf/open/floor/plasteel,/area/ruin/space/has_grav/powered/dinner_for_two)
"qMx" = (/obj/structure/window/reinforced{dir = 1},/obj/structure/lattice,/turf/template_noop,/area/space/nearstation)
"roA" = (/obj/machinery/light/small{dir = 1},/turf/open/floor/plasteel,/area/ruin/space/has_grav/powered/dinner_for_two)
"sSi" = (/obj/structure/window/reinforced{dir = 4},/obj/structure/lattice,/turf/template_noop,/area/space/nearstation)
"tjO" = (/obj/machinery/door/airlock/external,/obj/effect/mapping_helpers/airlock/cyclelink_helper{dir = 4},/turf/open/floor/plating,/area/ruin/space/has_grav/powered/dinner_for_two)
"ttK" = (/obj/structure/chair{dir = 4},/obj/effect/decal/remains/human,/turf/open/floor/plasteel,/area/ruin/space/has_grav/powered/dinner_for_two)
"tFE" = (/obj/structure/window/reinforced{dir = 8},/obj/structure/lattice,/turf/template_noop,/area/space/nearstation)
"xgV" = (/obj/structure/table,/obj/item/candle{pixel_y = 5},/obj/item/trash/plate{pixel_x = 10},/obj/item/trash/plate{pixel_x = -10},/turf/open/floor/plasteel,/area/ruin/space/has_grav/powered/dinner_for_two)

(1,1,1) = {"
arG
arG
arG
arG
arG
arG
arG
hlI
tjO
qMx
arG
arG
arG
arG
arG
arG
arG
"}
(2,1,1) = {"
arG
arG
arG
arG
arG
arG
arG
hlI
hZX
qMx
arG
arG
arG
arG
arG
arG
arG
"}
(3,1,1) = {"
arG
arG
arG
arG
arG
arG
arG
hlI
hZX
qMx
arG
arG
arG
arG
arG
arG
arG
"}
(4,1,1) = {"
arG
arG
arG
arG
arG
arG
arG
hlI
hZX
qMx
arG
arG
arG
arG
arG
arG
arG
"}
(5,1,1) = {"
arG
arG
arG
arG
arG
exV
exV
ajl
hRK
ajl
exV
exV
arG
arG
arG
arG
arG
"}
(6,1,1) = {"
arG
arG
arG
arG
exV
exV
qte
qte
qte
qte
jbx
exV
exV
arG
arG
arG
arG
"}
(7,1,1) = {"
arG
arG
arG
arG
exV
roA
qte
qte
qte
qte
qte
qte
exV
arG
arG
arG
arG
"}
(8,1,1) = {"
sSi
sSi
sSi
sSi
ajl
qte
qte
qte
ttK
qte
qte
qte
ajl
sSi
sSi
sSi
sSi
"}
(9,1,1) = {"
buA
mey
mey
mey
jHb
qte
qte
qte
xgV
qte
qte
qte
buA
mey
mey
mey
jHb
"}
(10,1,1) = {"
tFE
tFE
tFE
tFE
ajl
qte
qte
qte
dfJ
qte
qte
qte
ajl
tFE
tFE
tFE
tFE
"}
(11,1,1) = {"
arG
arG
arG
arG
exV
qte
qte
qte
qte
qte
qte
gjT
exV
arG
arG
arG
arG
"}
(12,1,1) = {"
arG
arG
arG
arG
exV
exV
pzV
qte
qte
qte
qte
exV
exV
arG
arG
arG
arG
"}
(13,1,1) = {"
arG
arG
arG
arG
arG
exV
exV
ajl
tjO
ajl
exV
exV
arG
arG
arG
arG
arG
"}
(14,1,1) = {"
arG
arG
arG
arG
arG
arG
arG
hlI
hZX
qMx
arG
arG
arG
arG
arG
arG
arG
"}
(15,1,1) = {"
arG
arG
arG
arG
arG
arG
arG
hlI
hZX
qMx
arG
arG
arG
arG
arG
arG
arG
"}
(16,1,1) = {"
arG
arG
arG
arG
arG
arG
arG
hlI
hZX
qMx
arG
arG
arG
arG
arG
arG
arG
"}
(17,1,1) = {"
arG
arG
arG
arG
arG
arG
arG
hlI
hRK
qMx
arG
arG
arG
arG
arG
arG
arG
"}
