// This map has been converted using maphash
"arG" = (/turf/template_noop,/area/template_noop)
"bMx" = (/turf/open/floor/plating/airless,/area/ruin/unpowered/no_grav)
"esc" = (/obj/structure/lattice,/turf/template_noop,/area/space/nearstation)
"iAX" = (/turf/closed/wall,/area/ruin/unpowered/no_grav)
"vZd" = (/obj/structure/lattice,/obj/structure/lattice,/turf/template_noop,/area/space/nearstation)

(1,1,1) = {"
arG
arG
arG
arG
arG
arG
arG
arG
arG
arG
arG
arG
arG
arG
arG
arG
arG
arG
arG
arG
arG
arG
arG
iAX
iAX
iAX
iAX
iAX
arG
arG
"}
(2,1,1) = {"
arG
arG
arG
arG
arG
arG
arG
arG
arG
arG
arG
arG
arG
arG
arG
arG
arG
arG
arG
arG
arG
arG
bMx
bMx
bMx
bMx
bMx
bMx
iAX
arG
"}
(3,1,1) = {"
arG
arG
arG
arG
arG
arG
arG
arG
arG
arG
arG
arG
arG
arG
arG
arG
arG
arG
arG
arG
arG
arG
bMx
bMx
bMx
bMx
bMx
bMx
bMx
iAX
"}
(4,1,1) = {"
arG
arG
arG
arG
arG
arG
arG
arG
arG
arG
arG
arG
arG
arG
arG
arG
arG
arG
arG
arG
arG
arG
arG
esc
bMx
bMx
bMx
bMx
bMx
iAX
"}
(5,1,1) = {"
arG
arG
arG
arG
arG
arG
arG
arG
arG
arG
arG
arG
arG
arG
arG
arG
arG
arG
arG
arG
arG
arG
arG
esc
esc
esc
bMx
bMx
bMx
iAX
"}
(6,1,1) = {"
arG
arG
arG
arG
arG
arG
arG
arG
arG
arG
arG
arG
arG
arG
arG
arG
arG
arG
arG
arG
arG
arG
arG
esc
esc
esc
bMx
bMx
bMx
iAX
"}
(7,1,1) = {"
arG
arG
arG
arG
arG
arG
arG
arG
arG
arG
arG
arG
arG
arG
arG
arG
arG
arG
arG
arG
arG
arG
arG
arG
esc
esc
esc
bMx
bMx
iAX
"}
(8,1,1) = {"
arG
arG
arG
arG
arG
arG
arG
arG
arG
arG
arG
arG
arG
arG
arG
arG
arG
arG
arG
arG
arG
arG
arG
arG
esc
esc
esc
bMx
bMx
arG
"}
(9,1,1) = {"
arG
arG
arG
arG
arG
arG
arG
arG
arG
arG
arG
arG
arG
arG
arG
arG
arG
arG
arG
arG
arG
arG
arG
esc
esc
arG
vZd
esc
bMx
arG
"}
(10,1,1) = {"
arG
arG
arG
arG
arG
arG
arG
arG
arG
arG
arG
arG
arG
arG
arG
arG
arG
arG
arG
arG
arG
arG
arG
arG
arG
arG
arG
arG
arG
arG
"}
(11,1,1) = {"
arG
arG
arG
arG
arG
arG
arG
arG
arG
arG
arG
arG
arG
arG
arG
arG
arG
arG
arG
arG
esc
esc
arG
arG
arG
arG
arG
arG
arG
arG
"}
(12,1,1) = {"
arG
arG
arG
arG
arG
arG
arG
arG
arG
arG
arG
arG
arG
arG
arG
arG
arG
esc
esc
esc
esc
arG
arG
arG
arG
arG
arG
arG
arG
arG
"}
(13,1,1) = {"
arG
arG
arG
arG
arG
arG
arG
arG
arG
arG
arG
arG
arG
arG
arG
esc
esc
esc
esc
esc
arG
arG
arG
arG
arG
arG
arG
arG
arG
arG
"}
(14,1,1) = {"
arG
arG
arG
arG
arG
arG
arG
arG
arG
arG
arG
arG
arG
bMx
bMx
bMx
bMx
esc
esc
esc
arG
arG
arG
arG
arG
arG
arG
arG
arG
arG
"}
(15,1,1) = {"
arG
arG
arG
arG
arG
arG
arG
arG
arG
arG
esc
esc
bMx
bMx
iAX
bMx
bMx
bMx
esc
arG
arG
arG
arG
arG
arG
arG
arG
arG
arG
arG
"}
(16,1,1) = {"
arG
arG
arG
arG
arG
arG
arG
arG
arG
esc
esc
bMx
bMx
bMx
iAX
bMx
bMx
bMx
esc
arG
arG
arG
arG
arG
arG
arG
arG
arG
arG
arG
"}
(17,1,1) = {"
arG
arG
arG
arG
arG
arG
arG
arG
esc
esc
bMx
bMx
bMx
bMx
iAX
bMx
bMx
bMx
esc
arG
arG
arG
arG
arG
arG
arG
arG
arG
arG
arG
"}
(18,1,1) = {"
arG
arG
arG
arG
arG
arG
esc
esc
bMx
esc
bMx
iAX
iAX
iAX
bMx
iAX
bMx
bMx
esc
arG
arG
arG
arG
arG
arG
arG
arG
arG
arG
arG
"}
(19,1,1) = {"
arG
arG
arG
esc
esc
esc
esc
esc
esc
esc
bMx
iAX
bMx
bMx
bMx
bMx
bMx
bMx
esc
arG
arG
arG
arG
arG
arG
arG
arG
arG
arG
arG
"}
(20,1,1) = {"
arG
arG
arG
bMx
bMx
bMx
esc
esc
esc
esc
bMx
bMx
bMx
bMx
bMx
bMx
esc
esc
esc
arG
arG
arG
arG
arG
arG
arG
arG
arG
arG
arG
"}
(21,1,1) = {"
arG
bMx
bMx
bMx
bMx
bMx
bMx
esc
esc
esc
bMx
bMx
bMx
bMx
esc
esc
esc
esc
esc
arG
arG
arG
arG
arG
arG
arG
arG
arG
arG
arG
"}
(22,1,1) = {"
bMx
bMx
bMx
bMx
iAX
bMx
bMx
esc
esc
esc
esc
bMx
bMx
bMx
esc
esc
bMx
esc
arG
arG
arG
arG
arG
arG
arG
arG
arG
arG
arG
arG
"}
(23,1,1) = {"
bMx
bMx
bMx
iAX
bMx
bMx
bMx
bMx
esc
esc
esc
esc
esc
esc
esc
esc
esc
esc
arG
arG
arG
arG
arG
arG
arG
arG
arG
arG
arG
arG
"}
(24,1,1) = {"
bMx
bMx
iAX
iAX
iAX
iAX
bMx
bMx
esc
esc
bMx
esc
esc
esc
esc
esc
esc
esc
esc
arG
arG
arG
arG
arG
arG
arG
arG
arG
arG
arG
"}
(25,1,1) = {"
bMx
bMx
bMx
iAX
bMx
bMx
bMx
bMx
esc
esc
esc
esc
esc
bMx
bMx
bMx
bMx
bMx
esc
esc
arG
arG
arG
arG
arG
arG
arG
arG
arG
arG
"}
(26,1,1) = {"
arG
bMx
bMx
bMx
iAX
iAX
bMx
esc
esc
esc
esc
bMx
bMx
bMx
bMx
bMx
bMx
bMx
bMx
esc
arG
arG
arG
arG
arG
arG
arG
arG
arG
arG
"}
(27,1,1) = {"
arG
bMx
bMx
bMx
bMx
bMx
bMx
esc
esc
esc
esc
bMx
bMx
bMx
bMx
bMx
bMx
bMx
bMx
arG
arG
arG
arG
arG
arG
arG
arG
arG
arG
arG
"}
(28,1,1) = {"
arG
arG
arG
bMx
bMx
bMx
bMx
esc
esc
esc
bMx
bMx
bMx
bMx
bMx
iAX
bMx
bMx
bMx
bMx
arG
arG
arG
arG
arG
arG
arG
arG
arG
arG
"}
(29,1,1) = {"
arG
arG
arG
esc
esc
esc
esc
esc
esc
esc
bMx
bMx
bMx
bMx
iAX
iAX
iAX
iAX
bMx
bMx
arG
arG
arG
arG
arG
arG
arG
arG
arG
arG
"}
(30,1,1) = {"
arG
arG
arG
arG
arG
esc
esc
bMx
esc
esc
bMx
bMx
iAX
iAX
bMx
iAX
bMx
bMx
bMx
arG
arG
arG
arG
arG
arG
arG
arG
arG
arG
arG
"}
(31,1,1) = {"
arG
arG
arG
arG
arG
arG
esc
esc
esc
esc
bMx
bMx
bMx
bMx
bMx
iAX
bMx
bMx
arG
arG
arG
arG
arG
arG
arG
arG
arG
arG
arG
arG
"}
(32,1,1) = {"
arG
arG
arG
arG
arG
arG
arG
esc
esc
esc
esc
esc
bMx
bMx
bMx
bMx
arG
arG
arG
arG
arG
arG
arG
arG
arG
arG
arG
arG
arG
arG
"}
