// This map has been converted using maphash
"arG" = (/turf/template_noop,/area/template_noop)
"aMQ" = (/turf/closed/mineral,/area/ruin/unpowered/no_grav)
"bye" = (/turf/open/floor/plating,/area/ruin/unpowered)
"chf" = (/turf/closed/wall,/area/ruin/unpowered)
"dlv" = (/obj/effect/spawner/lootdrop/crate_spawner,/turf/open/floor/plating,/area/ruin/unpowered)
"eGY" = (/obj/structure/table,/obj/item/storage/toolbox/syndicate,/turf/open/floor/plating,/area/ruin/unpowered)
"fVL" = (/obj/structure/barricade/wooden,/obj/structure/door_assembly,/turf/open/floor/plating,/area/ruin/unpowered)
"ilK" = (/turf/open/floor/plating/asteroid/airless,/area/ruin/unpowered/no_grav)
"iTw" = (/turf/open/floor/plating/asteroid,/area/ruin/unpowered)
"lbf" = (/obj/structure/barricade/wooden,/turf/open/floor/plating,/area/ruin/unpowered)
"loO" = (/obj/machinery/door/airlock/external,/turf/open/floor/plating,/area/ruin/unpowered)
"mQz" = (/obj/structure/closet/crate,/obj/effect/spawner/lootdrop/maintenance,/turf/open/floor/plating,/area/ruin/unpowered)
"mSI" = (/obj/effect/decal/remains/human,/turf/open/floor/plating,/area/ruin/unpowered)
"nUh" = (/obj/structure/closet/crate,/turf/open/floor/plating,/area/ruin/unpowered)
"phJ" = (/turf/closed/mineral,/area/ruin/unpowered)
"poV" = (/obj/structure/table,/turf/open/floor/plating,/area/ruin/unpowered)
"ppC" = (/turf/closed/wall/rust,/area/ruin/unpowered)
"rZL" = (/obj/structure/table,/obj/item/storage/toolbox/electrical,/turf/open/floor/plating,/area/ruin/unpowered)
"sZm" = (/obj/structure/barricade/wooden,/obj/machinery/door/airlock/external,/turf/open/floor/plating/asteroid/airless,/area/ruin/unpowered)

(1,1,1) = {"
arG
arG
arG
arG
arG
arG
arG
arG
arG
arG
arG
arG
arG
arG
arG
arG
arG
arG
arG
arG
arG
arG
arG
arG
arG
arG
arG
arG
arG
arG
arG
aMQ
aMQ
aMQ
arG
arG
arG
arG
"}
(2,1,1) = {"
arG
arG
arG
arG
arG
arG
arG
arG
arG
arG
arG
arG
arG
arG
arG
arG
arG
arG
arG
arG
arG
arG
arG
arG
arG
arG
arG
arG
arG
arG
arG
aMQ
aMQ
aMQ
arG
arG
arG
arG
"}
(3,1,1) = {"
arG
arG
arG
arG
arG
arG
arG
arG
arG
arG
arG
arG
arG
arG
arG
arG
arG
arG
aMQ
arG
arG
arG
arG
arG
arG
arG
arG
arG
arG
arG
arG
arG
arG
aMQ
arG
arG
arG
aMQ
"}
(4,1,1) = {"
arG
arG
arG
arG
arG
arG
arG
arG
arG
arG
arG
arG
arG
arG
arG
arG
arG
arG
arG
arG
arG
arG
arG
arG
arG
arG
arG
arG
arG
arG
arG
arG
arG
arG
arG
arG
arG
arG
"}
(5,1,1) = {"
arG
arG
arG
arG
arG
arG
arG
arG
arG
ilK
ilK
ilK
ilK
arG
arG
arG
arG
arG
arG
arG
arG
arG
aMQ
arG
arG
arG
arG
arG
arG
arG
arG
arG
arG
arG
arG
arG
aMQ
arG
"}
(6,1,1) = {"
arG
arG
arG
arG
arG
arG
arG
ilK
ilK
ilK
ilK
ilK
ilK
arG
arG
arG
arG
arG
arG
arG
arG
arG
arG
arG
arG
arG
arG
arG
arG
arG
arG
arG
arG
arG
arG
arG
arG
arG
"}
(7,1,1) = {"
arG
arG
arG
arG
arG
arG
aMQ
aMQ
aMQ
aMQ
aMQ
ilK
ilK
ilK
ilK
arG
arG
arG
arG
arG
arG
arG
arG
arG
aMQ
aMQ
aMQ
arG
arG
arG
arG
arG
arG
arG
arG
arG
arG
arG
"}
(8,1,1) = {"
arG
arG
arG
arG
arG
aMQ
aMQ
aMQ
aMQ
aMQ
aMQ
ilK
ilK
ilK
ilK
ilK
ilK
ilK
arG
arG
arG
arG
arG
arG
aMQ
aMQ
aMQ
arG
arG
arG
arG
arG
arG
arG
arG
arG
arG
arG
"}
(9,1,1) = {"
arG
arG
arG
arG
arG
aMQ
aMQ
aMQ
aMQ
aMQ
aMQ
aMQ
aMQ
aMQ
ilK
ilK
ilK
ilK
ilK
arG
arG
arG
arG
arG
arG
aMQ
aMQ
aMQ
aMQ
arG
arG
arG
arG
arG
arG
arG
arG
arG
"}
(10,1,1) = {"
arG
arG
arG
arG
arG
aMQ
aMQ
aMQ
aMQ
aMQ
aMQ
aMQ
aMQ
aMQ
aMQ
aMQ
aMQ
ilK
ilK
arG
arG
arG
arG
arG
arG
aMQ
aMQ
aMQ
aMQ
arG
arG
arG
arG
arG
arG
arG
arG
arG
"}
(11,1,1) = {"
arG
arG
arG
arG
aMQ
aMQ
aMQ
aMQ
aMQ
aMQ
aMQ
aMQ
aMQ
aMQ
aMQ
aMQ
aMQ
ilK
ilK
ilK
ilK
arG
arG
arG
arG
arG
arG
arG
arG
arG
arG
arG
arG
arG
arG
arG
arG
arG
"}
(12,1,1) = {"
arG
arG
arG
arG
aMQ
aMQ
aMQ
aMQ
aMQ
aMQ
aMQ
aMQ
aMQ
aMQ
aMQ
aMQ
aMQ
aMQ
ilK
ilK
ilK
arG
arG
arG
arG
arG
arG
arG
arG
arG
arG
arG
arG
arG
arG
arG
arG
arG
"}
(13,1,1) = {"
arG
arG
arG
arG
aMQ
aMQ
aMQ
aMQ
aMQ
aMQ
aMQ
aMQ
aMQ
aMQ
aMQ
aMQ
aMQ
aMQ
ilK
ilK
ilK
ilK
ilK
arG
arG
arG
arG
arG
arG
arG
arG
arG
arG
arG
arG
arG
arG
arG
"}
(14,1,1) = {"
arG
arG
arG
arG
aMQ
aMQ
aMQ
aMQ
aMQ
phJ
phJ
ppC
ppC
chf
ppC
chf
chf
chf
phJ
aMQ
ilK
ilK
ilK
arG
arG
arG
arG
arG
arG
arG
arG
arG
arG
arG
arG
arG
arG
arG
"}
(15,1,1) = {"
arG
arG
arG
arG
aMQ
aMQ
aMQ
aMQ
aMQ
phJ
bye
dlv
dlv
mSI
bye
ppC
bye
bye
phJ
aMQ
ilK
ilK
ilK
arG
arG
arG
arG
arG
arG
arG
arG
arG
arG
arG
arG
arG
arG
arG
"}
(16,1,1) = {"
arG
arG
arG
arG
arG
arG
aMQ
aMQ
aMQ
chf
bye
bye
bye
bye
nUh
ppC
bye
bye
chf
aMQ
ilK
ilK
ilK
arG
arG
arG
arG
arG
arG
arG
arG
arG
arG
arG
arG
arG
arG
arG
"}
(17,1,1) = {"
arG
arG
arG
arG
arG
arG
aMQ
aMQ
aMQ
chf
bye
bye
rZL
eGY
dlv
chf
bye
bye
phJ
aMQ
ilK
ilK
ilK
ilK
arG
arG
arG
arG
arG
arG
aMQ
aMQ
aMQ
arG
arG
arG
arG
arG
"}
(18,1,1) = {"
arG
arG
arG
arG
arG
arG
aMQ
aMQ
aMQ
ppC
chf
fVL
ppC
ppC
chf
chf
iTw
mQz
chf
aMQ
aMQ
aMQ
ilK
ilK
ilK
ilK
ilK
arG
arG
arG
aMQ
aMQ
aMQ
aMQ
aMQ
arG
arG
arG
"}
(19,1,1) = {"
arG
arG
arG
arG
arG
arG
arG
aMQ
aMQ
phJ
bye
bye
mQz
nUh
mQz
chf
bye
bye
ppC
aMQ
aMQ
aMQ
ilK
ilK
ilK
ilK
ilK
ilK
ilK
ilK
ilK
ilK
aMQ
aMQ
aMQ
arG
arG
arG
"}
(20,1,1) = {"
arG
arG
arG
arG
arG
arG
arG
aMQ
aMQ
phJ
bye
bye
bye
bye
bye
chf
bye
iTw
ppC
aMQ
aMQ
aMQ
ilK
ilK
ilK
ilK
ilK
ilK
ilK
ilK
ilK
ilK
aMQ
aMQ
aMQ
aMQ
aMQ
arG
"}
(21,1,1) = {"
arG
arG
arG
arG
arG
arG
arG
aMQ
aMQ
chf
bye
bye
bye
bye
bye
fVL
bye
bye
chf
aMQ
aMQ
aMQ
ilK
ilK
ilK
ilK
ilK
ilK
ilK
ilK
ilK
ilK
ilK
ilK
aMQ
aMQ
aMQ
arG
"}
(22,1,1) = {"
arG
arG
arG
arG
arG
arG
arG
arG
aMQ
chf
nUh
nUh
bye
poV
bye
chf
bye
iTw
chf
chf
chf
aMQ
ilK
ilK
ilK
ilK
ilK
ilK
ilK
ilK
ilK
ilK
ilK
ilK
aMQ
aMQ
aMQ
aMQ
"}
(23,1,1) = {"
arG
arG
arG
arG
arG
arG
arG
arG
aMQ
phJ
ppC
ppC
fVL
ppC
bye
chf
iTw
lbf
sZm
lbf
loO
ilK
ilK
ilK
ilK
ilK
ilK
ilK
ilK
ilK
ilK
ilK
ilK
ilK
aMQ
aMQ
aMQ
aMQ
"}
(24,1,1) = {"
arG
arG
arG
arG
arG
arG
arG
arG
arG
phJ
dlv
nUh
bye
ppC
mQz
chf
chf
phJ
chf
chf
chf
aMQ
ilK
ilK
ilK
ilK
ilK
ilK
ilK
ilK
ilK
ilK
ilK
ilK
aMQ
aMQ
aMQ
aMQ
"}
(25,1,1) = {"
arG
aMQ
arG
arG
arG
arG
arG
arG
arG
aMQ
aMQ
chf
ppC
chf
aMQ
aMQ
aMQ
aMQ
aMQ
aMQ
aMQ
aMQ
ilK
ilK
ilK
ilK
ilK
ilK
ilK
ilK
ilK
ilK
ilK
ilK
ilK
aMQ
aMQ
aMQ
"}
(26,1,1) = {"
arG
arG
arG
arG
arG
arG
arG
arG
arG
aMQ
aMQ
aMQ
aMQ
aMQ
aMQ
aMQ
aMQ
aMQ
aMQ
aMQ
aMQ
aMQ
aMQ
aMQ
aMQ
ilK
ilK
ilK
ilK
ilK
ilK
ilK
ilK
ilK
ilK
ilK
aMQ
aMQ
"}
(27,1,1) = {"
arG
arG
arG
arG
arG
arG
arG
arG
arG
aMQ
aMQ
aMQ
aMQ
aMQ
aMQ
aMQ
aMQ
aMQ
aMQ
aMQ
aMQ
aMQ
aMQ
aMQ
aMQ
aMQ
ilK
ilK
ilK
ilK
ilK
ilK
ilK
ilK
ilK
ilK
aMQ
aMQ
"}
(28,1,1) = {"
arG
arG
arG
arG
arG
arG
arG
arG
arG
aMQ
aMQ
aMQ
aMQ
aMQ
aMQ
aMQ
aMQ
aMQ
aMQ
aMQ
aMQ
aMQ
aMQ
aMQ
aMQ
aMQ
ilK
ilK
ilK
ilK
ilK
ilK
ilK
ilK
ilK
ilK
aMQ
aMQ
"}
(29,1,1) = {"
arG
arG
arG
arG
arG
arG
arG
arG
arG
aMQ
aMQ
aMQ
aMQ
aMQ
aMQ
aMQ
aMQ
aMQ
aMQ
aMQ
aMQ
aMQ
aMQ
aMQ
aMQ
ilK
ilK
ilK
ilK
ilK
ilK
ilK
ilK
ilK
ilK
ilK
aMQ
aMQ
"}
(30,1,1) = {"
arG
aMQ
aMQ
arG
arG
arG
arG
arG
arG
arG
aMQ
aMQ
aMQ
aMQ
aMQ
aMQ
aMQ
aMQ
aMQ
aMQ
aMQ
aMQ
aMQ
aMQ
aMQ
ilK
ilK
ilK
ilK
ilK
ilK
ilK
ilK
ilK
aMQ
aMQ
aMQ
aMQ
"}
(31,1,1) = {"
aMQ
aMQ
aMQ
arG
arG
arG
arG
arG
arG
arG
aMQ
aMQ
aMQ
aMQ
aMQ
aMQ
aMQ
aMQ
aMQ
aMQ
aMQ
aMQ
aMQ
aMQ
aMQ
aMQ
ilK
ilK
ilK
ilK
ilK
ilK
ilK
ilK
aMQ
aMQ
aMQ
arG
"}
(32,1,1) = {"
aMQ
aMQ
aMQ
aMQ
arG
arG
arG
arG
arG
arG
arG
arG
aMQ
aMQ
aMQ
aMQ
aMQ
aMQ
aMQ
aMQ
aMQ
aMQ
aMQ
aMQ
aMQ
aMQ
ilK
ilK
ilK
ilK
ilK
ilK
aMQ
aMQ
aMQ
aMQ
aMQ
arG
"}
(33,1,1) = {"
arG
aMQ
aMQ
aMQ
arG
arG
arG
arG
arG
arG
arG
arG
aMQ
aMQ
aMQ
aMQ
aMQ
aMQ
aMQ
aMQ
aMQ
aMQ
aMQ
aMQ
aMQ
aMQ
aMQ
aMQ
aMQ
aMQ
ilK
ilK
aMQ
aMQ
aMQ
aMQ
aMQ
arG
"}
(34,1,1) = {"
aMQ
arG
arG
arG
arG
arG
arG
aMQ
arG
arG
arG
arG
arG
arG
aMQ
aMQ
aMQ
aMQ
aMQ
aMQ
aMQ
aMQ
aMQ
aMQ
aMQ
aMQ
aMQ
aMQ
aMQ
aMQ
aMQ
aMQ
aMQ
aMQ
aMQ
aMQ
arG
arG
"}
(35,1,1) = {"
aMQ
arG
arG
arG
arG
arG
arG
arG
arG
arG
arG
arG
arG
arG
aMQ
aMQ
aMQ
aMQ
aMQ
aMQ
aMQ
aMQ
aMQ
aMQ
aMQ
aMQ
aMQ
aMQ
aMQ
aMQ
aMQ
aMQ
aMQ
aMQ
aMQ
aMQ
arG
arG
"}
(36,1,1) = {"
arG
arG
arG
arG
aMQ
arG
arG
arG
arG
arG
arG
arG
arG
arG
arG
arG
arG
arG
arG
aMQ
aMQ
aMQ
aMQ
aMQ
aMQ
aMQ
aMQ
aMQ
aMQ
aMQ
aMQ
aMQ
aMQ
aMQ
aMQ
aMQ
arG
arG
"}
(37,1,1) = {"
arG
arG
arG
arG
arG
arG
arG
arG
arG
arG
arG
arG
arG
arG
arG
arG
arG
arG
arG
arG
arG
arG
arG
arG
arG
arG
aMQ
aMQ
aMQ
aMQ
aMQ
aMQ
aMQ
arG
arG
arG
arG
arG
"}
