// This map has been converted using maphash
"aqU" = (/obj/structure/table,/turf/open/floor/mineral/titanium/blue/airless,/area/ruin/unpowered)
"arG" = (/turf/template_noop,/area/template_noop)
"bif" = (/turf/open/floor/plating/asteroid/airless,/area/ruin/unpowered)
"bqm" = (/obj/structure/shuttle/engine/propulsion{dir = 4},/turf/open/floor/plating/airless,/area/ruin/unpowered)
"bYn" = (/turf/closed/wall/mineral/titanium,/area/ruin/unpowered)
"cwM" = (/obj/structure/chair{dir = 1},/turf/open/floor/plating/airless,/area/ruin/unpowered)
"dPj" = (/turf/open/floor/mineral/titanium/blue/airless,/area/ruin/unpowered)
"eeQ" = (/obj/effect/spawner/lootdrop/crate_spawner,/turf/open/floor/mineral/titanium/blue/airless,/area/ruin/unpowered)
"gnm" = (/turf/closed/mineral/random/high_chance,/area/ruin/unpowered)
"hhT" = (/obj/structure/grille,/turf/open/floor/plating/airless,/area/ruin/unpowered)
"hzp" = (/obj/structure/chair{dir = 8},/turf/open/floor/plating/airless,/area/ruin/unpowered)
"iaF" = (/obj/item/shard,/turf/open/floor/plating/airless,/area/ruin/unpowered)
"ieJ" = (/obj/structure/chair{dir = 1},/obj/structure/window/reinforced{dir = 8},/turf/open/floor/mineral/titanium/blue/airless,/area/ruin/unpowered)
"iMc" = (/obj/item/shard,/obj/structure/chair{dir = 8},/turf/open/floor/mineral/titanium/blue/airless,/area/ruin/unpowered)
"jMU" = (/obj/structure/chair,/obj/structure/window/reinforced{dir = 8},/turf/open/floor/mineral/titanium/blue/airless,/area/ruin/unpowered)
"mdU" = (/obj/structure/chair,/turf/open/floor/mineral/titanium/blue/airless,/area/ruin/unpowered)
"oHI" = (/turf/open/floor/plating/airless,/area/ruin/unpowered)
"phJ" = (/turf/closed/mineral,/area/ruin/unpowered)
"pyP" = (/obj/machinery/door/airlock/titanium,/turf/open/floor/plating/airless,/area/ruin/unpowered)
"tMT" = (/obj/structure/girder,/turf/open/floor/plating/airless,/area/ruin/unpowered)

(1,1,1) = {"
arG
arG
arG
arG
arG
arG
arG
arG
arG
arG
arG
arG
arG
arG
arG
arG
arG
arG
arG
arG
arG
phJ
arG
arG
arG
arG
arG
arG
arG
arG
arG
arG
arG
arG
arG
"}
(2,1,1) = {"
arG
arG
arG
arG
arG
arG
arG
arG
arG
arG
arG
arG
arG
arG
arG
arG
arG
arG
arG
arG
arG
arG
arG
arG
phJ
phJ
arG
arG
arG
arG
arG
arG
arG
arG
arG
"}
(3,1,1) = {"
arG
arG
bif
bif
arG
arG
arG
arG
arG
arG
arG
arG
arG
arG
arG
arG
arG
arG
arG
arG
arG
arG
arG
phJ
phJ
phJ
arG
arG
arG
arG
arG
arG
arG
arG
arG
"}
(4,1,1) = {"
arG
phJ
bif
bif
bif
arG
arG
arG
arG
arG
arG
arG
arG
arG
arG
arG
arG
arG
arG
phJ
arG
arG
arG
phJ
phJ
arG
arG
arG
arG
arG
arG
arG
arG
arG
arG
"}
(5,1,1) = {"
phJ
phJ
bif
bif
bif
arG
arG
arG
arG
arG
arG
arG
arG
arG
arG
arG
arG
arG
arG
arG
arG
arG
arG
arG
arG
arG
arG
arG
arG
arG
arG
arG
arG
arG
arG
"}
(6,1,1) = {"
phJ
phJ
phJ
phJ
phJ
arG
arG
arG
arG
arG
arG
bif
bif
arG
arG
arG
arG
arG
arG
arG
arG
arG
arG
arG
arG
arG
arG
arG
arG
arG
arG
arG
arG
arG
arG
"}
(7,1,1) = {"
phJ
phJ
phJ
phJ
phJ
arG
arG
arG
arG
arG
arG
bif
bif
bif
bif
bif
bif
bif
arG
arG
arG
arG
arG
arG
arG
arG
arG
arG
arG
arG
arG
arG
arG
arG
arG
"}
(8,1,1) = {"
arG
arG
phJ
phJ
arG
arG
arG
arG
arG
arG
arG
bif
bif
bif
bif
bif
bif
bif
phJ
phJ
phJ
arG
arG
arG
arG
arG
arG
arG
arG
arG
arG
arG
arG
arG
arG
"}
(9,1,1) = {"
arG
arG
phJ
phJ
arG
arG
arG
arG
arG
phJ
bif
bif
bif
bif
bif
bif
bif
bif
bif
phJ
phJ
arG
arG
arG
arG
arG
arG
arG
arG
arG
arG
arG
arG
arG
arG
"}
(10,1,1) = {"
arG
arG
arG
arG
arG
arG
arG
arG
arG
phJ
phJ
phJ
bif
bif
bif
bif
bif
bif
bif
phJ
phJ
phJ
arG
arG
arG
arG
arG
arG
arG
arG
arG
arG
arG
arG
arG
"}
(11,1,1) = {"
arG
arG
arG
arG
arG
arG
arG
arG
phJ
phJ
phJ
phJ
phJ
phJ
bif
bif
phJ
phJ
phJ
phJ
phJ
phJ
phJ
arG
arG
arG
arG
arG
arG
arG
arG
arG
arG
arG
arG
"}
(12,1,1) = {"
arG
arG
arG
arG
arG
arG
arG
arG
phJ
phJ
phJ
phJ
gnm
gnm
phJ
phJ
phJ
phJ
phJ
phJ
phJ
phJ
gnm
arG
arG
arG
arG
arG
arG
arG
phJ
phJ
phJ
arG
arG
"}
(13,1,1) = {"
arG
arG
arG
arG
arG
arG
arG
arG
gnm
gnm
phJ
phJ
gnm
gnm
phJ
phJ
phJ
gnm
phJ
phJ
phJ
phJ
phJ
arG
arG
arG
arG
arG
arG
arG
arG
phJ
phJ
phJ
arG
"}
(14,1,1) = {"
arG
arG
arG
arG
arG
arG
arG
arG
gnm
gnm
phJ
phJ
phJ
phJ
phJ
phJ
phJ
phJ
phJ
phJ
phJ
phJ
phJ
phJ
arG
arG
arG
arG
arG
arG
phJ
phJ
phJ
phJ
phJ
"}
(15,1,1) = {"
arG
arG
arG
arG
arG
arG
arG
arG
gnm
gnm
gnm
phJ
phJ
phJ
oHI
oHI
hhT
phJ
phJ
bif
phJ
phJ
gnm
gnm
arG
arG
arG
arG
arG
gnm
phJ
phJ
phJ
bif
bif
"}
(16,1,1) = {"
arG
arG
arG
arG
arG
arG
arG
arG
gnm
gnm
phJ
phJ
bif
bYn
oHI
iaF
aqU
oHI
bYn
bif
phJ
phJ
gnm
gnm
arG
arG
arG
arG
gnm
gnm
phJ
phJ
gnm
bif
bif
"}
(17,1,1) = {"
arG
arG
arG
arG
arG
arG
arG
arG
gnm
phJ
phJ
phJ
bif
bYn
oHI
hzp
iMc
dPj
bYn
bif
phJ
phJ
gnm
gnm
arG
arG
arG
gnm
phJ
phJ
phJ
bif
bif
bif
arG
"}
(18,1,1) = {"
arG
arG
arG
arG
arG
arG
arG
arG
phJ
phJ
phJ
phJ
bif
bYn
oHI
dPj
dPj
dPj
bYn
bif
bif
phJ
phJ
phJ
arG
arG
arG
phJ
phJ
phJ
phJ
bif
bif
bif
arG
"}
(19,1,1) = {"
arG
arG
arG
arG
arG
arG
arG
arG
phJ
phJ
phJ
bif
bif
bYn
dPj
dPj
dPj
dPj
bYn
bif
bif
bif
bif
phJ
arG
arG
gnm
phJ
phJ
bif
bif
bif
bif
bif
arG
"}
(20,1,1) = {"
arG
arG
arG
arG
arG
arG
arG
arG
arG
phJ
phJ
bif
bif
pyP
dPj
dPj
dPj
dPj
pyP
bif
bif
bif
bif
phJ
arG
phJ
phJ
phJ
phJ
bif
bif
bif
arG
arG
arG
"}
(21,1,1) = {"
arG
arG
arG
arG
arG
arG
arG
arG
arG
phJ
phJ
phJ
bif
bYn
jMU
dPj
dPj
ieJ
bYn
bif
bif
bif
bif
arG
arG
phJ
phJ
phJ
bif
bif
bif
arG
arG
arG
arG
"}
(22,1,1) = {"
arG
arG
arG
arG
arG
arG
phJ
arG
arG
phJ
phJ
phJ
bif
bYn
mdU
dPj
dPj
cwM
tMT
bif
bif
bif
bif
arG
arG
phJ
phJ
bif
arG
arG
arG
arG
arG
arG
arG
"}
(23,1,1) = {"
arG
arG
arG
arG
arG
arG
arG
arG
phJ
phJ
phJ
gnm
bif
bYn
eeQ
dPj
oHI
oHI
oHI
bif
bif
arG
arG
arG
arG
arG
phJ
bif
arG
arG
arG
arG
arG
arG
arG
"}
(24,1,1) = {"
arG
arG
arG
phJ
phJ
arG
arG
arG
phJ
phJ
phJ
gnm
bif
bYn
bYn
bYn
bYn
bYn
bYn
bif
bif
arG
arG
arG
arG
arG
arG
arG
arG
arG
arG
arG
arG
arG
arG
"}
(25,1,1) = {"
arG
arG
phJ
phJ
phJ
arG
arG
arG
phJ
phJ
phJ
gnm
bif
bYn
bqm
bqm
bqm
bqm
bYn
bif
bif
arG
arG
arG
arG
arG
arG
arG
arG
arG
arG
arG
arG
arG
arG
"}
(26,1,1) = {"
arG
arG
arG
phJ
phJ
arG
arG
arG
phJ
phJ
phJ
phJ
phJ
bif
bif
bif
bif
bif
bif
bif
bif
arG
arG
arG
arG
arG
arG
arG
arG
arG
arG
arG
arG
arG
arG
"}
(27,1,1) = {"
arG
arG
arG
arG
arG
arG
arG
arG
arG
phJ
phJ
phJ
bif
bif
bif
bif
bif
arG
arG
arG
arG
arG
arG
arG
arG
arG
arG
arG
arG
arG
arG
arG
arG
arG
arG
"}
(28,1,1) = {"
arG
arG
arG
arG
arG
arG
arG
arG
arG
arG
phJ
phJ
bif
bif
bif
bif
bif
arG
arG
arG
arG
arG
arG
arG
arG
arG
arG
arG
arG
arG
arG
arG
arG
arG
arG
"}
(29,1,1) = {"
arG
arG
arG
arG
arG
arG
arG
arG
arG
arG
arG
arG
arG
arG
arG
arG
arG
arG
arG
arG
arG
arG
arG
arG
arG
arG
arG
arG
arG
arG
arG
arG
arG
arG
arG
"}
(30,1,1) = {"
arG
arG
arG
arG
arG
arG
arG
arG
arG
arG
arG
arG
arG
arG
arG
arG
arG
arG
arG
arG
arG
arG
arG
arG
arG
arG
arG
arG
arG
arG
arG
arG
arG
arG
arG
"}
(31,1,1) = {"
arG
arG
arG
arG
arG
arG
arG
arG
arG
arG
arG
arG
arG
arG
arG
arG
arG
arG
arG
arG
arG
arG
arG
arG
arG
arG
bif
bif
bif
arG
arG
arG
arG
arG
arG
"}
(32,1,1) = {"
arG
arG
arG
arG
arG
arG
arG
arG
arG
arG
arG
arG
arG
arG
arG
arG
arG
arG
arG
arG
arG
arG
arG
arG
arG
bif
bif
phJ
phJ
arG
arG
arG
arG
arG
arG
"}
(33,1,1) = {"
arG
arG
arG
arG
arG
arG
arG
arG
arG
arG
arG
arG
arG
arG
arG
arG
arG
arG
arG
arG
arG
arG
arG
arG
arG
bif
bif
gnm
phJ
arG
arG
arG
arG
arG
arG
"}
(34,1,1) = {"
arG
arG
arG
arG
arG
arG
arG
arG
arG
arG
arG
arG
arG
arG
arG
arG
arG
arG
arG
arG
arG
arG
arG
phJ
arG
phJ
gnm
phJ
phJ
arG
arG
arG
arG
arG
arG
"}
(35,1,1) = {"
arG
arG
arG
arG
arG
arG
arG
arG
arG
arG
arG
arG
arG
arG
arG
arG
arG
arG
arG
arG
arG
arG
arG
arG
arG
phJ
phJ
arG
arG
arG
arG
arG
arG
arG
arG
"}
