// This map has been converted using maphash
"bOD" = (/turf/closed/wall/mineral/titanium,/area/ruin/powered)
"cgM" = (/obj/item/reagent_containers/syringe,/obj/item/reagent_containers/food/drinks/beer,/turf/open/floor/mineral/titanium/yellow,/area/ruin/powered)
"cih" = (/obj/structure/light_construct{dir = 4},/turf/open/floor/mineral/titanium/blue,/area/ruin/powered)
"dTm" = (/turf/open/floor/mineral/titanium/blue,/area/ruin/powered)
"ebY" = (/obj/item/reagent_containers/food/drinks/beer,/turf/open/floor/mineral/titanium/yellow,/area/ruin/powered)
"eve" = (/turf/open/floor/plasteel/stairs/right,/area/ruin/powered)
"fmt" = (/turf/open/floor/plasteel/stairs/left,/area/ruin/powered)
"gTf" = (/turf/open/floor/mineral/titanium/yellow,/area/ruin/powered)
"htZ" = (/obj/item/clothing/mask/cigarette/rollie/trippy,/obj/effect/decal/cleanable/blood/tracks,/turf/open/floor/mineral/titanium/yellow,/area/ruin/powered)
"hGG" = (/obj/item/paper/crumpled/bloody/hippie,/obj/item/cigbutt/roach,/obj/structure/light_construct{dir = 4},/turf/open/floor/mineral/titanium/yellow,/area/ruin/powered)
"iNO" = (/obj/machinery/computer/shuttle,/turf/open/floor/mineral/titanium/white,/area/ruin/powered)
"kpy" = (/obj/item/reagent_containers/food/drinks/beer,/turf/open/floor/mineral/titanium/blue,/area/ruin/powered)
"lyc" = (/obj/structure/chair/comfy{dir = 1; icon_state = "comfychair"; tag = ""},/turf/open/floor/mineral/titanium/blue,/area/ruin/powered)
"mbF" = (/obj/machinery/door/airlock/shuttle,/turf/open/floor/mineral/titanium/blue,/area/ruin/powered)
"nCB" = (/obj/structure/bed,/turf/open/floor/mineral/titanium/yellow,/area/ruin/powered)
"rLY" = (/obj/item/reagent_containers/glass/bottle/drugs,/obj/effect/decal/cleanable/cobweb/cobweb2,/turf/open/floor/mineral/titanium/yellow,/area/ruin/powered)
"rPK" = (/obj/item/reagent_containers/food/snacks/grown/ambrosia/vulgaris,/obj/item/lighter,/turf/open/floor/mineral/titanium/yellow,/area/ruin/powered)
"skC" = (/obj/structure/table,/obj/item/key,/turf/open/floor/mineral/titanium/white,/area/ruin/powered)
"spM" = (/obj/structure/closet/wardrobe/mixed,/turf/open/floor/mineral/titanium/yellow,/area/ruin/powered)
"tBI" = (/turf/open/space,/area/space)
"uAr" = (/obj/structure/chair/comfy{dir = 1; icon_state = "comfychair"; tag = ""},/obj/effect/decal/remains/human,/turf/open/floor/mineral/titanium/blue,/area/ruin/powered)
"uCV" = (/obj/item/reagent_containers/syringe,/turf/open/floor/mineral/titanium/yellow,/area/ruin/powered)
"vmV" = (/obj/effect/decal/remains/human,/turf/open/floor/mineral/titanium/yellow,/area/ruin/powered)
"vGS" = (/obj/structure/light_construct{dir = 8},/turf/open/floor/mineral/titanium/blue,/area/ruin/powered)
"vNX" = (/obj/structure/shuttle/engine/propulsion{icon_state = "propulsion_r"},/turf/open/space,/area/ruin/powered)
"why" = (/obj/item/reagent_containers/glass/bottle,/turf/open/floor/mineral/titanium/yellow,/area/ruin/powered)
"wVC" = (/obj/effect/mob_spawn/human/corpse/damaged,/obj/effect/decal/cleanable/blood,/obj/effect/decal/cleanable/blood/gibs/body,/obj/effect/decal/cleanable/blood/tracks,/obj/machinery/button/door{id = "HippieVan"; name = "External Shutters"; pixel_y = 25},/turf/open/floor/mineral/titanium/yellow,/area/ruin/powered)
"xba" = (/obj/structure/shuttle/engine/propulsion{icon_state = "propulsion_l"},/turf/open/space,/area/ruin/powered)
"xTr" = (/obj/structure/window/shuttle,/turf/open/floor/plating,/area/ruin/powered)
"xXj" = (/obj/machinery/door/poddoor/shutters{id = "HippieVan"},/turf/open/floor/mineral/titanium/yellow,/area/ruin/powered)

(1,1,1) = {"
tBI
tBI
tBI
tBI
tBI
tBI
tBI
tBI
tBI
tBI
tBI
tBI
tBI
tBI
"}
(2,1,1) = {"
tBI
tBI
tBI
tBI
tBI
tBI
tBI
tBI
tBI
tBI
tBI
tBI
tBI
tBI
"}
(3,1,1) = {"
tBI
tBI
tBI
tBI
tBI
tBI
tBI
tBI
tBI
tBI
tBI
tBI
tBI
tBI
"}
(4,1,1) = {"
tBI
tBI
tBI
tBI
tBI
tBI
tBI
tBI
tBI
tBI
tBI
tBI
tBI
tBI
"}
(5,1,1) = {"
tBI
bOD
mbF
bOD
bOD
xXj
xXj
xXj
xTr
bOD
xba
tBI
tBI
tBI
"}
(6,1,1) = {"
tBI
xTr
uAr
vGS
bOD
wVC
htZ
gTf
nCB
bOD
tBI
tBI
tBI
tBI
"}
(7,1,1) = {"
tBI
xTr
iNO
dTm
fmt
gTf
gTf
uCV
spM
xTr
tBI
tBI
tBI
tBI
"}
(8,1,1) = {"
tBI
xTr
skC
kpy
eve
rPK
uCV
why
ebY
xTr
tBI
tBI
tBI
tBI
"}
(9,1,1) = {"
tBI
xTr
lyc
cih
bOD
rLY
hGG
vmV
cgM
bOD
tBI
tBI
tBI
tBI
"}
(10,1,1) = {"
tBI
bOD
mbF
bOD
bOD
bOD
bOD
bOD
xTr
bOD
vNX
tBI
tBI
tBI
"}
(11,1,1) = {"
tBI
tBI
tBI
tBI
tBI
tBI
tBI
tBI
tBI
tBI
tBI
tBI
tBI
tBI
"}
(12,1,1) = {"
tBI
tBI
tBI
tBI
tBI
tBI
tBI
tBI
tBI
tBI
tBI
tBI
tBI
tBI
"}
(13,1,1) = {"
tBI
tBI
tBI
tBI
tBI
tBI
tBI
tBI
tBI
tBI
tBI
tBI
tBI
tBI
"}
(14,1,1) = {"
tBI
tBI
tBI
tBI
tBI
tBI
tBI
tBI
tBI
tBI
tBI
tBI
tBI
tBI
"}
