//MAP CONVERTED BY dmm2tgm.py THIS HEADER COMMENT PREVENTS RECONVERSION, DO NOT REMOVE
"b" = (
/obj/machinery/door/poddoor/shutters{
	id = "HippieVan"
	},
/obj/structure/fans/tiny,
/turf/open/floor/mineral/titanium/yellow,
/area/ruin/space/has_grav/powered)
"d" = (
/obj/effect/mob_spawn/human/corpse/damaged,
/obj/effect/decal/cleanable/blood,
/obj/effect/decal/cleanable/blood/gibs/body,
/obj/effect/decal/cleanable/blood/tracks,
/obj/machinery/button/door{
	id = "HippieVan";
	name = "External Shutters";
	pixel_y = 25
	},
/obj/machinery/light/broken{
	dir = 1
	},
/turf/open/floor/mineral/titanium/yellow,
/area/ruin/space/has_grav/powered)
"e" = (
/turf/closed/wall/mineral/titanium/nodiagonal,
/area/ruin/space/has_grav/powered)
"g" = (
/obj/structure/chair/comfy{
	dir = 1;
	icon_state = "comfychair";
	tag = ""
	},
/obj/machinery/light/built{
	dir = 8
	},
/turf/open/floor/mineral/titanium/blue,
/area/ruin/space/has_grav/powered)
"h" = (
/obj/structure/shuttle/engine/propulsion,
/turf/open/floor/plating/airless,
/area/ruin/space/has_grav/powered)
"j" = (
/obj/item/reagent_containers/glass/bottle,
/turf/open/floor/mineral/titanium/yellow,
/area/ruin/space/has_grav/powered)
"k" = (
/turf/open/floor/mineral/titanium/yellow,
/area/ruin/space/has_grav/powered)
"l" = (
/obj/structure/table,
/obj/item/key,
/turf/open/floor/mineral/titanium/white,
/area/ruin/space/has_grav/powered)
"m" = (
/obj/effect/spawner/structure/window/shuttle,
/turf/open/floor/plating,
/area/ruin/space/has_grav/powered)
"n" = (
/obj/item/reagent_containers/glass/bottle/drugs,
/obj/effect/decal/cleanable/cobweb/cobweb2,
/obj/structure/bed,
/obj/machinery/light/broken{
	dir = 1
	},
/turf/open/floor/mineral/titanium/yellow,
/area/ruin/space/has_grav/powered)
"o" = (
/turf/closed/wall/mineral/titanium,
/area/ruin/space/has_grav/powered)
"p" = (
/turf/template_noop,
/area/template_noop)
"r" = (
/obj/item/reagent_containers/food/drinks/beer,
/turf/open/floor/mineral/titanium/yellow,
/area/ruin/space/has_grav/powered)
"s" = (
/turf/open/floor/plating/airless,
/area/ruin/space/has_grav/powered)
"t" = (
/obj/structure/window/reinforced{
	dir = 1
	},
/obj/structure/shuttle/engine/heater,
/turf/open/floor/plating/airless,
/area/ruin/space/has_grav/powered)
"u" = (
/obj/structure/shuttle/engine/large,
/turf/open/floor/plating/airless,
/area/ruin/space/has_grav/powered)
"v" = (
/obj/item/reagent_containers/food/drinks/beer,
/turf/open/floor/mineral/titanium/blue,
/area/ruin/space/has_grav/powered)
"w" = (
/obj/item/paper/crumpled/bloody/hippie,
/obj/item/cigbutt/roach,
/obj/structure/light_construct{
	dir = 4
	},
/turf/open/floor/mineral/titanium/yellow,
/area/ruin/space/has_grav/powered)
"x" = (
/turf/open/floor/plasteel/stairs/left,
/area/ruin/space/has_grav/powered)
"y" = (
/obj/item/reagent_containers/syringe,
/obj/item/reagent_containers/food/drinks/beer,
/turf/open/floor/mineral/titanium/yellow,
/area/ruin/space/has_grav/powered)
"z" = (
/obj/machinery/computer/shuttle,
/turf/open/floor/mineral/titanium/white,
/area/ruin/space/has_grav/powered)
"A" = (
/turf/open/floor/plasteel/stairs/right,
/area/ruin/space/has_grav/powered)
"D" = (
/obj/item/reagent_containers/syringe,
/turf/open/floor/mineral/titanium/yellow,
/area/ruin/space/has_grav/powered)
"J" = (
/obj/machinery/door/airlock/shuttle,
/obj/structure/fans/tiny,
/turf/open/floor/mineral/titanium/blue,
/area/ruin/space/has_grav/powered)
"L" = (
/obj/structure/closet/wardrobe/mixed,
/turf/open/floor/mineral/titanium/yellow,
/area/ruin/space/has_grav/powered)
"O" = (
/obj/effect/decal/remains/human,
/turf/open/floor/mineral/titanium/blue,
/area/ruin/space/has_grav/powered)
"P" = (
/obj/item/reagent_containers/food/snacks/grown/ambrosia/vulgaris,
/obj/item/lighter,
/turf/open/floor/mineral/titanium/yellow,
/area/ruin/space/has_grav/powered)
"R" = (
/obj/item/clothing/mask/cigarette/rollie/trippy,
/obj/effect/decal/cleanable/blood/tracks,
/turf/open/floor/mineral/titanium/yellow,
/area/ruin/space/has_grav/powered)
"S" = (
/obj/item/reagent_containers/syringe{
	desc = "A syringe, looks like someone used it to inject weed into themselves.";
	name = "weed syringe"
	},
/obj/item/stack/cable_coil,
/turf/open/floor/mineral/titanium/yellow,
/area/ruin/space/has_grav/powered)
"U" = (
/obj/structure/chair/comfy{
	dir = 1;
	icon_state = "comfychair";
	tag = ""
	},
/obj/machinery/light{
	dir = 4
	},
/turf/open/floor/mineral/titanium/blue,
/area/ruin/space/has_grav/powered)
"V" = (
/turf/open/floor/mineral/titanium/blue,
/area/ruin/space/has_grav/powered)
"Y" = (
/obj/structure/shuttle/engine/heater,
/obj/structure/window/reinforced{
	dir = 1
	},
/turf/open/floor/plating/airless,
/area/ruin/space/has_grav/powered)
"Z" = (
/obj/effect/decal/remains/human,
/turf/open/floor/mineral/titanium/yellow,
/area/ruin/space/has_grav/powered)

(1,1,1) = {"
p
p
p
p
p
p
p
p
p
p
p
p
p
p
"}
(2,1,1) = {"
p
p
p
p
p
p
p
p
p
p
p
p
p
p
"}
(3,1,1) = {"
p
p
p
p
p
p
p
p
p
p
p
p
p
p
"}
(4,1,1) = {"
p
p
p
p
p
p
p
p
p
p
p
p
p
p
"}
(5,1,1) = {"
p
o
o
J
e
b
b
b
o
o
p
p
p
p
"}
(6,1,1) = {"
p
m
g
O
o
d
R
k
L
Y
h
p
p
p
"}
(7,1,1) = {"
p
m
z
V
x
k
k
D
k
t
s
u
p
p
"}
(8,1,1) = {"
p
m
l
v
A
P
S
j
r
t
s
s
p
p
"}
(9,1,1) = {"
p
m
U
V
o
n
w
Z
y
Y
h
p
p
p
"}
(10,1,1) = {"
p
o
o
J
o
o
m
m
o
o
p
p
p
p
"}
(11,1,1) = {"
p
p
p
p
p
p
p
p
p
p
p
p
p
p
"}
(12,1,1) = {"
p
p
p
p
p
p
p
p
p
p
p
p
p
p
"}
(13,1,1) = {"
p
p
p
p
p
p
p
p
p
p
p
p
p
p
"}
(14,1,1) = {"
p
p
p
p
p
p
p
p
p
p
p
p
p
p
"}
