// This map has been converted using maphash
"amf" = (/obj/structure/closet,/turf/open/floor/mineral/titanium/purple,/area/ruin/space/has_grav/powered/authorship)
"arG" = (/turf/template_noop,/area/template_noop)
"aJb" = (/mob/living/simple_animal/bot/medbot,/turf/open/floor/mineral/titanium/purple,/area/ruin/space/has_grav/powered/authorship)
"aVE" = (/obj/structure/chair{dir = 4},/turf/open/floor/mineral/titanium/purple,/area/ruin/space/has_grav/powered/authorship)
"baD" = (/obj/structure/shuttle/engine/propulsion{dir = 8},/turf/template_noop,/area/ruin/space/has_grav/powered/authorship)
"bDN" = (/obj/structure/table/wood,/obj/item/clothing/under/shorts/black,/turf/open/floor/mineral/titanium/purple,/area/ruin/space/has_grav/powered/authorship)
"cnl" = (/obj/structure/table/wood,/obj/machinery/computer/libraryconsole/bookmanagement,/turf/open/floor/mineral/titanium/purple,/area/ruin/space/has_grav/powered/authorship)
"dVR" = (/obj/structure/table/wood,/turf/open/floor/mineral/titanium/purple,/area/ruin/space/has_grav/powered/authorship)
"ean" = (/obj/structure/chair,/turf/open/floor/mineral/titanium/purple,/area/ruin/space/has_grav/powered/authorship)
"fFk" = (/obj/effect/spawner/structure/window/reinforced,/turf/open/floor/plating,/area/ruin/space/has_grav/powered/authorship)
"huX" = (/turf/closed/wall/mineral/plastitanium,/area/ruin/space/has_grav/powered/authorship)
"ikF" = (/obj/machinery/light,/turf/open/floor/mineral/titanium/purple,/area/ruin/space/has_grav/powered/authorship)
"jbi" = (/obj/structure/table/wood,/obj/item/clothing/shoes/sandal,/turf/open/floor/mineral/titanium/purple,/area/ruin/space/has_grav/powered/authorship)
"lJV" = (/obj/machinery/door/airlock/external,/turf/open/floor/mineral/titanium/purple,/area/ruin/space/has_grav/powered/authorship)
"nCe" = (/obj/structure/table,/obj/item/flashlight/lamp,/obj/machinery/light{dir = 1},/turf/open/floor/mineral/titanium/purple,/area/ruin/space/has_grav/powered/authorship)
"pMM" = (/obj/structure/window/reinforced{dir = 4},/obj/structure/shuttle/engine/heater{dir = 8},/turf/open/floor/plating/airless,/area/ruin/space/has_grav/powered/authorship)
"qye" = (/obj/machinery/light,/obj/structure/bed,/turf/open/floor/mineral/titanium/purple,/area/ruin/space/has_grav/powered/authorship)
"qNh" = (/turf/open/floor/mineral/titanium/purple,/area/ruin/space/has_grav/powered/authorship)
"qNV" = (/obj/machinery/door/airlock/public/glass,/turf/open/floor/mineral/titanium/purple,/area/ruin/space/has_grav/powered/authorship)
"tWy" = (/obj/machinery/door/poddoor{id = "goonwizship1"},/obj/machinery/button/door{id = "goonwizship1"; name = "Strange Ship Door Button"; pixel_y = 32},/turf/open/floor/mineral/titanium/purple,/area/ruin/space/has_grav/powered/authorship)
"uvo" = (/obj/machinery/light{dir = 8},/turf/open/floor/mineral/titanium/purple,/area/ruin/space/has_grav/powered/authorship)
"vmy" = (/obj/structure/table/wood,/obj/item/paper_bin,/obj/item/pen,/turf/open/floor/mineral/titanium/purple,/area/ruin/space/has_grav/powered/authorship)
"vwN" = (/turf/closed/wall/mineral/plastitanium{icon_state = "diagonalWall3"},/area/ruin/space/has_grav/powered/authorship)
"wHP" = (/obj/machinery/vending/assist,/turf/open/floor/mineral/titanium/purple,/area/ruin/space/has_grav/powered/authorship)
"wWZ" = (/obj/structure/table/wood,/obj/item/paper,/obj/item/pen,/turf/open/floor/mineral/titanium/purple,/area/ruin/space/has_grav/powered/authorship)

(1,1,1) = {"
arG
arG
arG
huX
huX
tWy
huX
huX
arG
arG
arG
"}
(2,1,1) = {"
arG
baD
baD
huX
dVR
qNh
qNh
huX
baD
baD
arG
"}
(3,1,1) = {"
huX
pMM
pMM
huX
cnl
qNh
ikF
huX
pMM
pMM
vwN
"}
(4,1,1) = {"
huX
bDN
jbi
huX
fFk
lJV
fFk
huX
ean
dVR
huX
"}
(5,1,1) = {"
huX
qNh
qNh
huX
qNh
qNh
aJb
huX
qNh
dVR
huX
"}
(6,1,1) = {"
huX
nCe
qNh
uvo
qNh
qNh
qNh
uvo
qNh
qye
huX
"}
(7,1,1) = {"
huX
amf
qNh
qNh
qNh
qNh
qNh
qNh
qNh
qNh
huX
"}
(8,1,1) = {"
huX
wHP
qNh
qNh
qNh
qNh
qNh
qNh
qNh
amf
huX
"}
(9,1,1) = {"
huX
huX
huX
huX
fFk
qNV
fFk
huX
huX
huX
huX
"}
(10,1,1) = {"
arG
arG
huX
uvo
qNh
qNh
qNh
uvo
huX
arG
arG
"}
(11,1,1) = {"
arG
arG
huX
qNh
qNh
aVE
qNh
qNh
huX
arG
arG
"}
(12,1,1) = {"
arG
arG
huX
amf
vmy
wWZ
dVR
amf
huX
arG
arG
"}
(13,1,1) = {"
arG
arG
huX
huX
huX
huX
huX
huX
huX
arG
arG
"}
