// This map has been converted using maphash
"arG" = (/turf/template_noop,/area/template_noop)
"avH" = (/obj/effect/decal/cleanable/dirt,/obj/effect/decal/cleanable/dirt,/turf/open/floor/plating,/area/ruin/space/has_grav/powered/cat_man)
"awC" = (/obj/structure/table/wood,/obj/item/paper_bin,/obj/item/pen,/turf/open/floor/carpet,/area/ruin/space/has_grav/powered/cat_man)
"azh" = (/obj/machinery/firealarm{dir = 1; pixel_y = -26},/obj/effect/turf_decal/tile/neutral,/obj/effect/turf_decal/tile/neutral{dir = 8},/turf/open/floor/plasteel,/area/ruin/space/has_grav/powered/cat_man)
"aMQ" = (/turf/closed/mineral,/area/ruin/unpowered/no_grav)
"aRq" = (/obj/effect/decal/cleanable/dirt,/obj/effect/decal/cleanable/dirt,/obj/item/reagent_containers/food/snacks/meat/slab/synthmeat{desc = "A slab of cat meat. Tastes like furball."; name = "cat meat"},/obj/machinery/atmospherics/pipe/simple/green/hidden{dir = 5},/turf/open/floor/plating,/area/ruin/space/has_grav/powered/cat_man)
"bcu" = (/obj/machinery/atmospherics/components/unary/thermomachine/freezer{dir = 4},/turf/open/floor/plating,/area/ruin/space/has_grav/powered/cat_man)
"biK" = (/obj/effect/turf_decal/tile/neutral{dir = 1},/obj/effect/turf_decal/tile/neutral,/obj/effect/turf_decal/tile/neutral{dir = 4},/obj/machinery/atmospherics/pipe/manifold/green/hidden{dir = 4},/turf/open/floor/plasteel,/area/ruin/space/has_grav/powered/cat_man)
"boj" = (/obj/effect/decal/cleanable/dirt,/obj/effect/decal/cleanable/blood/old,/turf/open/floor/plating,/area/ruin/space/has_grav/powered/cat_man)
"bse" = (/obj/effect/spawner/structure/window/reinforced,/obj/machinery/atmospherics/pipe/simple/green/hidden{dir = 4},/turf/open/floor/plating,/area/ruin/space/has_grav/powered/cat_man)
"bBv" = (/obj/effect/decal/cleanable/dirt,/obj/machinery/atmospherics/pipe/manifold/dark/hidden,/turf/open/floor/plating,/area/ruin/space/has_grav/powered/cat_man)
"bCW" = (/obj/effect/turf_decal/tile/neutral,/obj/effect/turf_decal/tile/neutral{dir = 8},/turf/open/floor/plasteel,/area/ruin/space/has_grav/powered/cat_man)
"bKh" = (/turf/open/floor/plasteel/white/corner{dir = 8},/area/ruin/space/has_grav/powered/cat_man)
"cgs" = (/obj/machinery/atmospherics/pipe/simple/green/hidden,/obj/machinery/door/firedoor,/turf/open/floor/plasteel,/area/ruin/space/has_grav/powered/cat_man)
"ckK" = (/obj/effect/decal/cleanable/dirt,/obj/effect/decal/cleanable/dirt,/obj/structure/bed/dogbed{name = "kitty bed"},/obj/effect/mob_spawn/human/corpse/damaged{head = /obj/item/clothing/head/kitty},/obj/machinery/atmospherics/pipe/simple/green/hidden{dir = 9},/turf/open/floor/plating,/area/ruin/space/has_grav/powered/cat_man)
"cxh" = (/obj/effect/decal/cleanable/dirt,/obj/machinery/door/poddoor/preopen{id = "meow"; name = "kitty protection door"},/obj/machinery/door/window/northleft{name = "kitty door"; req_access_txt = "200"},/obj/machinery/atmospherics/pipe/simple/green/hidden,/turf/open/floor/plating,/area/ruin/space/has_grav/powered/cat_man)
"cKW" = (/obj/machinery/door/airlock/maintenance_hatch{name = "Portable Atmos Equipment"; req_access_txt = "201"},/turf/open/floor/plating/airless,/area/ruin/space/has_grav/powered/cat_man)
"deE" = (/turf/closed/wall,/area/ruin/space/has_grav/powered/cat_man)
"dxr" = (/turf/open/floor/plasteel/white/side,/area/ruin/space/has_grav/powered/cat_man)
"dBg" = (/obj/machinery/door/airlock/external,/obj/effect/mapping_helpers/airlock/cyclelink_helper{dir = 8},/turf/open/floor/plating,/area/ruin/space/has_grav/powered/cat_man)
"dSP" = (/obj/effect/turf_decal/tile/neutral,/obj/effect/turf_decal/tile/neutral{dir = 8},/obj/machinery/atmospherics/pipe/manifold/green/hidden{dir = 1},/turf/open/floor/plasteel,/area/ruin/space/has_grav/powered/cat_man)
"eoK" = (/obj/machinery/light,/obj/effect/turf_decal/tile/neutral,/obj/effect/turf_decal/tile/neutral{dir = 8},/turf/open/floor/plasteel,/area/ruin/space/has_grav/powered/cat_man)
"eKu" = (/obj/effect/turf_decal/tile/neutral,/obj/effect/turf_decal/tile/neutral{dir = 8},/obj/machinery/atmospherics/pipe/simple/green/hidden,/turf/open/floor/plasteel,/area/ruin/space/has_grav/powered/cat_man)
"eOw" = (/obj/effect/decal/cleanable/dirt,/obj/effect/decal/cleanable/dirt,/obj/effect/decal/cleanable/blood/old,/obj/machinery/light/small,/obj/machinery/atmospherics/components/unary/vent_pump/on{dir = 1},/turf/open/floor/plating,/area/ruin/space/has_grav/powered/cat_man)
"eZW" = (/obj/effect/turf_decal/tile/neutral{dir = 1},/obj/effect/turf_decal/tile/neutral{dir = 4},/turf/open/floor/plasteel,/area/ruin/space/has_grav/powered/cat_man)
"ffg" = (/obj/machinery/door/airlock/external,/obj/effect/mapping_helpers/airlock/cyclelink_helper{dir = 4},/turf/open/floor/plating,/area/ruin/space/has_grav/powered/cat_man)
"fpk" = (/obj/machinery/button/door{id = "meow"; name = "Emergency Kitty Lockdown"; pixel_x = -24},/turf/open/floor/plasteel,/area/ruin/space/has_grav/powered/cat_man)
"ftQ" = (/obj/structure/closet/crate,/obj/item/storage/toolbox,/obj/item/storage/toolbox/mechanical,/turf/open/floor/plating,/area/ruin/space/has_grav/powered/cat_man)
"fvr" = (/obj/effect/decal/cleanable/dirt,/obj/effect/turf_decal/tile/neutral,/obj/effect/turf_decal/tile/neutral{dir = 4},/obj/machinery/atmospherics/pipe/manifold/green/hidden{dir = 8; icon_state = "manifold-2"},/turf/open/floor/plasteel,/area/ruin/space/has_grav/powered/cat_man)
"fIs" = (/obj/structure/table/optable,/obj/effect/mob_spawn/human/corpse/damaged,/obj/item/organ/ears/cat,/obj/effect/decal/cleanable/blood/old,/turf/open/floor/plasteel/white,/area/ruin/space/has_grav/powered/cat_man)
"fPT" = (/obj/machinery/atmospherics/pipe/simple/green/hidden{dir = 5},/obj/structure/table,/obj/item/storage/toolbox/mechanical,/obj/item/wrench,/turf/open/floor/plating,/area/ruin/space/has_grav/powered/cat_man)
"fTh" = (/obj/effect/decal/cleanable/dirt,/obj/effect/decal/cleanable/dirt,/obj/effect/decal/cleanable/dirt,/turf/open/floor/plating,/area/ruin/space/has_grav/powered/cat_man)
"fTo" = (/obj/machinery/atmospherics/pipe/simple/green/hidden{dir = 4},/turf/open/floor/plating,/area/ruin/space/has_grav/powered/cat_man)
"fUg" = (/obj/structure/rack,/obj/item/melee/baton/cattleprod,/obj/item/melee/baton/cattleprod,/obj/item/restraints/handcuffs,/obj/item/restraints/handcuffs,/turf/open/floor/carpet,/area/ruin/space/has_grav/powered/cat_man)
"fVw" = (/obj/effect/decal/cleanable/dirt,/obj/item/twohanded/required/kirbyplants/random,/obj/effect/turf_decal/tile/neutral{dir = 1},/obj/effect/turf_decal/tile/neutral{dir = 4},/obj/machinery/atmospherics/pipe/simple/green/hidden{dir = 4},/turf/open/floor/plasteel,/area/ruin/space/has_grav/powered/cat_man)
"gby" = (/obj/effect/decal/cleanable/dirt,/obj/effect/decal/cleanable/dirt,/obj/item/reagent_containers/glass/bowl,/obj/item/reagent_containers/food/snacks/meat/slab/synthmeat{desc = "A slab of cat meat. Tastes like furball."; name = "cat meat"},/obj/machinery/light/small{dir = 1},/turf/open/floor/plating,/area/ruin/space/has_grav/powered/cat_man)
"gGq" = (/obj/structure/bed/dogbed{name = "kitty bed"},/mob/living/simple_animal/pet/cat/space,/turf/open/floor/carpet,/area/ruin/space/has_grav/powered/cat_man)
"gPb" = (/obj/machinery/door/firedoor,/turf/open/floor/plasteel,/area/ruin/space/has_grav/powered/cat_man)
"gRw" = (/obj/effect/decal/cleanable/dirt,/obj/machinery/atmospherics/pipe/simple/green/hidden{dir = 5},/turf/open/floor/plating,/area/ruin/space/has_grav/powered/cat_man)
"gUA" = (/obj/structure/janitorialcart,/obj/item/mop,/obj/item/reagent_containers/glass/bucket,/obj/effect/decal/cleanable/cobweb/cobweb2,/turf/open/floor/plating,/area/ruin/space/has_grav/powered/cat_man)
"gYk" = (/turf/open/floor/plasteel/white/corner{dir = 1},/area/ruin/space/has_grav/powered/cat_man)
"gYz" = (/obj/machinery/light/small,/turf/open/floor/plating,/area/ruin/space/has_grav/powered/cat_man)
"hLF" = (/obj/structure/reagent_dispensers/watertank,/turf/open/floor/plating,/area/ruin/space/has_grav/powered/cat_man)
"hSX" = (/obj/structure/table/reinforced,/obj/item/scalpel{pixel_y = 12},/turf/open/floor/plasteel,/area/ruin/space/has_grav/powered/cat_man)
"ieM" = (/obj/effect/decal/cleanable/dirt,/obj/effect/decal/cleanable/cobweb,/obj/structure/closet/emcloset,/turf/open/floor/plating,/area/ruin/space/has_grav/powered/cat_man)
"iiD" = (/obj/structure/closet/crate/freezer{name = "cat tails"},/obj/item/organ/tail/cat,/obj/item/organ/tail/cat,/obj/item/organ/tail/cat,/obj/item/organ/tail/cat,/obj/item/organ/tail/cat,/obj/item/organ/tail/cat,/turf/open/floor/plasteel/freezer,/area/ruin/space/has_grav/powered/cat_man)
"ilK" = (/turf/open/floor/plating/asteroid/airless,/area/ruin/unpowered/no_grav)
"iNj" = (/obj/effect/decal/cleanable/dirt,/turf/open/floor/plating,/area/ruin/space/has_grav/powered/cat_man)
"jcp" = (/obj/item/organ/tail/cat,/obj/effect/decal/cleanable/blood/old,/turf/open/floor/plasteel/white/corner,/area/ruin/space/has_grav/powered/cat_man)
"jed" = (/obj/effect/decal/cleanable/dirt,/obj/effect/decal/cleanable/dirt,/obj/machinery/light/small{dir = 1},/turf/open/floor/plating,/area/ruin/space/has_grav/powered/cat_man)
"joG" = (/obj/structure/closet/crate/freezer{name = "cat hide"},/obj/item/stack/sheet/animalhide/human,/obj/item/stack/sheet/animalhide/human,/obj/item/stack/sheet/animalhide/human,/obj/item/stack/sheet/animalhide/human,/obj/item/stack/sheet/animalhide/human,/obj/item/stack/sheet/animalhide/human,/obj/item/stack/sheet/animalhide/human,/obj/item/stack/sheet/animalhide/human,/obj/item/stack/sheet/animalhide/human,/obj/item/stack/sheet/animalhide/human,/obj/item/stack/sheet/animalhide/human,/obj/machinery/atmospherics/components/unary/vent_pump/siphon/atmos{dir = 4; icon_state = "vent_map_siphon_on-2"; id_tag = "o2_out_cat"; name = "freezer vent"},/turf/open/floor/plasteel/freezer,/area/ruin/space/has_grav/powered/cat_man)
"jpL" = (/obj/machinery/portable_atmospherics/scrubber,/turf/open/floor/plating/airless,/area/ruin/space/has_grav/powered/cat_man)
"jFV" = (/turf/open/floor/plating/airless,/area/ruin/space/has_grav/powered/cat_man)
"jLv" = (/obj/machinery/door/airlock/maintenance_hatch{name = "Custodial Supplies"; req_access_txt = "201"},/turf/open/floor/plating,/area/ruin/space/has_grav/powered/cat_man)
"kmF" = (/obj/effect/decal/cleanable/dirt,/obj/machinery/atmospherics/pipe/simple/green/hidden,/turf/open/floor/plating,/area/ruin/space/has_grav/powered/cat_man)
"kBu" = (/obj/machinery/light{dir = 8},/turf/open/floor/plasteel,/area/ruin/space/has_grav/powered/cat_man)
"kJO" = (/obj/machinery/light{dir = 4},/obj/structure/closet/cabinet,/obj/item/gps{gpstag = "kitty"},/turf/open/floor/carpet,/area/ruin/space/has_grav/powered/cat_man)
"kWh" = (/obj/effect/decal/cleanable/dirt,/obj/machinery/light/small,/obj/machinery/atmospherics/components/unary/vent_pump/on{dir = 4},/turf/open/floor/plating,/area/ruin/space/has_grav/powered/cat_man)
"ldY" = (/obj/machinery/atmospherics/pipe/simple/green/hidden{dir = 10},/turf/open/floor/plating,/area/ruin/space/has_grav/powered/cat_man)
"lgX" = (/turf/open/floor/plating,/area/ruin/space/has_grav/powered/cat_man)
"ltQ" = (/obj/structure/closet/crate/bin,/obj/effect/turf_decal/tile/neutral{dir = 1},/obj/effect/turf_decal/tile/neutral{dir = 4},/turf/open/floor/plasteel,/area/ruin/space/has_grav/powered/cat_man)
"lGr" = (/obj/machinery/light{dir = 1},/obj/effect/turf_decal/tile/neutral{dir = 1},/obj/effect/turf_decal/tile/neutral{dir = 4},/turf/open/floor/plasteel,/area/ruin/space/has_grav/powered/cat_man)
"lIb" = (/obj/effect/decal/cleanable/dirt,/obj/effect/turf_decal/tile/neutral,/obj/effect/turf_decal/tile/neutral{dir = 8},/obj/machinery/atmospherics/pipe/simple/green/hidden{dir = 4},/turf/open/floor/plasteel,/area/ruin/space/has_grav/powered/cat_man)
"lRg" = (/obj/effect/turf_decal/tile/neutral,/obj/effect/turf_decal/tile/neutral{dir = 8},/obj/machinery/firealarm{dir = 1; pixel_y = -26},/turf/open/floor/plasteel,/area/ruin/space/has_grav/powered/cat_man)
"mkN" = (/obj/structure/chair/wood/wings{dir = 8},/turf/open/floor/carpet,/area/ruin/space/has_grav/powered/cat_man)
"msV" = (/obj/effect/turf_decal/tile/neutral,/obj/effect/turf_decal/tile/neutral{dir = 4},/obj/machinery/firealarm{dir = 8; icon_state = "fire0"; pixel_x = 26},/obj/machinery/atmospherics/pipe/simple/green/hidden,/turf/open/floor/plasteel,/area/ruin/space/has_grav/powered/cat_man)
"mAt" = (/obj/machinery/atmospherics/pipe/simple/green/hidden,/turf/open/floor/plasteel,/area/ruin/space/has_grav/powered/cat_man)
"mBL" = (/obj/structure/table/reinforced,/obj/item/hemostat,/obj/item/cautery{pixel_x = 4},/turf/open/floor/plasteel,/area/ruin/space/has_grav/powered/cat_man)
"mSG" = (/obj/effect/decal/cleanable/dirt,/obj/item/toy/cattoy,/obj/machinery/atmospherics/pipe/simple/green/hidden{dir = 4},/turf/open/floor/plating,/area/ruin/space/has_grav/powered/cat_man)
"mXT" = (/obj/effect/decal/cleanable/dirt,/obj/item/reagent_containers/glass/bowl,/obj/machinery/atmospherics/pipe/simple/green/hidden,/turf/open/floor/plating,/area/ruin/space/has_grav/powered/cat_man)
"npO" = (/obj/effect/decal/cleanable/dirt,/obj/effect/turf_decal/tile/neutral,/obj/effect/turf_decal/tile/neutral{dir = 4},/obj/effect/turf_decal/tile/neutral{dir = 8},/obj/machinery/atmospherics/pipe/manifold/green/hidden{dir = 4},/turf/open/floor/plasteel,/area/ruin/space/has_grav/powered/cat_man)
"nsZ" = (/obj/effect/decal/cleanable/dirt,/obj/item/reagent_containers/glass/bowl,/turf/open/floor/plating,/area/ruin/space/has_grav/powered/cat_man)
"nLf" = (/obj/structure/table/reinforced,/obj/item/clothing/gloves/color/latex,/obj/item/surgical_drapes,/turf/open/floor/plasteel/white/side{dir = 8},/area/ruin/space/has_grav/powered/cat_man)
"nTP" = (/obj/machinery/light/small{dir = 8},/obj/machinery/atmospherics/components/unary/portables_connector/visible{dir = 4},/obj/machinery/portable_atmospherics/canister/oxygen,/turf/open/floor/plating,/area/ruin/space/has_grav/powered/cat_man)
"nWK" = (/obj/item/twohanded/required/kirbyplants/random,/obj/effect/turf_decal/tile/neutral,/obj/effect/turf_decal/tile/neutral{dir = 8},/turf/open/floor/plasteel,/area/ruin/space/has_grav/powered/cat_man)
"ofL" = (/obj/machinery/door/airlock/maintenance_hatch{name = "Misc Supplies"; req_access_txt = "201"},/turf/open/floor/plating,/area/ruin/space/has_grav/powered/cat_man)
"ojj" = (/obj/effect/decal/cleanable/dirt,/obj/machinery/atmospherics/pipe/simple/green/hidden{dir = 4},/turf/open/floor/plating,/area/ruin/space/has_grav/powered/cat_man)
"onF" = (/obj/effect/decal/cleanable/dirt,/obj/effect/decal/cleanable/dirt,/obj/item/toy/cattoy,/turf/open/floor/plating,/area/ruin/space/has_grav/powered/cat_man)
"opo" = (/obj/structure/bed/dogbed{name = "kitty bed"},/obj/effect/decal/cleanable/dirt,/obj/effect/decal/cleanable/dirt,/turf/open/floor/plating,/area/ruin/space/has_grav/powered/cat_man)
"ovy" = (/obj/structure/bed/dogbed{name = "kitty bed"},/obj/effect/decal/cleanable/dirt,/turf/open/floor/plating,/area/ruin/space/has_grav/powered/cat_man)
"oMu" = (/obj/structure/table,/obj/effect/turf_decal/tile/neutral{dir = 1},/obj/effect/turf_decal/tile/neutral{dir = 4},/turf/open/floor/plasteel,/area/ruin/space/has_grav/powered/cat_man)
"pcs" = (/obj/structure/table/wood,/turf/open/floor/carpet,/area/ruin/space/has_grav/powered/cat_man)
"phG" = (/obj/structure/closet/crate/freezer{name = "cat ears"},/obj/item/organ/ears/cat,/obj/item/organ/ears/cat,/obj/item/organ/ears/cat,/obj/item/organ/ears/cat,/obj/item/organ/ears/cat,/obj/item/organ/ears/cat,/turf/open/floor/plasteel/freezer,/area/ruin/space/has_grav/powered/cat_man)
"pyi" = (/obj/machinery/atmospherics/components/binary/valve{name = "kitty sleep gas"},/turf/open/floor/plating,/area/ruin/space/has_grav/powered/cat_man)
"pKX" = (/obj/structure/chair,/obj/effect/turf_decal/tile/neutral{dir = 1},/obj/effect/turf_decal/tile/neutral{dir = 4},/turf/open/floor/plasteel,/area/ruin/space/has_grav/powered/cat_man)
"pRo" = (/obj/effect/decal/cleanable/dirt,/obj/effect/decal/cleanable/dirt,/obj/item/reagent_containers/glass/bowl,/turf/open/floor/plating,/area/ruin/space/has_grav/powered/cat_man)
"pYi" = (/obj/effect/decal/cleanable/dirt,/obj/effect/turf_decal/tile/neutral{dir = 1},/obj/effect/turf_decal/tile/neutral{dir = 4},/obj/machinery/atmospherics/pipe/simple/green/hidden{dir = 5},/turf/open/floor/plasteel,/area/ruin/space/has_grav/powered/cat_man)
"qaH" = (/obj/machinery/door/airlock/maintenance_hatch{req_access_txt = "201"},/obj/machinery/atmospherics/pipe/simple/green/hidden,/turf/open/floor/plating,/area/ruin/space/has_grav/powered/cat_man)
"qoW" = (/obj/machinery/door/airlock/external,/obj/effect/mapping_helpers/airlock/cyclelink_helper{dir = 1},/turf/open/floor/plating,/area/ruin/space/has_grav/powered/cat_man)
"qpp" = (/obj/structure/table,/obj/item/reagent_containers/spray/cleaner,/turf/open/floor/plating,/area/ruin/space/has_grav/powered/cat_man)
"qyW" = (/obj/effect/decal/cleanable/dirt,/obj/effect/decal/cleanable/dirt,/obj/item/reagent_containers/glass/bowl,/obj/machinery/atmospherics/pipe/simple/green/hidden{dir = 10},/turf/open/floor/plating,/area/ruin/space/has_grav/powered/cat_man)
"qCa" = (/obj/machinery/atmospherics/pipe/simple/green/hidden{dir = 6},/turf/open/floor/plasteel,/area/ruin/space/has_grav/powered/cat_man)
"qIT" = (/obj/machinery/light/small,/turf/open/floor/plasteel/freezer,/area/ruin/space/has_grav/powered/cat_man)
"qPA" = (/obj/machinery/door/airlock{name = "Limb Storage"; req_access_txt = "200"},/obj/machinery/atmospherics/pipe/simple/dark/hidden,/turf/open/floor/plasteel/freezer,/area/ruin/space/has_grav/powered/cat_man)
"rbr" = (/obj/machinery/space_heater,/turf/open/floor/plating,/area/ruin/space/has_grav/powered/cat_man)
"rUx" = (/obj/structure/dresser,/turf/open/floor/carpet,/area/ruin/space/has_grav/powered/cat_man)
"rXr" = (/obj/effect/decal/cleanable/dirt,/obj/machinery/atmospherics/components/unary/vent_pump/on{dir = 8},/turf/open/floor/plating,/area/ruin/space/has_grav/powered/cat_man)
"sdq" = (/obj/machinery/portable_atmospherics/pump,/turf/open/floor/plating/airless,/area/ruin/space/has_grav/powered/cat_man)
"sey" = (/turf/open/floor/plasteel,/area/ruin/space/has_grav/powered/cat_man)
"sgr" = (/obj/effect/decal/cleanable/dirt,/obj/item/twohanded/required/kirbyplants/random,/obj/effect/turf_decal/tile/neutral,/obj/effect/turf_decal/tile/neutral{dir = 8},/obj/machinery/atmospherics/pipe/simple/green/hidden{dir = 4},/turf/open/floor/plasteel,/area/ruin/space/has_grav/powered/cat_man)
"svo" = (/obj/machinery/atmospherics/miner/n2o,/turf/open/floor/plating/airless,/area/ruin/space/has_grav/powered/cat_man)
"sLg" = (/obj/effect/decal/cleanable/dirt,/obj/effect/decal/cleanable/dirt,/obj/structure/bed/dogbed{name = "kitty bed"},/obj/machinery/atmospherics/pipe/simple/green/hidden{dir = 10},/turf/open/floor/plating,/area/ruin/space/has_grav/powered/cat_man)
"sPi" = (/obj/structure/table/wood,/obj/item/flashlight/lamp,/turf/open/floor/carpet,/area/ruin/space/has_grav/powered/cat_man)
"thk" = (/obj/machinery/atmospherics/pipe/simple/dark/hidden{dir = 10},/turf/open/floor/plating,/area/ruin/space/has_grav/powered/cat_man)
"tqC" = (/obj/effect/turf_decal/tile/neutral,/obj/effect/turf_decal/tile/neutral{dir = 8},/obj/machinery/atmospherics/pipe/simple/green/hidden{dir = 4},/turf/open/floor/plasteel,/area/ruin/space/has_grav/powered/cat_man)
"tEl" = (/obj/structure/reagent_dispensers/water_cooler,/obj/effect/turf_decal/tile/neutral{dir = 1},/obj/effect/turf_decal/tile/neutral{dir = 4},/turf/open/floor/plasteel,/area/ruin/space/has_grav/powered/cat_man)
"tLb" = (/turf/open/floor/plasteel/white/corner{dir = 4},/area/ruin/space/has_grav/powered/cat_man)
"uhm" = (/obj/machinery/door/airlock{name = "Private Quarters"},/turf/open/floor/carpet,/area/ruin/space/has_grav/powered/cat_man)
"uks" = (/obj/effect/decal/cleanable/dirt,/obj/machinery/light/small,/obj/machinery/atmospherics/components/unary/vent_pump/on{dir = 8},/turf/open/floor/plating,/area/ruin/space/has_grav/powered/cat_man)
"uDC" = (/mob/living/simple_animal/hostile/cat_butcherer,/turf/open/floor/plasteel/white/side{dir = 4},/area/ruin/space/has_grav/powered/cat_man)
"uTF" = (/obj/machinery/atmospherics/components/unary/vent_pump/siphon/atmos{dir = 8; id_tag = "n2o_out_cat"; name = "n2o out"},/turf/open/floor/plating/airless,/area/ruin/space/has_grav/powered/cat_man)
"vlQ" = (/obj/machinery/door/airlock/external,/obj/effect/mapping_helpers/airlock/cyclelink_helper,/turf/open/floor/plating,/area/ruin/space/has_grav/powered/cat_man)
"voW" = (/obj/structure/mopbucket,/turf/open/floor/plating,/area/ruin/space/has_grav/powered/cat_man)
"vve" = (/obj/structure/bed/dogbed{name = "kitty bed"},/obj/effect/decal/cleanable/dirt,/obj/effect/mob_spawn/human/corpse/damaged{head = /obj/item/clothing/head/kitty},/turf/open/floor/plating,/area/ruin/space/has_grav/powered/cat_man)
"vAs" = (/obj/effect/decal/cleanable/dirt,/obj/machinery/atmospherics/components/unary/vent_pump/on,/turf/open/floor/plating,/area/ruin/space/has_grav/powered/cat_man)
"vDe" = (/obj/effect/decal/cleanable/dirt,/obj/machinery/door/poddoor/preopen{id = "meow"; name = "kitty protection door"},/obj/machinery/door/window{name = "kitty door"; req_access_txt = "200"},/obj/machinery/atmospherics/pipe/simple/green/hidden,/turf/open/floor/plating,/area/ruin/space/has_grav/powered/cat_man)
"vJP" = (/obj/machinery/atmospherics/pipe/simple/dark/hidden{dir = 9; icon_state = "pipe11-2"},/turf/open/floor/plasteel/freezer,/area/ruin/space/has_grav/powered/cat_man)
"wMX" = (/obj/effect/decal/cleanable/dirt,/obj/effect/decal/cleanable/dirt,/obj/effect/decal/cleanable/dirt,/obj/effect/decal/cleanable/vomit/old,/turf/open/floor/plating,/area/ruin/space/has_grav/powered/cat_man)
"wWm" = (/obj/effect/spawner/structure/window/reinforced,/obj/machinery/door/poddoor/preopen{id = "meow"; name = "kitty protection door"},/turf/open/floor/plating,/area/ruin/space/has_grav/powered/cat_man)
"wZX" = (/turf/open/floor/plasteel/white/side{dir = 1},/area/ruin/space/has_grav/powered/cat_man)
"xkI" = (/turf/open/floor/carpet,/area/ruin/space/has_grav/powered/cat_man)
"xoC" = (/obj/structure/bed,/turf/open/floor/carpet,/area/ruin/space/has_grav/powered/cat_man)
"xDi" = (/obj/structure/closet/crate/freezer{name = "cat meat"},/obj/item/reagent_containers/food/snacks/meat/slab/synthmeat{desc = "A slab of cat meat. Tastes like furball."; name = "cat meat"},/obj/item/reagent_containers/food/snacks/meat/slab/synthmeat{desc = "A slab of cat meat. Tastes like furball."; name = "cat meat"},/obj/item/reagent_containers/food/snacks/meat/slab/synthmeat{desc = "A slab of cat meat. Tastes like furball."; name = "cat meat"},/obj/item/reagent_containers/food/snacks/meat/slab/synthmeat{desc = "A slab of cat meat. Tastes like furball."; name = "cat meat"},/obj/item/reagent_containers/food/snacks/meat/slab/synthmeat{desc = "A slab of cat meat. Tastes like furball."; name = "cat meat"},/obj/item/reagent_containers/food/snacks/meat/slab/synthmeat{desc = "A slab of cat meat. Tastes like furball."; name = "cat meat"},/obj/item/reagent_containers/food/snacks/meat/slab/synthmeat{desc = "A slab of cat meat. Tastes like furball."; name = "cat meat"},/obj/item/reagent_containers/food/snacks/meat/slab/synthmeat{desc = "A slab of cat meat. Tastes like furball."; name = "cat meat"},/turf/open/floor/plasteel/freezer,/area/ruin/space/has_grav/powered/cat_man)
"xDE" = (/obj/effect/decal/cleanable/dirt,/obj/machinery/door/poddoor/preopen{id = "meow"; name = "kitty protection door"},/obj/machinery/door/window/westleft{name = "kitty door"; req_access_txt = "200"},/obj/machinery/atmospherics/pipe/simple/green/hidden{dir = 4},/turf/open/floor/plating,/area/ruin/space/has_grav/powered/cat_man)
"xLl" = (/obj/effect/spawner/structure/window/reinforced,/turf/open/floor/plating,/area/ruin/space/has_grav/powered/cat_man)
"yaB" = (/obj/effect/decal/cleanable/dirt,/obj/effect/decal/cleanable/blood/old,/obj/machinery/light/small{dir = 1},/obj/machinery/atmospherics/components/unary/vent_pump/on{dir = 4},/turf/open/floor/plating,/area/ruin/space/has_grav/powered/cat_man)
"yiv" = (/obj/structure/table/reinforced,/obj/item/retractor,/obj/item/razor,/turf/open/floor/plasteel,/area/ruin/space/has_grav/powered/cat_man)
"ylq" = (/obj/effect/decal/cleanable/cobweb,/turf/open/floor/plating,/area/ruin/space/has_grav/powered/cat_man)

(1,1,1) = {"
arG
arG
arG
arG
arG
arG
arG
arG
arG
arG
arG
arG
arG
arG
arG
arG
aMQ
aMQ
aMQ
aMQ
aMQ
aMQ
aMQ
arG
arG
arG
arG
arG
arG
arG
"}
(2,1,1) = {"
arG
arG
arG
arG
arG
arG
arG
aMQ
aMQ
aMQ
aMQ
ilK
ilK
ilK
ilK
ilK
aMQ
aMQ
aMQ
aMQ
aMQ
aMQ
aMQ
arG
arG
arG
arG
arG
arG
arG
"}
(3,1,1) = {"
arG
arG
arG
arG
arG
arG
aMQ
aMQ
aMQ
aMQ
ilK
ilK
ilK
ilK
ilK
ilK
aMQ
aMQ
aMQ
aMQ
aMQ
aMQ
aMQ
aMQ
aMQ
arG
arG
arG
arG
arG
"}
(4,1,1) = {"
arG
arG
arG
arG
aMQ
aMQ
aMQ
aMQ
aMQ
aMQ
aMQ
ilK
ilK
ilK
ilK
ilK
aMQ
aMQ
aMQ
aMQ
aMQ
aMQ
aMQ
aMQ
aMQ
aMQ
aMQ
aMQ
arG
arG
"}
(5,1,1) = {"
arG
arG
aMQ
aMQ
aMQ
aMQ
ilK
ilK
ilK
aMQ
aMQ
ilK
ilK
ilK
ilK
aMQ
aMQ
aMQ
aMQ
aMQ
aMQ
aMQ
aMQ
aMQ
aMQ
aMQ
aMQ
aMQ
arG
arG
"}
(6,1,1) = {"
arG
arG
ilK
ilK
ilK
ilK
ilK
deE
ffg
deE
aMQ
aMQ
ilK
ilK
ilK
aMQ
aMQ
aMQ
aMQ
aMQ
aMQ
aMQ
aMQ
aMQ
aMQ
ilK
ilK
aMQ
arG
arG
"}
(7,1,1) = {"
arG
arG
aMQ
aMQ
aMQ
aMQ
aMQ
deE
gYz
deE
aMQ
deE
xLl
xLl
xLl
deE
deE
deE
deE
deE
ilK
ilK
ilK
ilK
ilK
ilK
ilK
ilK
arG
arG
"}
(8,1,1) = {"
arG
arG
aMQ
aMQ
deE
deE
deE
deE
dBg
deE
deE
deE
sPi
pcs
awC
deE
ltQ
sey
nWK
deE
xLl
deE
ilK
ilK
ilK
ilK
ilK
ilK
arG
arG
"}
(9,1,1) = {"
arG
aMQ
aMQ
aMQ
deE
ftQ
lgX
deE
eZW
nWK
deE
gGq
xkI
mkN
fUg
deE
oMu
sey
bCW
vlQ
lgX
qoW
ilK
ilK
ilK
ilK
ilK
ilK
arG
arG
"}
(10,1,1) = {"
aMQ
aMQ
aMQ
aMQ
deE
rbr
lgX
ofL
eZW
bCW
uhm
xkI
xkI
xkI
xkI
deE
pKX
sey
lRg
deE
xLl
deE
ilK
ilK
ilK
ilK
ilK
ilK
arG
arG
"}
(11,1,1) = {"
arG
aMQ
aMQ
aMQ
deE
deE
deE
deE
lGr
azh
deE
rUx
kJO
xkI
xoC
deE
tEl
sey
eoK
deE
ilK
ilK
ilK
ilK
ilK
ilK
ilK
ilK
arG
arG
"}
(12,1,1) = {"
arG
arG
aMQ
aMQ
deE
hLF
qpp
deE
eZW
bCW
deE
deE
deE
deE
deE
deE
deE
sey
bCW
deE
deE
deE
deE
deE
aMQ
aMQ
ilK
aMQ
arG
arG
"}
(13,1,1) = {"
arG
arG
aMQ
aMQ
deE
lgX
lgX
jLv
eZW
sey
gPb
sey
fpk
kBu
sey
qCa
cgs
mAt
eKu
qaH
gRw
nTP
bcu
deE
deE
deE
deE
aMQ
arG
arG
"}
(14,1,1) = {"
arG
aMQ
aMQ
aMQ
deE
gUA
voW
deE
deE
deE
deE
eZW
mBL
hSX
yiv
tqC
deE
deE
deE
deE
fTo
thk
bBv
deE
joG
xDi
deE
aMQ
aMQ
arG
"}
(15,1,1) = {"
arG
aMQ
aMQ
aMQ
deE
deE
deE
deE
iNj
iNj
wWm
eZW
jcp
uDC
tLb
tqC
wWm
boj
iNj
deE
fTo
iNj
thk
qPA
vJP
qIT
deE
aMQ
aMQ
arG
"}
(16,1,1) = {"
arG
aMQ
aMQ
aMQ
aMQ
deE
ieM
deE
yaB
avH
wWm
eZW
dxr
fIs
wZX
lIb
wWm
onF
kWh
deE
ldY
pyi
fPT
deE
phG
iiD
deE
aMQ
aMQ
arG
"}
(17,1,1) = {"
arG
aMQ
aMQ
aMQ
aMQ
deE
lgX
deE
sLg
mXT
vDe
pYi
bKh
nLf
gYk
dSP
cxh
mXT
ckK
deE
iNj
deE
bse
deE
deE
deE
deE
aMQ
aMQ
arG
"}
(18,1,1) = {"
arG
aMQ
aMQ
aMQ
aMQ
deE
iNj
deE
deE
deE
deE
fVw
sey
sey
sey
sgr
deE
deE
deE
deE
iNj
deE
uTF
jFV
deE
aMQ
aMQ
aMQ
arG
arG
"}
(19,1,1) = {"
arG
aMQ
aMQ
aMQ
aMQ
deE
iNj
deE
vAs
kmF
vDe
biK
fvr
msV
fvr
npO
cxh
kmF
aRq
deE
iNj
deE
jFV
svo
deE
aMQ
aMQ
aMQ
arG
arG
"}
(20,1,1) = {"
arG
aMQ
aMQ
aMQ
aMQ
deE
iNj
deE
jed
avH
deE
wWm
xDE
deE
xDE
wWm
deE
avH
uks
deE
iNj
deE
deE
deE
deE
aMQ
aMQ
aMQ
arG
arG
"}
(21,1,1) = {"
arG
aMQ
aMQ
aMQ
aMQ
deE
iNj
deE
ovy
pRo
deE
iNj
mSG
deE
ojj
iNj
deE
nsZ
ovy
deE
lgX
cKW
jFV
jpL
deE
aMQ
aMQ
aMQ
aMQ
aMQ
"}
(22,1,1) = {"
arG
aMQ
aMQ
aMQ
aMQ
deE
lgX
deE
deE
deE
deE
gby
rXr
deE
qyW
eOw
deE
deE
deE
deE
iNj
deE
sdq
jpL
deE
aMQ
aMQ
aMQ
arG
arG
"}
(23,1,1) = {"
arG
arG
arG
aMQ
aMQ
deE
iNj
lgX
iNj
iNj
deE
vve
wMX
deE
opo
fTh
deE
ylq
iNj
iNj
lgX
deE
deE
deE
deE
aMQ
aMQ
arG
arG
arG
"}
(24,1,1) = {"
arG
arG
arG
aMQ
aMQ
deE
deE
deE
deE
lgX
deE
deE
deE
deE
deE
deE
deE
lgX
deE
deE
deE
deE
aMQ
aMQ
aMQ
aMQ
aMQ
arG
arG
arG
"}
(25,1,1) = {"
arG
arG
arG
arG
aMQ
aMQ
aMQ
aMQ
deE
iNj
lgX
iNj
iNj
iNj
lgX
iNj
iNj
iNj
deE
aMQ
aMQ
aMQ
aMQ
aMQ
aMQ
aMQ
aMQ
arG
arG
arG
"}
(26,1,1) = {"
arG
arG
arG
arG
aMQ
aMQ
aMQ
aMQ
deE
deE
deE
deE
deE
deE
deE
deE
deE
deE
deE
aMQ
aMQ
aMQ
aMQ
aMQ
aMQ
aMQ
aMQ
arG
arG
arG
"}
(27,1,1) = {"
arG
arG
arG
arG
aMQ
aMQ
aMQ
aMQ
aMQ
aMQ
aMQ
aMQ
aMQ
aMQ
aMQ
aMQ
aMQ
aMQ
aMQ
aMQ
aMQ
aMQ
aMQ
aMQ
aMQ
arG
arG
arG
arG
arG
"}
(28,1,1) = {"
arG
arG
arG
arG
aMQ
aMQ
aMQ
aMQ
aMQ
aMQ
aMQ
aMQ
aMQ
aMQ
aMQ
aMQ
aMQ
aMQ
aMQ
aMQ
aMQ
aMQ
aMQ
aMQ
aMQ
arG
arG
arG
arG
arG
"}
(29,1,1) = {"
arG
arG
arG
arG
aMQ
aMQ
aMQ
aMQ
aMQ
aMQ
aMQ
aMQ
aMQ
aMQ
aMQ
aMQ
aMQ
aMQ
aMQ
aMQ
aMQ
aMQ
aMQ
aMQ
aMQ
arG
arG
arG
arG
arG
"}
(30,1,1) = {"
arG
arG
arG
arG
arG
arG
arG
aMQ
aMQ
aMQ
aMQ
aMQ
aMQ
aMQ
aMQ
aMQ
aMQ
aMQ
aMQ
aMQ
aMQ
arG
arG
arG
arG
arG
arG
arG
arG
arG
"}
(31,1,1) = {"
arG
arG
arG
arG
arG
arG
arG
aMQ
aMQ
aMQ
aMQ
aMQ
aMQ
aMQ
aMQ
arG
arG
arG
arG
arG
arG
arG
arG
arG
arG
arG
arG
arG
arG
arG
"}
(32,1,1) = {"
arG
arG
arG
arG
arG
arG
arG
arG
arG
aMQ
aMQ
aMQ
arG
arG
arG
arG
arG
arG
arG
arG
arG
arG
arG
arG
arG
arG
arG
arG
arG
arG
"}
(33,1,1) = {"
arG
arG
arG
arG
arG
arG
arG
arG
arG
aMQ
aMQ
aMQ
arG
arG
arG
arG
arG
arG
arG
arG
arG
arG
arG
arG
arG
arG
arG
arG
arG
arG
"}
