//MAP CONVERTED BY dmm2tgm.py THIS HEADER COMMENT PREVENTS RECONVERSION, DO NOT REMOVE
"bs" = (
/obj/machinery/door/morgue{
	name = "Study"
	},
/turf/open/floor/wood,
/area/ruin/space/has_grav/powered)
"cl" = (
/turf/template_noop,
/area/space)
"da" = (
/obj/machinery/door/airlock/medical{
	name = "Medical"
	},
/turf/open/floor/plasteel/white,
/area/ruin/space/has_grav/powered)
"eg" = (
/obj/structure/table,
/obj/item/storage/box/lights/mixed,
/turf/open/floor/plating,
/area/ruin/space/has_grav/powered)
"ex" = (
/obj/structure/table/wood/poker,
/obj/item/toy/cards/deck,
/obj/item/reagent_containers/food/drinks/drinkingglass/shotglass{
	pixel_x = -4;
	pixel_y = 11
	},
/turf/open/floor/wood,
/area/ruin/space/has_grav/powered)
"eQ" = (
/obj/structure/dresser,
/turf/open/floor/wood,
/area/ruin/space/has_grav/powered)
"fm" = (
/obj/structure/table,
/obj/item/storage/toolbox/syndicate,
/turf/open/floor/plating,
/area/ruin/space/has_grav/powered)
"fw" = (
/obj/structure/table/wood,
/obj/item/paper_bin{
	pixel_x = -1;
	pixel_y = 6
	},
/turf/open/floor/plasteel/grimy,
/area/ruin/space/has_grav/powered)
"fZ" = (
/obj/structure/fireplace,
/turf/open/floor/wood,
/area/ruin/space/has_grav/powered)
"hD" = (
/obj/machinery/portable_atmospherics/canister/oxygen,
/turf/open/floor/plating,
/area/ruin/space/has_grav/powered)
"in" = (
/turf/open/floor/carpet,
/area/ruin/space/has_grav/powered)
"iv" = (
/turf/open/floor/wood{
	icon_state = "wood-broken6"
	},
/area/ruin/space/has_grav/powered)
"iB" = (
/obj/structure/table/reinforced,
/obj/structure/bedsheetbin,
/turf/open/floor/plasteel/freezer,
/area/ruin/space/has_grav/powered)
"jp" = (
/obj/structure/table,
/obj/item/clothing/suit/space/nasavoid,
/obj/item/clothing/head/helmet/space/nasavoid,
/obj/item/clothing/mask/breath,
/obj/item/tank/internals/oxygen/red,
/obj/effect/decal/cleanable/cobweb/cobweb2,
/turf/open/floor/plating,
/area/ruin/space/has_grav/powered)
"kr" = (
/turf/open/floor/wood,
/area/ruin/space/has_grav/powered)
"ky" = (
/obj/structure/table/reinforced,
/obj/item/storage/box/donkpockets,
/turf/open/floor/plasteel/checker,
/area/ruin/space/has_grav/powered)
"kQ" = (
/obj/effect/decal/cleanable/greenglow,
/turf/open/floor/plating,
/area/ruin/space/has_grav/powered)
"lK" = (
/obj/structure/table/wood,
/obj/item/reagent_containers/food/drinks/mug/coco{
	pixel_x = -7;
	pixel_y = -2
	},
/obj/item/flashlight/lamp/green{
	pixel_x = 5;
	pixel_y = 5
	},
/turf/open/floor/carpet,
/area/ruin/space/has_grav/powered)
"lY" = (
/obj/machinery/computer/arcade/orion_trail,
/turf/open/floor/plasteel/grimy,
/area/ruin/space/has_grav/powered)
"mq" = (
/obj/structure/fans/tiny,
/obj/effect/turf_decal/loading_area{
	dir = 1
	},
/obj/machinery/door/airlock/external,
/obj/effect/mapping_helpers/airlock/cyclelink_helper,
/turf/open/floor/plating,
/area/ruin/space/has_grav/powered)
"nN" = (
/obj/machinery/light{
	dir = 4
	},
/obj/structure/chair/comfy/teal{
	dir = 8
	},
/turf/open/floor/wood,
/area/ruin/space/has_grav/powered)
"oc" = (
/obj/structure/sign/poster/official/bless_this_spess{
	pixel_y = 32
	},
/turf/open/floor/wood,
/area/ruin/space/has_grav/powered)
"od" = (
/obj/structure/sink/kitchen{
	dir = 8;
	pixel_x = 11
	},
/turf/open/floor/plasteel/checker,
/area/ruin/space/has_grav/powered)
"qg" = (
/obj/machinery/door/airlock/hatch{
	name = "Bedroom"
	},
/turf/open/floor/wood,
/area/ruin/space/has_grav/powered)
"sq" = (
/obj/structure/chair/comfy/lime{
	dir = 4
	},
/turf/open/floor/wood,
/area/ruin/space/has_grav/powered)
"tp" = (
/turf/closed/mineral/random/labormineral,
/area/ruin/space/has_grav/powered)
"tE" = (
/obj/machinery/shower,
/obj/structure/curtain,
/obj/structure/window/reinforced{
	dir = 4
	},
/obj/machinery/door/window/southright,
/turf/open/floor/plasteel/freezer,
/area/ruin/space/has_grav/powered)
"xh" = (
/turf/open/floor/plasteel/freezer,
/area/ruin/space/has_grav/powered)
"xw" = (
/obj/machinery/light,
/turf/open/floor/wood{
	icon_state = "wood-broken6"
	},
/area/ruin/space/has_grav/powered)
"ya" = (
/obj/machinery/washing_machine,
/turf/open/floor/plasteel/freezer,
/area/ruin/space/has_grav/powered)
"yq" = (
/obj/structure/sink{
	dir = 4;
	pixel_x = 11
	},
/obj/structure/mirror{
	pixel_x = 25;
	pixel_y = -2
	},
/turf/open/floor/plasteel/freezer,
/area/ruin/space/has_grav/powered)
"yZ" = (
/obj/structure/fans/tiny,
/obj/effect/turf_decal/loading_area,
/obj/machinery/door/airlock/external,
/obj/effect/mapping_helpers/airlock/cyclelink_helper{
	dir = 1
	},
/turf/open/floor/plating,
/area/ruin/space/has_grav/powered)
"zC" = (
/obj/structure/chair/sofa/left{
	dir = 4
	},
/turf/open/floor/wood,
/area/ruin/space/has_grav/powered)
"Aq" = (
/obj/structure/chair/comfy/beige{
	dir = 1
	},
/turf/open/floor/plasteel/grimy,
/area/ruin/space/has_grav/powered)
"Bk" = (
/obj/structure/toilet,
/turf/open/floor/plasteel/freezer,
/area/ruin/space/has_grav/powered)
"Bn" = (
/obj/structure/chair/sofa/left{
	dir = 1
	},
/turf/open/floor/wood,
/area/ruin/space/has_grav/powered)
"BL" = (
/obj/structure/table/reinforced,
/obj/machinery/reagentgrinder{
	desc = "Used to grind things up into raw materials and liquids.";
	pixel_y = 5
	},
/turf/open/floor/plasteel/checker,
/area/ruin/space/has_grav/powered)
"BU" = (
/obj/structure/table/reinforced,
/obj/item/paper/fluff/ruins{
	info = "Welcome, weary traveler. Welcome to my place to rest! Here you can relax and stay a while. Take whatever you want, I do not need anything in return. I am just here to help in the ways that I can. Yours truly, Warner Sarsaparilla, just a normal traveler like you.";
	name = "Welcome Note";
	text = ""
	},
/turf/open/floor/plasteel/checker,
/area/ruin/space/has_grav/powered)
"BY" = (
/obj/structure/closet/secure_closet/freezer/meat/open,
/turf/open/floor/plasteel/checker,
/area/ruin/space/has_grav/powered)
"Cn" = (
/turf/open/floor/plating,
/area/ruin/space/has_grav/powered)
"Cr" = (
/obj/structure/bed/pod,
/obj/item/bedsheet/yellow,
/obj/item/reagent_containers/food/snacks/mint{
	pixel_x = 9;
	pixel_y = -4
	},
/turf/open/floor/carpet,
/area/ruin/space/has_grav/powered)
"DH" = (
/obj/structure/table/reinforced,
/obj/machinery/microwave{
	pixel_y = 4
	},
/obj/machinery/light{
	dir = 1
	},
/turf/open/floor/plasteel/checker,
/area/ruin/space/has_grav/powered)
"El" = (
/obj/structure/chair/sofa/corner{
	dir = 4
	},
/turf/open/floor/wood,
/area/ruin/space/has_grav/powered)
"Ex" = (
/obj/structure/table/reinforced,
/obj/machinery/light{
	dir = 1
	},
/obj/item/gps{
	gpstag = "Cozy Signal"
	},
/turf/open/floor/plasteel/checker,
/area/ruin/space/has_grav/powered)
"EC" = (
/turf/open/floor/wood{
	icon_state = "wood-broken4"
	},
/area/ruin/space/has_grav/powered)
"FF" = (
/obj/machinery/stasis{
	dir = 4
	},
/turf/open/floor/plasteel/white,
/area/ruin/space/has_grav/powered)
"FM" = (
/obj/structure/table/wood/poker,
/obj/item/toy/cards/cardhand{
	pixel_x = 2;
	pixel_y = 1
	},
/obj/item/clothing/mask/cigarette/cigar/cohiba{
	pixel_x = -4;
	pixel_y = 7
	},
/turf/open/floor/wood,
/area/ruin/space/has_grav/powered)
"FN" = (
/obj/structure/closet/secure_closet/chemical{
	req_access = list(0)
	},
/turf/open/floor/plasteel/white,
/area/ruin/space/has_grav/powered)
"Ge" = (
/obj/machinery/light/small,
/obj/structure/reagent_dispensers/watertank,
/turf/open/floor/plating,
/area/ruin/space/has_grav/powered)
"Gk" = (
/turf/closed/wall/r_wall,
/area/ruin/space/has_grav/powered)
"GF" = (
/turf/open/floor/plasteel/white,
/area/ruin/space/has_grav/powered)
"GN" = (
/obj/structure/table/optable,
/turf/open/floor/plasteel/white,
/area/ruin/space/has_grav/powered)
"HZ" = (
/mob/living/simple_animal/bot/medbot{
	name = "Patcher-Upper"
	},
/obj/machinery/light,
/turf/open/floor/plasteel/white,
/area/ruin/space/has_grav/powered)
"Iq" = (
/obj/machinery/light/small,
/obj/structure/closet/secure_closet/personal/cabinet,
/obj/item/clothing/under/yogs/fancysuit,
/obj/item/clothing/shoes/laceup,
/obj/item/clothing/head/yogs/formalhat,
/turf/open/floor/wood{
	icon_state = "wood-broken4"
	},
/area/ruin/space/has_grav/powered)
"Ko" = (
/obj/effect/spawner/structure/window/reinforced/tinted/shutter,
/turf/open/floor/plating,
/area/ruin/space/has_grav/powered)
"MJ" = (
/turf/open/floor/plasteel/checker,
/area/ruin/space/has_grav/powered)
"NS" = (
/obj/machinery/door/airlock/silver,
/turf/open/floor/plasteel/freezer,
/area/ruin/space/has_grav/powered)
"Oa" = (
/turf/open/floor/plasteel/grimy,
/area/ruin/space/has_grav/powered)
"Po" = (
/obj/structure/chair/sofa{
	dir = 4
	},
/obj/machinery/light{
	dir = 8
	},
/turf/open/floor/wood,
/area/ruin/space/has_grav/powered)
"Qa" = (
/turf/closed/wall/r_wall/rust,
/area/ruin/space/has_grav/powered)
"QX" = (
/obj/structure/table/reinforced,
/obj/item/storage/firstaid,
/obj/item/storage/firstaid/toxin,
/obj/item/storage/firstaid,
/turf/open/floor/plasteel/white,
/area/ruin/space/has_grav/powered)
"Sv" = (
/obj/effect/turf_decal/delivery,
/turf/open/floor/plating,
/area/ruin/space/has_grav/powered)
"SI" = (
/obj/machinery/vending/boozeomat/all_access,
/turf/open/floor/plasteel/checker,
/area/ruin/space/has_grav/powered)
"SV" = (
/obj/machinery/sleeper{
	dir = 8
	},
/obj/machinery/light{
	dir = 1
	},
/turf/open/floor/plasteel/white,
/area/ruin/space/has_grav/powered)
"Tf" = (
/obj/item/storage/backpack/duffelbag/med/surgery,
/obj/structure/table/reinforced,
/obj/item/clothing/neck/stethoscope,
/turf/open/floor/plasteel/white,
/area/ruin/space/has_grav/powered)
"TQ" = (
/obj/structure/mopbucket,
/obj/item/mop,
/obj/item/reagent_containers/glass/bucket,
/turf/open/floor/plating,
/area/ruin/space/has_grav/powered)
"Vt" = (
/obj/structure/table/wood,
/obj/item/flashlight/lamp,
/turf/open/floor/plasteel/grimy,
/area/ruin/space/has_grav/powered)
"WH" = (
/obj/structure/cloth_curtain,
/turf/open/floor/carpet,
/area/ruin/space/has_grav/powered)
"WU" = (
/obj/structure/table/wood,
/obj/machinery/computer/libraryconsole/bookmanagement,
/turf/open/floor/plasteel/grimy,
/area/ruin/space/has_grav/powered)
"Xm" = (
/obj/machinery/door/airlock/maintenance_hatch{
	name = "Storage"
	},
/turf/open/floor/plating,
/area/ruin/space/has_grav/powered)
"Yl" = (
/obj/structure/bookcase/random/nonfiction,
/turf/open/floor/plasteel/grimy,
/area/ruin/space/has_grav/powered)
"YC" = (
/obj/structure/table,
/obj/item/stack/sheet/metal/fifty,
/obj/item/stack/sheet/glass/fifty{
	pixel_x = 3;
	pixel_y = 3
	},
/turf/open/floor/plating,
/area/ruin/space/has_grav/powered)

(1,1,1) = {"
cl
cl
cl
cl
cl
cl
cl
cl
cl
cl
cl
cl
cl
cl
cl
cl
cl
cl
cl
cl
cl
cl
cl
cl
cl
cl
cl
cl
cl
cl
"}
(2,1,1) = {"
cl
cl
cl
cl
cl
cl
cl
cl
cl
cl
cl
cl
cl
cl
cl
cl
cl
cl
cl
cl
cl
cl
cl
cl
cl
cl
cl
cl
cl
cl
"}
(3,1,1) = {"
cl
cl
cl
cl
cl
cl
cl
cl
cl
cl
cl
cl
cl
cl
cl
cl
cl
cl
cl
cl
cl
cl
cl
cl
cl
cl
cl
cl
cl
cl
"}
(4,1,1) = {"
cl
cl
cl
cl
cl
cl
cl
cl
cl
cl
cl
cl
cl
cl
cl
cl
cl
cl
cl
cl
cl
cl
cl
cl
cl
cl
cl
cl
cl
cl
"}
(5,1,1) = {"
cl
cl
cl
cl
cl
cl
cl
cl
cl
cl
cl
cl
cl
cl
cl
cl
cl
cl
cl
cl
cl
cl
cl
cl
cl
cl
cl
cl
cl
cl
"}
(6,1,1) = {"
cl
cl
cl
cl
cl
cl
cl
cl
cl
cl
cl
cl
cl
cl
cl
cl
cl
cl
cl
cl
cl
cl
cl
cl
cl
cl
cl
cl
cl
cl
"}
(7,1,1) = {"
cl
cl
cl
cl
cl
cl
cl
cl
cl
cl
cl
cl
cl
cl
cl
cl
cl
cl
cl
cl
cl
cl
cl
cl
cl
cl
cl
cl
cl
cl
"}
(8,1,1) = {"
cl
cl
cl
cl
cl
cl
cl
cl
cl
cl
cl
cl
cl
cl
cl
cl
cl
cl
cl
cl
cl
cl
cl
cl
cl
cl
cl
cl
cl
cl
"}
(9,1,1) = {"
cl
cl
cl
cl
cl
Gk
Gk
Qa
Qa
Gk
Gk
Qa
Gk
Qa
Gk
Qa
Gk
Qa
Gk
Gk
cl
cl
cl
cl
cl
cl
cl
cl
cl
cl
"}
(10,1,1) = {"
cl
cl
cl
cl
tp
Gk
YC
Cn
hD
TQ
Qa
Vt
Oa
Oa
bs
kr
zC
Po
El
Gk
cl
cl
cl
cl
cl
cl
cl
cl
cl
cl
"}
(11,1,1) = {"
cl
cl
cl
cl
tp
Gk
eg
Cn
Cn
Ge
Gk
WU
Aq
lY
Qa
oc
EC
kr
Bn
Gk
Gk
Gk
cl
cl
cl
cl
cl
cl
cl
cl
"}
(12,1,1) = {"
cl
cl
cl
cl
tp
Qa
fm
Cn
kQ
Cn
Gk
fw
Oa
Yl
Gk
fZ
kr
kr
kr
mq
Sv
yZ
cl
cl
cl
cl
cl
cl
cl
cl
"}
(13,1,1) = {"
cl
cl
cl
tp
tp
Gk
jp
Cn
Cn
Cn
Xm
Oa
Oa
Yl
Gk
kr
kr
kr
kr
Gk
Gk
Gk
cl
cl
cl
cl
cl
cl
cl
cl
"}
(14,1,1) = {"
cl
cl
cl
tp
tp
Gk
Qa
Qa
Qa
Gk
Qa
Gk
da
Gk
Qa
Ex
BU
kr
xw
Gk
cl
cl
cl
cl
cl
cl
cl
cl
cl
cl
"}
(15,1,1) = {"
cl
cl
cl
tp
tp
tp
tp
tp
tp
Qa
FN
GF
GF
Gk
ky
MJ
MJ
kr
sq
Ko
cl
cl
cl
cl
cl
cl
cl
cl
cl
cl
"}
(16,1,1) = {"
cl
cl
cl
tp
tp
Gk
Qa
Qa
Gk
Gk
FF
GF
GF
Qa
BL
MJ
MJ
kr
FM
Ko
cl
cl
cl
cl
cl
cl
cl
cl
cl
cl
"}
(17,1,1) = {"
cl
cl
cl
tp
tp
Qa
tE
xh
iB
Gk
SV
GF
HZ
Gk
DH
MJ
MJ
kr
ex
Ko
cl
cl
cl
cl
cl
cl
cl
cl
cl
cl
"}
(18,1,1) = {"
cl
cl
cl
tp
tp
Gk
Bk
xh
xh
NS
GF
GF
GF
Gk
BY
od
SI
iv
nN
Ko
cl
cl
cl
cl
cl
cl
cl
cl
cl
cl
"}
(19,1,1) = {"
cl
cl
cl
tp
tp
Gk
yq
xh
ya
Gk
QX
Tf
GN
Qa
Gk
Gk
Qa
qg
Qa
Gk
cl
cl
cl
cl
cl
cl
cl
cl
cl
cl
"}
(20,1,1) = {"
cl
cl
cl
cl
cl
Gk
Gk
Qa
Gk
Gk
Qa
Qa
Gk
Gk
Cr
in
WH
kr
eQ
Gk
cl
cl
cl
cl
cl
cl
cl
cl
cl
cl
"}
(21,1,1) = {"
cl
cl
cl
cl
cl
cl
tp
tp
tp
tp
tp
tp
tp
Qa
lK
in
WH
Iq
Gk
Gk
cl
cl
cl
cl
cl
cl
cl
cl
cl
cl
"}
(22,1,1) = {"
cl
cl
cl
cl
cl
cl
cl
tp
tp
tp
tp
tp
tp
Qa
Gk
Qa
Gk
Gk
Gk
cl
cl
cl
cl
cl
cl
cl
cl
cl
cl
cl
"}
(23,1,1) = {"
cl
cl
cl
cl
cl
cl
cl
cl
cl
cl
tp
tp
tp
tp
tp
tp
tp
tp
cl
cl
cl
cl
cl
cl
cl
cl
cl
cl
cl
cl
"}
(24,1,1) = {"
cl
cl
cl
cl
cl
cl
cl
cl
cl
cl
tp
tp
tp
tp
tp
tp
cl
cl
cl
cl
cl
cl
cl
cl
cl
cl
cl
cl
cl
cl
"}
(25,1,1) = {"
cl
cl
cl
cl
cl
cl
cl
cl
cl
cl
cl
cl
cl
cl
cl
cl
cl
cl
cl
cl
cl
cl
cl
cl
cl
cl
cl
cl
cl
cl
"}
(26,1,1) = {"
cl
cl
cl
cl
cl
cl
cl
cl
cl
cl
cl
cl
cl
cl
cl
cl
cl
cl
cl
cl
cl
cl
cl
cl
cl
cl
cl
cl
cl
cl
"}
(27,1,1) = {"
cl
cl
cl
cl
cl
cl
cl
cl
cl
cl
cl
cl
cl
cl
cl
cl
cl
cl
cl
cl
cl
cl
cl
cl
cl
cl
cl
cl
cl
cl
"}
(28,1,1) = {"
cl
cl
cl
cl
cl
cl
cl
cl
cl
cl
cl
cl
cl
cl
cl
cl
cl
cl
cl
cl
cl
cl
cl
cl
cl
cl
cl
cl
cl
cl
"}
(29,1,1) = {"
cl
cl
cl
cl
cl
cl
cl
cl
cl
cl
cl
cl
cl
cl
cl
cl
cl
cl
cl
cl
cl
cl
cl
cl
cl
cl
cl
cl
cl
cl
"}
(30,1,1) = {"
cl
cl
cl
cl
cl
cl
cl
cl
cl
cl
cl
cl
cl
cl
cl
cl
cl
cl
cl
cl
cl
cl
cl
cl
cl
cl
cl
cl
cl
cl
"}
