//MAP CONVERTED BY dmm2tgm.py THIS HEADER COMMENT PREVENTS RECONVERSION, DO NOT REMOVE
"aa" = (
/turf/open/space,
/area/space)
"ab" = (
/turf/closed/mineral,
/area/ruin/powered/spacebar)
"ac" = (
/turf/open/floor/plating/asteroid,
/area/ruin/powered/spacebar)
"ad" = (
/obj/effect/spawner/structure/window/reinforced,
/turf/open/floor/plating,
/area/ruin/powered/spacebar)
"ae" = (
/turf/closed/wall,
/area/ruin/powered/spacebar)
"af" = (
/obj/effect/spawner/structure/window/shuttle,
/turf/open/floor/plating,
/area/ruin/powered/spacebar)
"ag" = (
/obj/machinery/door/airlock/external,
/obj/effect/mapping_helpers/airlock/cyclelink_helper{
	dir = 4
	},
/turf/open/floor/plating,
/area/ruin/powered/spacebar)
"ah" = (
/obj/machinery/door/airlock/external,
/obj/effect/mapping_helpers/airlock/cyclelink_helper{
	dir = 8
	},
/turf/open/floor/plating,
/area/ruin/powered/spacebar)
"ai" = (
/turf/open/floor/plating/asteroid/airless,
/area/ruin/powered/spacebar)
"aj" = (
/turf/closed/wall/mineral/titanium,
/area/ruin/powered/spacebar)
"al" = (
/obj/structure/chair{
	dir = 1
	},
/obj/machinery/light/small{
	dir = 4
	},
/obj/machinery/light/small{
	dir = 8
	},
/turf/open/floor/mineral/titanium/blue,
/area/ruin/powered/spacebar)
"ao" = (
/turf/open/floor/mineral/titanium/blue,
/area/ruin/powered/spacebar)
"ap" = (
/obj/structure/table,
/obj/machinery/chem_dispenser/drinks/beer{
	dispensable_reagents = list(/datum/reagent/consumable/ethanol/beer,/datum/reagent/consumable/ethanol/kahlua,/datum/reagent/consumable/ethanol/whiskey,/datum/reagent/consumable/ethanol/wine,/datum/reagent/consumable/ethanol/vodka,/datum/reagent/consumable/ethanol/gin,/datum/reagent/consumable/ethanol/rum,/datum/reagent/consumable/ethanol/tequila,/datum/reagent/consumable/ethanol/vermouth,/datum/reagent/consumable/ethanol/cognac,/datum/reagent/consumable/ethanol/ale,/datum/reagent/consumable/ethanol/absinthe,/datum/reagent/consumable/ethanol/hcider,/datum/reagent/consumable/ethanol/creme_de_menthe,/datum/reagent/consumable/ethanol/creme_de_cacao,/datum/reagent/consumable/ethanol/triple_sec,/datum/reagent/consumable/ethanol/sake,/datum/reagent/consumable/ethanol,/datum/reagent/iron,/datum/reagent/toxin/minttoxin,/datum/reagent/consumable/ethanol/atomicbomb,/datum/reagent/consumable/ethanol/fernet);
	emagged_reagents = null;
	name = "Exotic booze dispenser"
	},
/turf/open/floor/wood,
/area/ruin/powered/spacebar)
"aq" = (
/obj/structure/table,
/obj/machinery/chem_dispenser/drinks{
	dispensable_reagents = list(/datum/reagent/water,/datum/reagent/consumable/ice,/datum/reagent/consumable/coffee,/datum/reagent/consumable/cream,/datum/reagent/consumable/tea,/datum/reagent/consumable/icetea,/datum/reagent/consumable/space_cola,/datum/reagent/consumable/spacemountainwind,/datum/reagent/consumable/dr_gibb,/datum/reagent/consumable/space_up,/datum/reagent/consumable/tonic,/datum/reagent/consumable/sodawater,/datum/reagent/consumable/lemon_lime,/datum/reagent/consumable/pwr_game,/datum/reagent/consumable/shamblers,/datum/reagent/consumable/sugar,/datum/reagent/consumable/orangejuice,/datum/reagent/consumable/grenadine,/datum/reagent/consumable/limejuice,/datum/reagent/consumable/tomatojuice,/datum/reagent/consumable/lemonjuice,/datum/reagent/consumable/menthol,/datum/reagent/consumable/ethanol/thirteenloko,/datum/reagent/consumable/ethanol/whiskey_cola,/datum/reagent/toxin/mindbreaker,/datum/reagent/toxin/staminatoxin);
	emagged_reagents = null;
	name = "Exotic soda dispenser"
	},
/turf/open/floor/wood,
/area/ruin/powered/spacebar)
"ar" = (
/obj/structure/table,
/obj/machinery/light/small{
	dir = 1
	},
/obj/item/stack/sheet/metal/fifty,
/obj/item/stack/sheet/metal/fifty,
/obj/item/stack/sheet/glass/fifty,
/obj/item/stack/sheet/glass/fifty,
/turf/open/floor/wood,
/area/ruin/powered/spacebar)
"as" = (
/obj/machinery/autolathe,
/turf/open/floor/wood,
/area/ruin/powered/spacebar)
"at" = (
/obj/structure/table,
/obj/item/toy/figure/bartender{
	pixel_x = -8;
	pixel_y = 5
	},
/obj/item/gun/ballistic/shotgun/doublebarrel,
/obj/item/storage/belt/bandolier,
/obj/item/radio/headset/headset_srv,
/turf/open/floor/wood,
/area/ruin/powered/spacebar)
"au" = (
/obj/structure/table,
/obj/item/reagent_containers/food/drinks/shaker,
/obj/item/reagent_containers/food/condiment/enzyme,
/turf/open/floor/wood,
/area/ruin/powered/spacebar)
"av" = (
/obj/structure/shuttle/engine/propulsion/burst,
/turf/closed/wall/mineral/titanium,
/area/ruin/powered/spacebar)
"aw" = (
/turf/open/floor/wood,
/area/ruin/powered/spacebar)
"ax" = (
/obj/structure/reagent_dispensers/beerkeg,
/turf/open/floor/wood,
/area/ruin/powered/spacebar)
"ay" = (
/obj/structure/chair/stool,
/obj/effect/turf_decal/tile/bar,
/obj/effect/turf_decal/tile/bar{
	dir = 1;
	icon_state = "tile_corner"
	},
/turf/open/floor/plasteel,
/area/ruin/powered/spacebar)
"az" = (
/obj/machinery/door/airlock{
	name = "Bar Storage";
	req_access_txt = "25"
	},
/turf/open/floor/wood,
/area/ruin/powered/spacebar)
"aA" = (
/obj/structure/table,
/obj/machinery/reagentgrinder,
/turf/open/floor/wood,
/area/ruin/powered/spacebar)
"aB" = (
/obj/effect/turf_decal/tile/bar,
/obj/effect/turf_decal/tile/bar{
	dir = 1;
	icon_state = "tile_corner"
	},
/turf/open/floor/plasteel,
/area/ruin/powered/spacebar)
"aC" = (
/obj/machinery/door/airlock/shuttle{
	name = "Escape Pod Airlock"
	},
/turf/open/floor/plasteel/shuttle,
/area/ruin/powered/spacebar)
"aD" = (
/obj/machinery/light{
	dir = 1
	},
/obj/effect/turf_decal/tile/bar,
/obj/effect/turf_decal/tile/bar{
	dir = 1;
	icon_state = "tile_corner"
	},
/turf/open/floor/plasteel,
/area/ruin/powered/spacebar)
"aE" = (
/obj/machinery/button/door{
	id = "spacebardock";
	name = "pod dock door cycle";
	pixel_x = -32
	},
/turf/open/floor/wood,
/area/ruin/powered/spacebar)
"aF" = (
/obj/machinery/vending/boozeomat,
/turf/closed/wall,
/area/ruin/powered/spacebar)
"aG" = (
/obj/structure/closet/secure_closet/freezer/kitchen{
	req_access = null;
	req_access_txt = "25"
	},
/turf/open/floor/wood,
/area/ruin/powered/spacebar)
"aH" = (
/obj/machinery/light/small,
/obj/structure/table,
/obj/machinery/microwave,
/turf/open/floor/wood,
/area/ruin/powered/spacebar)
"aI" = (
/obj/structure/closet/secure_closet/freezer/fridge{
	req_access = null;
	req_access_txt = "25"
	},
/turf/open/floor/wood,
/area/ruin/powered/spacebar)
"aJ" = (
/obj/item/rcd_ammo/large,
/obj/item/rcd_ammo/large,
/obj/item/rcd_ammo/large,
/obj/structure/closet/crate/rcd,
/obj/structure/closet/crate,
/turf/open/floor/wood,
/area/ruin/powered/spacebar)
"aN" = (
/obj/structure/table,
/obj/item/reagent_containers/food/drinks/beer,
/obj/item/reagent_containers/glass/rag,
/turf/open/floor/wood,
/area/ruin/powered/spacebar)
"aO" = (
/obj/machinery/door/airlock{
	name = "Bar Storage";
	req_access_txt = "25"
	},
/turf/open/floor/plasteel{
	icon_state = "wood"
	},
/area/ruin/powered/spacebar)
"aP" = (
/obj/structure/chair{
	dir = 4;
	icon_state = "chair";
	tag = ""
	},
/obj/effect/turf_decal/tile/bar{
	dir = 1;
	icon_state = "tile_corner"
	},
/turf/open/floor/plasteel,
/area/ruin/powered/spacebar)
"aQ" = (
/obj/structure/table/wood,
/obj/effect/turf_decal/tile/bar{
	dir = 1;
	icon_state = "tile_corner"
	},
/turf/open/floor/plasteel,
/area/ruin/powered/spacebar)
"aR" = (
/obj/structure/chair{
	dir = 8;
	icon_state = "chair";
	tag = ""
	},
/obj/effect/turf_decal/tile/bar{
	dir = 1;
	icon_state = "tile_corner"
	},
/turf/open/floor/plasteel,
/area/ruin/powered/spacebar)
"aU" = (
/obj/machinery/computer/teleporter{
	id = null
	},
/turf/open/floor/plating/asteroid,
/area/ruin/powered/spacebar)
"aV" = (
/obj/machinery/teleport/station,
/turf/open/floor/plating/asteroid,
/area/ruin/powered/spacebar)
"aW" = (
/obj/machinery/teleport/hub,
/turf/open/floor/plating/asteroid,
/area/ruin/powered/spacebar)
"aY" = (
/turf/open/floor/plating,
/area/ruin/powered/spacebar)
"aZ" = (
/obj/effect/turf_decal/tile/bar,
/obj/effect/turf_decal/tile/bar{
	dir = 1;
	icon_state = "tile_corner"
	},
/obj/machinery/light{
	dir = 8;
	icon_state = "tube"
	},
/turf/open/floor/plasteel,
/area/ruin/powered/spacebar)
"ba" = (
/obj/structure/chair{
	dir = 4;
	icon_state = "chair";
	tag = ""
	},
/obj/effect/turf_decal/tile/bar,
/obj/effect/turf_decal/tile/bar{
	dir = 1;
	icon_state = "tile_corner"
	},
/turf/open/floor/plasteel,
/area/ruin/powered/spacebar)
"bb" = (
/obj/structure/table/wood,
/obj/effect/turf_decal/tile/bar,
/obj/effect/turf_decal/tile/bar{
	dir = 1;
	icon_state = "tile_corner"
	},
/turf/open/floor/plasteel,
/area/ruin/powered/spacebar)
"bc" = (
/obj/structure/chair{
	dir = 8;
	icon_state = "chair";
	tag = ""
	},
/obj/effect/turf_decal/tile/bar,
/obj/effect/turf_decal/tile/bar{
	dir = 1;
	icon_state = "tile_corner"
	},
/turf/open/floor/plasteel,
/area/ruin/powered/spacebar)
"bd" = (
/obj/structure/chair,
/obj/effect/turf_decal/tile/bar{
	dir = 1;
	icon_state = "tile_corner"
	},
/turf/open/floor/plasteel,
/area/ruin/powered/spacebar)
"be" = (
/obj/machinery/vending/cola,
/obj/effect/turf_decal/tile/bar,
/obj/effect/turf_decal/tile/bar{
	dir = 1;
	icon_state = "tile_corner"
	},
/turf/open/floor/plasteel,
/area/ruin/powered/spacebar)
"bf" = (
/obj/machinery/vending/cigarette,
/obj/effect/turf_decal/tile/bar,
/obj/effect/turf_decal/tile/bar{
	dir = 1;
	icon_state = "tile_corner"
	},
/turf/open/floor/plasteel,
/area/ruin/powered/spacebar)
"bg" = (
/obj/machinery/vending/coffee,
/obj/effect/turf_decal/tile/bar,
/obj/effect/turf_decal/tile/bar{
	dir = 1;
	icon_state = "tile_corner"
	},
/turf/open/floor/plasteel,
/area/ruin/powered/spacebar)
"bh" = (
/obj/machinery/vending/snack,
/obj/machinery/light,
/obj/effect/turf_decal/tile/bar,
/obj/effect/turf_decal/tile/bar{
	dir = 1;
	icon_state = "tile_corner"
	},
/turf/open/floor/plasteel,
/area/ruin/powered/spacebar)
"bi" = (
/obj/machinery/vending/dinnerware,
/obj/effect/turf_decal/tile/bar,
/obj/effect/turf_decal/tile/bar{
	dir = 1;
	icon_state = "tile_corner"
	},
/turf/open/floor/plasteel,
/area/ruin/powered/spacebar)
"bj" = (
/obj/structure/chair{
	dir = 1
	},
/obj/effect/turf_decal/tile/bar{
	dir = 1;
	icon_state = "tile_corner"
	},
/turf/open/floor/plasteel,
/area/ruin/powered/spacebar)
"bk" = (
/obj/machinery/computer/arcade/orion_trail,
/obj/effect/turf_decal/tile/bar,
/obj/effect/turf_decal/tile/bar{
	dir = 1;
	icon_state = "tile_corner"
	},
/turf/open/floor/plasteel,
/area/ruin/powered/spacebar)
"bl" = (
/obj/machinery/door/airlock{
	name = "Unisex Bathroom"
	},
/turf/open/floor/plasteel/freezer,
/area/ruin/powered/spacebar)
"bm" = (
/obj/machinery/computer/arcade/battle,
/obj/effect/turf_decal/tile/bar,
/obj/effect/turf_decal/tile/bar{
	dir = 1;
	icon_state = "tile_corner"
	},
/turf/open/floor/plasteel,
/area/ruin/powered/spacebar)
"bn" = (
/obj/structure/urinal{
	pixel_x = -32
	},
/turf/open/floor/plasteel/freezer,
/area/ruin/powered/spacebar)
"bo" = (
/turf/open/floor/plasteel/freezer,
/area/ruin/powered/spacebar)
"bp" = (
/obj/structure/sink{
	dir = 4;
	icon_state = "sink";
	pixel_x = 11
	},
/obj/structure/mirror{
	pixel_x = 28
	},
/turf/open/floor/plasteel/freezer,
/area/ruin/powered/spacebar)
"bq" = (
/obj/structure/chair,
/obj/effect/turf_decal/tile/bar,
/obj/effect/turf_decal/tile/bar{
	dir = 1;
	icon_state = "tile_corner"
	},
/turf/open/floor/plasteel,
/area/ruin/powered/spacebar)
"br" = (
/obj/machinery/light/small{
	dir = 8
	},
/turf/open/floor/plasteel/freezer,
/area/ruin/powered/spacebar)
"bs" = (
/obj/structure/toilet{
	dir = 4
	},
/obj/machinery/light/small{
	dir = 8
	},
/turf/open/floor/plasteel/freezer,
/area/ruin/powered/spacebar)
"bt" = (
/obj/machinery/door/airlock{
	name = "Toilet"
	},
/turf/open/floor/plasteel/freezer,
/area/ruin/powered/spacebar)
"bu" = (
/obj/effect/temp_visual/ratvar/window/single,
/turf/open/floor/plasteel/freezer,
/area/ruin/powered/spacebar)
"bx" = (
/obj/structure/table/wood,
/obj/effect/turf_decal/tile/bar,
/obj/effect/turf_decal/tile/bar{
	dir = 1;
	icon_state = "tile_corner"
	},
/obj/machinery/light{
	dir = 4;
	icon_state = "tube"
	},
/turf/open/floor/plasteel,
/area/ruin/powered/spacebar)
"by" = (
/obj/machinery/door/poddoor/preopen{
	id = "spacebardock";
	name = "airlock dock"
	},
/turf/open/floor/plating,
/area/ruin/powered/spacebar)
"bz" = (
/obj/machinery/door/poddoor{
	id = "spacebardock";
	name = "airlock dock"
	},
/turf/open/floor/plating,
/area/ruin/powered/spacebar)
"bA" = (
/obj/structure/chair{
	dir = 1
	},
/obj/effect/turf_decal/tile/bar,
/obj/effect/turf_decal/tile/bar{
	dir = 1;
	icon_state = "tile_corner"
	},
/turf/open/floor/plasteel,
/area/ruin/powered/spacebar)
"bB" = (
/obj/effect/turf_decal/stripes,
/turf/open/floor/plating,
/area/ruin/powered/spacebar)
"bC" = (
/obj/effect/mob_spawn/human/bartender/alive{
	flavour_text = "<span class='big bold'>You are a space bartender!</span><b> Time to mix drinks and change lives. Do not leave your post under any circumstances!! </b>";
	name = "space bartender sleeper"
	},
/turf/open/floor/wood,
/area/ruin/powered/spacebar)
"bD" = (
/obj/item/radio,
/obj/item/radio,
/turf/open/floor/wood,
/area/ruin/powered/spacebar)
"bE" = (
/obj/structure/table/wood,
/obj/effect/turf_decal/tile/bar{
	dir = 1;
	icon_state = "tile_corner"
	},
/obj/item/gps{
	gpstag = "Space Bar";
	name = "space bar gps"
	},
/turf/open/floor/plasteel,
/area/ruin/powered/spacebar)
"bG" = (
/obj/structure/chair{
	dir = 1
	},
/obj/machinery/light/small{
	dir = 8
	},
/obj/machinery/light/small{
	dir = 4
	},
/turf/open/floor/mineral/titanium/blue,
/area/ruin/powered/spacebar)
"hw" = (
/obj/structure/table,
/mob/living/carbon/monkey{
	name = "Nup Nup"
	},
/obj/item/reagent_containers/food/drinks/bottle/fernet,
/turf/open/floor/wood,
/area/ruin/powered/spacebar)
"ke" = (
/obj/structure/table,
/obj/item/reagent_containers/food/drinks/bottle/patron,
/turf/open/floor/wood,
/area/ruin/powered/spacebar)
"ER" = (
/obj/item/beacon,
/turf/open/floor/plating/asteroid,
/area/ruin/powered/spacebar)
"FA" = (
/obj/machinery/light{
	dir = 8;
	icon_state = "tube"
	},
/turf/open/floor/plating,
/area/ruin/powered/spacebar)
"Sr" = (
/obj/machinery/light{
	dir = 4;
	light_color = "#e8eaff"
	},
/turf/open/floor/plating,
/area/ruin/powered/spacebar)
"SD" = (
/obj/structure/table,
/obj/item/reagent_containers/food/drinks/bottle/lizardwine,
/turf/open/floor/wood,
/area/ruin/powered/spacebar)

(1,1,1) = {"
aa
aa
aa
aa
aa
aa
aa
aa
aa
aa
aa
aa
aa
aa
aa
aa
aa
aa
aa
aa
aa
aa
aa
aa
aa
aa
aa
aa
aa
aa
aa
aa
aa
aa
aa
aa
aa
aa
aa
aa
"}
(2,1,1) = {"
aa
aa
aa
aa
aa
aa
aa
aa
aa
aa
aa
aa
aa
aa
aa
aa
aa
aa
aa
aa
aa
aa
aa
aa
aa
aa
aa
aa
aa
aa
aa
aa
aa
aa
aa
aa
aa
aa
aa
aa
"}
(3,1,1) = {"
aa
aa
aa
aa
aa
aa
aa
aa
aa
aa
aa
aa
aa
aa
aa
aa
aa
aa
aa
aa
aa
aa
aa
aa
aa
aa
aa
aa
aa
aa
aa
aa
aa
aa
aa
aa
aa
aa
aa
aa
"}
(4,1,1) = {"
aa
aa
aa
aa
aa
aa
aa
aa
aa
aa
aa
aa
aa
aa
ab
aa
aa
aa
aa
aa
aa
aa
ab
aa
aa
aa
aa
aa
aa
aa
aa
aa
aa
aa
aa
aa
aa
aa
aa
aa
"}
(5,1,1) = {"
aa
aa
aa
aa
aa
aa
aa
aa
aa
aa
aa
aa
aa
ai
ab
ab
ab
ai
aa
aa
ai
ab
ab
ab
ai
ai
aa
aa
aa
aa
aa
aa
aa
aa
aa
aa
aa
aa
aa
aa
"}
(6,1,1) = {"
aa
aa
aa
aa
aa
aa
aa
aa
aa
aa
aa
ai
ai
ai
ai
ai
ai
ai
ai
ai
ai
ai
ai
ai
ai
ai
ai
ai
aa
aa
aa
aa
aa
aa
aa
aa
aa
aa
aa
aa
"}
(7,1,1) = {"
aa
aa
aa
aa
aa
aa
aa
aa
aa
aa
aa
ai
ai
ad
ad
ae
ad
ai
ai
ad
ad
ad
ad
ad
ad
ad
ai
ae
ag
ae
ai
ai
ab
ab
aa
aa
aa
aa
aa
aa
"}
(8,1,1) = {"
aa
aa
aa
aa
aa
aa
aa
aa
aa
aa
ai
ai
ad
ad
ac
ac
ad
ai
ai
ad
ac
ac
ac
ac
ac
ad
ad
ae
aY
ae
ai
ab
ab
ab
aa
aa
aa
aa
aa
aa
"}
(9,1,1) = {"
aa
aa
aa
aa
aa
aa
aa
aa
aa
ai
ai
ad
ad
ac
ac
ac
ad
ad
ad
ad
ac
ac
ac
ac
ac
ac
ac
ae
aY
ae
ai
ai
ai
ab
ab
aa
aa
aa
aa
aa
"}
(10,1,1) = {"
aa
aa
aa
aa
aa
aa
aa
aa
ai
ai
ad
ad
ac
ac
ac
ac
ac
ac
ac
ac
ac
ac
ac
ac
ac
ac
ac
ae
ah
ae
ae
ai
ai
ab
ab
aa
aa
aa
aa
aa
"}
(11,1,1) = {"
aa
aa
aa
aa
aa
aa
aa
ai
ai
ad
ad
ac
ac
ac
ac
ac
ac
ac
ac
ac
ac
ac
ac
ac
ac
ac
ac
ac
ac
ac
ae
ae
ae
ae
ae
ae
ae
ae
aa
aa
"}
(12,1,1) = {"
aa
aa
aa
aa
aa
aa
ai
ai
ad
ad
ac
aj
aj
aj
av
ac
ac
ac
aU
ac
ac
ac
ac
ac
ac
ac
ac
ac
ac
ac
bB
by
aY
FA
aY
aY
bz
aa
aa
aa
"}
(13,1,1) = {"
aa
aa
aa
aa
aa
aa
ai
ai
ad
ac
ac
af
al
ao
aC
ac
ac
ac
aV
ER
ac
ac
ac
ac
ac
ac
ac
ac
ac
ac
bB
by
aY
aY
aY
aY
bz
aa
aa
aa
"}
(14,1,1) = {"
aa
aa
aa
aa
aa
ai
ai
ai
ad
ac
ac
aj
aj
aj
av
ac
ac
ac
aW
ac
ac
ac
ac
ac
ac
ac
ac
ac
ac
ac
bB
by
aY
aY
aY
aY
bz
aa
aa
aa
"}
(15,1,1) = {"
aa
aa
aa
aa
aa
ai
ai
ai
ad
ac
ac
ac
ac
ac
ac
ac
ac
ac
ac
ac
ac
ac
ac
ac
ac
ac
ac
ac
ac
ac
bB
by
aY
aY
aY
aY
bz
aa
aa
aa
"}
(16,1,1) = {"
aa
aa
aa
aa
ai
ai
ai
ad
ad
ac
ac
ac
ac
ac
ac
ac
ac
ac
ac
ac
ac
ac
ac
aj
aj
aj
av
ac
ac
ac
bB
by
aY
aY
aY
aY
bz
aa
aa
aa
"}
(17,1,1) = {"
aa
aa
aa
aa
ai
ai
ai
ad
ac
ac
ac
ab
ab
ab
ac
ac
ac
ae
ag
ae
ac
ac
ac
af
bG
ao
aC
ac
ac
ac
bB
by
aY
Sr
aY
aY
bz
aa
aa
aa
"}
(18,1,1) = {"
aa
aa
aa
aa
ai
ai
ai
ae
ac
ac
ab
ab
ab
ab
ab
ac
ac
ad
aY
ad
ac
ac
ac
aj
aj
aj
av
ac
ac
ac
ae
ae
ae
ae
ae
ae
ae
ae
aa
aa
"}
(19,1,1) = {"
aa
aa
aa
aa
ai
ai
ai
ad
ac
ab
ab
ab
ab
ab
ab
ac
ac
ad
aY
ad
ac
ac
ac
ac
ac
ac
ac
ac
ac
ac
ac
ac
ae
ai
ai
ai
ai
aa
aa
aa
"}
(20,1,1) = {"
aa
aa
aa
ab
ai
ai
ai
ad
ad
ab
ab
ae
ae
ae
ae
ae
ae
ae
ah
ae
ae
ae
ae
ae
ad
ac
ac
ac
ac
ab
ac
ac
ae
ai
ai
ai
ai
aa
aa
aa
"}
(21,1,1) = {"
aa
aa
aa
ab
ab
ai
ai
ai
ad
ac
ab
ae
ap
aw
aE
hw
ay
aB
aB
aZ
bd
aQ
bj
aB
aB
ad
ac
ac
ab
ab
ab
ac
ae
ai
ai
ai
aa
aa
aa
aa
"}
(22,1,1) = {"
aa
aa
aa
ab
ab
ai
ai
ai
ad
ad
ac
ae
aq
aw
aw
SD
ay
aB
aB
aB
aB
aB
aB
aB
aB
aB
ad
ac
ab
ab
ac
ac
ad
ai
ai
ai
aa
aa
aa
aa
"}
(23,1,1) = {"
aa
aa
aa
aa
ab
ab
ai
ai
ai
ad
ac
ae
ar
aw
aw
aN
ay
aB
aB
ba
aB
aB
aB
aB
aB
aB
aB
ad
ac
ac
ac
ac
ad
ai
ai
aa
aa
aa
aa
aa
"}
(24,1,1) = {"
aa
aa
aa
aa
ab
ab
ai
ai
ai
ad
ac
ae
as
aw
aw
ke
ay
aB
aB
bb
aB
aB
bk
bm
bq
bx
bA
ae
ac
ac
ac
ac
ad
ai
ai
aa
aa
aa
aa
aa
"}
(25,1,1) = {"
aa
aa
aa
aa
aa
ai
ai
ai
ad
ad
ac
ae
ae
az
aF
ae
aB
aB
aB
bc
aB
be
ae
ae
ae
ae
ae
ae
ac
ac
ac
ac
ad
ai
ai
aa
aa
aa
aa
aa
"}
(26,1,1) = {"
aa
aa
aa
aa
aa
ai
ai
ai
ad
ac
ac
ae
at
aw
aG
ae
aB
aB
aB
aB
aB
bf
ae
bn
bn
ae
bs
ae
ab
ac
ac
ac
ad
ai
ai
ai
aa
aa
aa
aa
"}
(27,1,1) = {"
aa
aa
aa
aa
aa
ai
ai
ai
ad
ac
ac
ae
au
aw
aH
ae
aD
aB
aP
aB
aB
bg
ae
bo
bo
ae
bt
ae
ab
ac
ac
ac
ad
ai
ab
ai
aa
aa
aa
aa
"}
(28,1,1) = {"
aa
aa
aa
aa
aa
ai
ai
ai
ad
ac
ac
ae
bC
aw
aI
ae
aB
aB
bE
aB
aB
bh
ae
bo
bo
br
bo
ae
ab
ab
ac
ac
ad
ai
ai
ai
aa
aa
aa
aa
"}
(29,1,1) = {"
aa
aa
aa
aa
aa
ai
ai
ai
ad
ac
ac
ae
bD
aw
aw
aO
aB
aB
aR
aB
aB
bi
ae
bo
bo
bo
bu
ae
ab
ab
ac
ac
ad
ai
ai
ab
aa
aa
aa
aa
"}
(30,1,1) = {"
aa
aa
aa
aa
aa
aa
ai
ai
ad
ac
ac
ae
ax
aA
aJ
ae
aB
aB
aB
aB
aB
aB
bl
bo
bp
bp
bo
ae
ab
ab
ab
ac
ad
ai
ai
ab
aa
aa
aa
aa
"}
(31,1,1) = {"
aa
aa
aa
aa
aa
aa
ai
ai
ad
ac
ac
ae
ae
ae
ae
ae
ae
ad
ad
ad
ad
ae
ae
ae
ae
ae
ae
ae
ab
ab
ab
ac
ad
ai
ai
aa
aa
aa
aa
aa
"}
(32,1,1) = {"
aa
aa
aa
aa
aa
aa
aa
ai
ad
ad
ac
ac
ac
ac
ac
ac
ac
ac
ac
ac
ac
ac
ab
ab
ab
ab
ab
ab
ab
ab
ab
ac
ae
ai
ai
aa
aa
aa
aa
aa
"}
(33,1,1) = {"
aa
aa
aa
aa
aa
aa
aa
ai
ai
ad
ac
ac
ac
ac
ac
ac
ac
ac
ac
ac
ac
ac
ac
ac
ab
ab
ab
ab
ab
ab
ac
ad
ad
ai
ai
aa
aa
aa
aa
aa
"}
(34,1,1) = {"
aa
aa
aa
aa
aa
aa
aa
aa
ai
ad
ad
ad
ad
ac
ac
ac
ac
ad
ad
ad
ad
ad
ac
ac
ac
ac
ac
ac
ac
ad
ad
ae
ai
ai
aa
aa
aa
aa
aa
aa
"}
(35,1,1) = {"
aa
aa
aa
aa
aa
aa
aa
aa
ai
ai
ai
ai
ad
ad
ad
ae
ad
ad
ai
ai
ai
ad
ad
ac
ac
ac
ac
ad
ad
ad
ai
ai
ai
ai
aa
aa
aa
aa
aa
aa
"}
(36,1,1) = {"
aa
aa
aa
aa
aa
aa
aa
aa
aa
ai
ai
ai
ai
ai
ai
ai
ai
ai
ab
ai
ai
ai
ad
ad
ad
ad
ad
ad
ai
ai
ai
ab
ai
aa
aa
aa
aa
aa
aa
aa
"}
(37,1,1) = {"
aa
aa
aa
aa
aa
aa
aa
aa
aa
aa
aa
aa
ai
ai
ai
aa
ab
ab
ab
aa
aa
ai
ai
ai
ai
ai
ai
ai
ai
ai
aa
aa
aa
aa
aa
aa
aa
aa
aa
aa
"}
(38,1,1) = {"
aa
aa
aa
aa
aa
aa
aa
aa
aa
aa
aa
aa
aa
aa
aa
aa
aa
ab
ab
aa
aa
aa
ai
ab
ab
ab
ai
ai
ai
aa
aa
aa
aa
aa
aa
aa
aa
aa
aa
aa
"}
(39,1,1) = {"
aa
aa
aa
aa
aa
aa
aa
aa
aa
aa
aa
aa
aa
aa
aa
aa
aa
aa
aa
aa
aa
aa
aa
aa
aa
aa
aa
aa
aa
aa
aa
aa
aa
aa
aa
aa
aa
aa
aa
aa
"}
(40,1,1) = {"
aa
aa
aa
aa
aa
aa
aa
aa
aa
aa
aa
aa
aa
aa
aa
aa
aa
aa
aa
aa
aa
aa
aa
aa
aa
aa
aa
aa
aa
aa
aa
aa
aa
aa
aa
aa
aa
aa
aa
aa
"}
