//MAP CONVERTED BY dmm2tgm.py THIS HEADER COMMENT PREVENTS RECONVERSION, DO NOT REMOVE
"qu" = (
/turf/template_noop,
/area/template_noop)
"Ak" = (
/obj/effect/landmark/stationroom/ruin/syndicatederelict,
/turf/template_noop,
/area/template_noop)

(1,1,1) = {"
qu
qu
qu
qu
qu
qu
qu
qu
qu
qu
qu
qu
qu
qu
qu
qu
qu
qu
qu
qu
qu
qu
qu
qu
qu
qu
qu
qu
qu
qu
qu
qu
qu
qu
qu
qu
qu
qu
qu
qu
qu
qu
qu
Ak
"}
(2,1,1) = {"
qu
qu
qu
qu
qu
qu
qu
qu
qu
qu
qu
qu
qu
qu
qu
qu
qu
qu
qu
qu
qu
qu
qu
qu
qu
qu
qu
qu
qu
qu
qu
qu
qu
qu
qu
qu
qu
qu
qu
qu
qu
qu
qu
qu
"}
(3,1,1) = {"
qu
qu
qu
qu
qu
qu
qu
qu
qu
qu
qu
qu
qu
qu
qu
qu
qu
qu
qu
qu
qu
qu
qu
qu
qu
qu
qu
qu
qu
qu
qu
qu
qu
qu
qu
qu
qu
qu
qu
qu
qu
qu
qu
qu
"}
(4,1,1) = {"
qu
qu
qu
qu
qu
qu
qu
qu
qu
qu
qu
qu
qu
qu
qu
qu
qu
qu
qu
qu
qu
qu
qu
qu
qu
qu
qu
qu
qu
qu
qu
qu
qu
qu
qu
qu
qu
qu
qu
qu
qu
qu
qu
qu
"}
(5,1,1) = {"
qu
qu
qu
qu
qu
qu
qu
qu
qu
qu
qu
qu
qu
qu
qu
qu
qu
qu
qu
qu
qu
qu
qu
qu
qu
qu
qu
qu
qu
qu
qu
qu
qu
qu
qu
qu
qu
qu
qu
qu
qu
qu
qu
qu
"}
(6,1,1) = {"
qu
qu
qu
qu
qu
qu
qu
qu
qu
qu
qu
qu
qu
qu
qu
qu
qu
qu
qu
qu
qu
qu
qu
qu
qu
qu
qu
qu
qu
qu
qu
qu
qu
qu
qu
qu
qu
qu
qu
qu
qu
qu
qu
qu
"}
(7,1,1) = {"
qu
qu
qu
qu
qu
qu
qu
qu
qu
qu
qu
qu
qu
qu
qu
qu
qu
qu
qu
qu
qu
qu
qu
qu
qu
qu
qu
qu
qu
qu
qu
qu
qu
qu
qu
qu
qu
qu
qu
qu
qu
qu
qu
qu
"}
(8,1,1) = {"
qu
qu
qu
qu
qu
qu
qu
qu
qu
qu
qu
qu
qu
qu
qu
qu
qu
qu
qu
qu
qu
qu
qu
qu
qu
qu
qu
qu
qu
qu
qu
qu
qu
qu
qu
qu
qu
qu
qu
qu
qu
qu
qu
qu
"}
(9,1,1) = {"
qu
qu
qu
qu
qu
qu
qu
qu
qu
qu
qu
qu
qu
qu
qu
qu
qu
qu
qu
qu
qu
qu
qu
qu
qu
qu
qu
qu
qu
qu
qu
qu
qu
qu
qu
qu
qu
qu
qu
qu
qu
qu
qu
qu
"}
(10,1,1) = {"
qu
qu
qu
qu
qu
qu
qu
qu
qu
qu
qu
qu
qu
qu
qu
qu
qu
qu
qu
qu
qu
qu
qu
qu
qu
qu
qu
qu
qu
qu
qu
qu
qu
qu
qu
qu
qu
qu
qu
qu
qu
qu
qu
qu
"}
(11,1,1) = {"
qu
qu
qu
qu
qu
qu
qu
qu
qu
qu
qu
qu
qu
qu
qu
qu
qu
qu
qu
qu
qu
qu
qu
qu
qu
qu
qu
qu
qu
qu
qu
qu
qu
qu
qu
qu
qu
qu
qu
qu
qu
qu
qu
qu
"}
(12,1,1) = {"
qu
qu
qu
qu
qu
qu
qu
qu
qu
qu
qu
qu
qu
qu
qu
qu
qu
qu
qu
qu
qu
qu
qu
qu
qu
qu
qu
qu
qu
qu
qu
qu
qu
qu
qu
qu
qu
qu
qu
qu
qu
qu
qu
qu
"}
(13,1,1) = {"
qu
qu
qu
qu
qu
qu
qu
qu
qu
qu
qu
qu
qu
qu
qu
qu
qu
qu
qu
qu
qu
qu
qu
qu
qu
qu
qu
qu
qu
qu
qu
qu
qu
qu
qu
qu
qu
qu
qu
qu
qu
qu
qu
qu
"}
(14,1,1) = {"
qu
qu
qu
qu
qu
qu
qu
qu
qu
qu
qu
qu
qu
qu
qu
qu
qu
qu
qu
qu
qu
qu
qu
qu
qu
qu
qu
qu
qu
qu
qu
qu
qu
qu
qu
qu
qu
qu
qu
qu
qu
qu
qu
qu
"}
(15,1,1) = {"
qu
qu
qu
qu
qu
qu
qu
qu
qu
qu
qu
qu
qu
qu
qu
qu
qu
qu
qu
qu
qu
qu
qu
qu
qu
qu
qu
qu
qu
qu
qu
qu
qu
qu
qu
qu
qu
qu
qu
qu
qu
qu
qu
qu
"}
(16,1,1) = {"
qu
qu
qu
qu
qu
qu
qu
qu
qu
qu
qu
qu
qu
qu
qu
qu
qu
qu
qu
qu
qu
qu
qu
qu
qu
qu
qu
qu
qu
qu
qu
qu
qu
qu
qu
qu
qu
qu
qu
qu
qu
qu
qu
qu
"}
(17,1,1) = {"
qu
qu
qu
qu
qu
qu
qu
qu
qu
qu
qu
qu
qu
qu
qu
qu
qu
qu
qu
qu
qu
qu
qu
qu
qu
qu
qu
qu
qu
qu
qu
qu
qu
qu
qu
qu
qu
qu
qu
qu
qu
qu
qu
qu
"}
(18,1,1) = {"
qu
qu
qu
qu
qu
qu
qu
qu
qu
qu
qu
qu
qu
qu
qu
qu
qu
qu
qu
qu
qu
qu
qu
qu
qu
qu
qu
qu
qu
qu
qu
qu
qu
qu
qu
qu
qu
qu
qu
qu
qu
qu
qu
qu
"}
(19,1,1) = {"
qu
qu
qu
qu
qu
qu
qu
qu
qu
qu
qu
qu
qu
qu
qu
qu
qu
qu
qu
qu
qu
qu
qu
qu
qu
qu
qu
qu
qu
qu
qu
qu
qu
qu
qu
qu
qu
qu
qu
qu
qu
qu
qu
qu
"}
(20,1,1) = {"
qu
qu
qu
qu
qu
qu
qu
qu
qu
qu
qu
qu
qu
qu
qu
qu
qu
qu
qu
qu
qu
qu
qu
qu
qu
qu
qu
qu
qu
qu
qu
qu
qu
qu
qu
qu
qu
qu
qu
qu
qu
qu
qu
qu
"}
(21,1,1) = {"
qu
qu
qu
qu
qu
qu
qu
qu
qu
qu
qu
qu
qu
qu
qu
qu
qu
qu
qu
qu
qu
qu
qu
qu
qu
qu
qu
qu
qu
qu
qu
qu
qu
qu
qu
qu
qu
qu
qu
qu
qu
qu
qu
qu
"}
(22,1,1) = {"
qu
qu
qu
qu
qu
qu
qu
qu
qu
qu
qu
qu
qu
qu
qu
qu
qu
qu
qu
qu
qu
qu
qu
qu
qu
qu
qu
qu
qu
qu
qu
qu
qu
qu
qu
qu
qu
qu
qu
qu
qu
qu
qu
qu
"}
(23,1,1) = {"
qu
qu
qu
qu
qu
qu
qu
qu
qu
qu
qu
qu
qu
qu
qu
qu
qu
qu
qu
qu
qu
qu
qu
qu
qu
qu
qu
qu
qu
qu
qu
qu
qu
qu
qu
qu
qu
qu
qu
qu
qu
qu
qu
qu
"}
(24,1,1) = {"
qu
qu
qu
qu
qu
qu
qu
qu
qu
qu
qu
qu
qu
qu
qu
qu
qu
qu
qu
qu
qu
qu
qu
qu
qu
qu
qu
qu
qu
qu
qu
qu
qu
qu
qu
qu
qu
qu
qu
qu
qu
qu
qu
qu
"}
(25,1,1) = {"
qu
qu
qu
qu
qu
qu
qu
qu
qu
qu
qu
qu
qu
qu
qu
qu
qu
qu
qu
qu
qu
qu
qu
qu
qu
qu
qu
qu
qu
qu
qu
qu
qu
qu
qu
qu
qu
qu
qu
qu
qu
qu
qu
qu
"}
(26,1,1) = {"
qu
qu
qu
qu
qu
qu
qu
qu
qu
qu
qu
qu
qu
qu
qu
qu
qu
qu
qu
qu
qu
qu
qu
qu
qu
qu
qu
qu
qu
qu
qu
qu
qu
qu
qu
qu
qu
qu
qu
qu
qu
qu
qu
qu
"}
(27,1,1) = {"
qu
qu
qu
qu
qu
qu
qu
qu
qu
qu
qu
qu
qu
qu
qu
qu
qu
qu
qu
qu
qu
qu
qu
qu
qu
qu
qu
qu
qu
qu
qu
qu
qu
qu
qu
qu
qu
qu
qu
qu
qu
qu
qu
qu
"}
(28,1,1) = {"
qu
qu
qu
qu
qu
qu
qu
qu
qu
qu
qu
qu
qu
qu
qu
qu
qu
qu
qu
qu
qu
qu
qu
qu
qu
qu
qu
qu
qu
qu
qu
qu
qu
qu
qu
qu
qu
qu
qu
qu
qu
qu
qu
qu
"}
(29,1,1) = {"
qu
qu
qu
qu
qu
qu
qu
qu
qu
qu
qu
qu
qu
qu
qu
qu
qu
qu
qu
qu
qu
qu
qu
qu
qu
qu
qu
qu
qu
qu
qu
qu
qu
qu
qu
qu
qu
qu
qu
qu
qu
qu
qu
qu
"}
(30,1,1) = {"
qu
qu
qu
qu
qu
qu
qu
qu
qu
qu
qu
qu
qu
qu
qu
qu
qu
qu
qu
qu
qu
qu
qu
qu
qu
qu
qu
qu
qu
qu
qu
qu
qu
qu
qu
qu
qu
qu
qu
qu
qu
qu
qu
qu
"}
(31,1,1) = {"
qu
qu
qu
qu
qu
qu
qu
qu
qu
qu
qu
qu
qu
qu
qu
qu
qu
qu
qu
qu
qu
qu
qu
qu
qu
qu
qu
qu
qu
qu
qu
qu
qu
qu
qu
qu
qu
qu
qu
qu
qu
qu
qu
qu
"}
(32,1,1) = {"
qu
qu
qu
qu
qu
qu
qu
qu
qu
qu
qu
qu
qu
qu
qu
qu
qu
qu
qu
qu
qu
qu
qu
qu
qu
qu
qu
qu
qu
qu
qu
qu
qu
qu
qu
qu
qu
qu
qu
qu
qu
qu
qu
qu
"}
(33,1,1) = {"
qu
qu
qu
qu
qu
qu
qu
qu
qu
qu
qu
qu
qu
qu
qu
qu
qu
qu
qu
qu
qu
qu
qu
qu
qu
qu
qu
qu
qu
qu
qu
qu
qu
qu
qu
qu
qu
qu
qu
qu
qu
qu
qu
qu
"}
(34,1,1) = {"
qu
qu
qu
qu
qu
qu
qu
qu
qu
qu
qu
qu
qu
qu
qu
qu
qu
qu
qu
qu
qu
qu
qu
qu
qu
qu
qu
qu
qu
qu
qu
qu
qu
qu
qu
qu
qu
qu
qu
qu
qu
qu
qu
qu
"}
(35,1,1) = {"
qu
qu
qu
qu
qu
qu
qu
qu
qu
qu
qu
qu
qu
qu
qu
qu
qu
qu
qu
qu
qu
qu
qu
qu
qu
qu
qu
qu
qu
qu
qu
qu
qu
qu
qu
qu
qu
qu
qu
qu
qu
qu
qu
qu
"}
(36,1,1) = {"
qu
qu
qu
qu
qu
qu
qu
qu
qu
qu
qu
qu
qu
qu
qu
qu
qu
qu
qu
qu
qu
qu
qu
qu
qu
qu
qu
qu
qu
qu
qu
qu
qu
qu
qu
qu
qu
qu
qu
qu
qu
qu
qu
qu
"}
(37,1,1) = {"
qu
qu
qu
qu
qu
qu
qu
qu
qu
qu
qu
qu
qu
qu
qu
qu
qu
qu
qu
qu
qu
qu
qu
qu
qu
qu
qu
qu
qu
qu
qu
qu
qu
qu
qu
qu
qu
qu
qu
qu
qu
qu
qu
qu
"}
(38,1,1) = {"
qu
qu
qu
qu
qu
qu
qu
qu
qu
qu
qu
qu
qu
qu
qu
qu
qu
qu
qu
qu
qu
qu
qu
qu
qu
qu
qu
qu
qu
qu
qu
qu
qu
qu
qu
qu
qu
qu
qu
qu
qu
qu
qu
qu
"}
(39,1,1) = {"
qu
qu
qu
qu
qu
qu
qu
qu
qu
qu
qu
qu
qu
qu
qu
qu
qu
qu
qu
qu
qu
qu
qu
qu
qu
qu
qu
qu
qu
qu
qu
qu
qu
qu
qu
qu
qu
qu
qu
qu
qu
qu
qu
qu
"}
(40,1,1) = {"
qu
qu
qu
qu
qu
qu
qu
qu
qu
qu
qu
qu
qu
qu
qu
qu
qu
qu
qu
qu
qu
qu
qu
qu
qu
qu
qu
qu
qu
qu
qu
qu
qu
qu
qu
qu
qu
qu
qu
qu
qu
qu
qu
qu
"}
