// This map has been converted using maphash
"alr" = (/obj/structure/lattice,/turf/open/space,/area/space/nearstation)
"asa" = (/obj/effect/overlay/palmtree_r,/turf/open/floor/holofloor/beach,/area/ruin/space/has_grav/powered/aesthetic)
"boi" = (/obj/effect/turf_decal/sand,/turf/open/floor/plasteel/airless{icon_state = "stairs-l"},/area/ruin/unpowered/no_grav)
"byk" = (/obj/structure/fans/tiny,/obj/machinery/door/airlock/hatch,/turf/open/floor/pod/dark,/area/ruin/space/has_grav/powered/aesthetic)
"bPb" = (/obj/structure/window{dir = 8},/turf/open/floor/plasteel/vaporwave,/area/ruin/space/has_grav/powered/aesthetic)
"cwK" = (/turf/open/floor/holofloor/beach,/area/ruin/space/has_grav/powered/aesthetic)
"cZU" = (/obj/structure/table/reinforced,/obj/item/taperecorder,/turf/open/floor/plasteel/vaporwave,/area/ruin/space/has_grav/powered/aesthetic)
"dey" = (/obj/effect/turf_decal/stripes/asteroid/line,/obj/effect/turf_decal/sand/plating,/turf/open/floor/plating{initial_gas_mix = "TEMP=2.7"},/area/ruin/unpowered/no_grav)
"enG" = (/obj/effect/overlay/palmtree_r,/turf/open/floor/plating/asteroid/airless,/area/ruin/unpowered/no_grav)
"eSL" = (/obj/effect/turf_decal/sand/plating,/turf/open/floor/plating{initial_gas_mix = "TEMP=2.7"},/area/ruin/unpowered/no_grav)
"fmb" = (/obj/structure/chair/stool,/obj/machinery/light/small{dir = 1},/turf/open/floor/plasteel/vaporwave,/area/ruin/space/has_grav/powered/aesthetic)
"hDV" = (/turf/closed/wall,/area/ruin/space/has_grav/powered/aesthetic)
"ilK" = (/turf/open/floor/plating/asteroid/airless,/area/ruin/unpowered/no_grav)
"ivX" = (/obj/structure/lattice,/turf/open/floor/plating/asteroid/airless,/area/ruin/unpowered/no_grav)
"kaR" = (/obj/effect/overlay/palmtree_l,/turf/open/floor/holofloor/beach,/area/ruin/space/has_grav/powered/aesthetic)
"kQy" = (/turf/open/floor/plasteel/vaporwave,/area/ruin/space/has_grav/powered/aesthetic)
"kYv" = (/obj/effect/overlay/palmtree_l,/turf/open/floor/plating/asteroid/airless,/area/ruin/unpowered/no_grav)
"mcG" = (/obj/item/statuebust,/turf/open/floor/plasteel/vaporwave,/area/ruin/space/has_grav/powered/aesthetic)
"mgH" = (/obj/structure/chair/comfy/black{dir = 4},/turf/open/floor/plasteel/vaporwave,/area/ruin/space/has_grav/powered/aesthetic)
"mor" = (/obj/effect/turf_decal/sand,/turf/open/floor/plasteel/airless{icon_state = "stairs-r"},/area/ruin/unpowered/no_grav)
"mGY" = (/obj/machinery/light/small{dir = 1},/obj/effect/turf_decal/sand/plating,/turf/open/floor/plating{initial_gas_mix = "TEMP=2.7"},/area/ruin/unpowered/no_grav)
"mHC" = (/mob/living/simple_animal/butterfly,/turf/open/floor/plasteel/vaporwave,/area/ruin/space/has_grav/powered/aesthetic)
"nvx" = (/obj/effect/turf_decal/sand,/turf/open/floor/plasteel/airless{icon_state = "recharge_floor_asteroid"},/area/ruin/unpowered/no_grav)
"nMC" = (/obj/structure/window{dir = 4},/turf/open/floor/plasteel/vaporwave,/area/ruin/space/has_grav/powered/aesthetic)
"oEf" = (/obj/effect/turf_decal/sand,/obj/effect/turf_decal/sand,/turf/open/floor/plasteel/airless,/area/ruin/unpowered/no_grav)
"pVa" = (/obj/structure/closet/crate/bin,/obj/item/tape/random,/turf/open/floor/plating/asteroid/airless,/area/ruin/unpowered/no_grav)
"qFd" = (/obj/structure/chair/comfy/black{dir = 8},/turf/open/floor/plasteel/vaporwave,/area/ruin/space/has_grav/powered/aesthetic)
"rAX" = (/obj/effect/turf_decal/sand,/turf/open/floor/plasteel/airless,/area/ruin/unpowered/no_grav)
"tpv" = (/obj/structure/chair/comfy/black{dir = 8},/obj/machinery/light/small{dir = 1},/turf/open/floor/plasteel/vaporwave,/area/ruin/space/has_grav/powered/aesthetic)
"tAH" = (/obj/structure/table/reinforced,/obj/item/clothing/glasses/sunglasses/big{name = "aesthetic sunglasses"},/turf/open/floor/plasteel/vaporwave,/area/ruin/space/has_grav/powered/aesthetic)
"tBI" = (/turf/open/space,/area/space)
"tXV" = (/obj/effect/turf_decal/sand,/obj/effect/turf_decal/sand/plating,/turf/open/floor/plating{initial_gas_mix = "TEMP=2.7"},/area/ruin/unpowered/no_grav)
"uam" = (/obj/structure/statue/sandstone/venus{dir = 4},/obj/effect/turf_decal/sand/plating,/turf/open/floor/plating{initial_gas_mix = "TEMP=2.7"},/area/ruin/unpowered/no_grav)
"uGD" = (/turf/closed/wall/rust,/area/ruin/space/has_grav/powered/aesthetic)
"vLN" = (/obj/machinery/light/small,/turf/open/floor/plasteel/vaporwave,/area/ruin/space/has_grav/powered/aesthetic)
"wGz" = (/turf/open/floor/holofloor/beach/coast_b,/area/ruin/space/has_grav/powered/aesthetic)
"xaz" = (/obj/structure/statue/sandstone/venus{desc = "Ugh, this is merely an ugly amateurish replica of the other statue! The letters RIPGOAT are scribbled onto the base."; dir = 8},/obj/effect/turf_decal/sand/plating,/turf/open/floor/plating{initial_gas_mix = "TEMP=2.7"},/area/ruin/unpowered/no_grav)
"xeH" = (/obj/structure/piano,/obj/structure/window{dir = 8},/turf/open/floor/plasteel/vaporwave,/area/ruin/space/has_grav/powered/aesthetic)
"xPX" = (/turf/open/floor/holofloor/beach/coast_t,/area/ruin/space/has_grav/powered/aesthetic)
"ydd" = (/obj/structure/lattice,/turf/open/floor/plating/airless,/area/ruin/unpowered/no_grav)
"yjB" = (/obj/item/instrument/eguitar,/turf/open/floor/holofloor/beach,/area/ruin/space/has_grav/powered/aesthetic)
"ylI" = (/obj/effect/turf_decal/sand,/turf/open/floor/plasteel/airless{icon_state = "stairs-m"},/area/ruin/unpowered/no_grav)

(1,1,1) = {"
tBI
tBI
tBI
tBI
tBI
tBI
alr
tBI
tBI
tBI
tBI
tBI
tBI
tBI
tBI
"}
(2,1,1) = {"
tBI
tBI
tBI
tBI
tBI
ilK
ivX
ilK
tBI
alr
tBI
tBI
tBI
tBI
tBI
"}
(3,1,1) = {"
tBI
tBI
tBI
tBI
ilK
ilK
ivX
ilK
ilK
ivX
ilK
ilK
tBI
tBI
tBI
"}
(4,1,1) = {"
tBI
tBI
tBI
ilK
ilK
ilK
ydd
ivX
ilK
ydd
ilK
ilK
ilK
tBI
tBI
"}
(5,1,1) = {"
tBI
tBI
tBI
ilK
hDV
hDV
uGD
uGD
uGD
hDV
uGD
tXV
ilK
ilK
tBI
"}
(6,1,1) = {"
tBI
tBI
ivX
ilK
hDV
asa
cwK
asa
xPX
wGz
hDV
mGY
ilK
ilK
tBI
"}
(7,1,1) = {"
tBI
alr
ivX
ydd
uGD
xeH
bPb
bPb
bPb
bPb
hDV
eSL
kYv
ilK
ilK
"}
(8,1,1) = {"
tBI
tBI
ilK
ilK
hDV
fmb
kQy
kQy
mcG
vLN
hDV
xaz
oEf
tXV
ilK
"}
(9,1,1) = {"
tBI
tBI
ilK
ilK
hDV
kQy
kQy
kQy
kQy
kQy
hDV
nvx
boi
oEf
ilK
"}
(10,1,1) = {"
tBI
tBI
ilK
ivX
hDV
mgH
mgH
kQy
kQy
kQy
byk
rAX
ylI
rAX
oEf
"}
(11,1,1) = {"
tBI
tBI
ilK
ivX
uGD
cZU
tAH
kQy
kQy
kQy
hDV
nvx
mor
rAX
oEf
"}
(12,1,1) = {"
tBI
tBI
ilK
ivX
uGD
tpv
qFd
kQy
mHC
vLN
uGD
uam
oEf
tXV
tXV
"}
(13,1,1) = {"
alr
alr
ivX
ydd
hDV
nMC
nMC
nMC
nMC
nMC
hDV
dey
enG
ilK
ilK
"}
(14,1,1) = {"
tBI
tBI
ilK
ilK
uGD
kaR
yjB
kaR
xPX
wGz
uGD
mGY
ilK
ilK
tBI
"}
(15,1,1) = {"
tBI
tBI
ilK
ilK
hDV
hDV
uGD
hDV
uGD
uGD
uGD
tXV
ilK
ilK
tBI
"}
(16,1,1) = {"
tBI
tBI
tBI
ilK
ilK
ilK
ydd
ivX
pVa
ydd
ilK
ilK
ilK
tBI
tBI
"}
(17,1,1) = {"
tBI
tBI
tBI
tBI
tBI
ilK
ivX
ilK
ilK
ivX
ilK
ilK
ilK
tBI
tBI
"}
(18,1,1) = {"
tBI
tBI
tBI
tBI
tBI
tBI
alr
ilK
ilK
ilK
ilK
tBI
tBI
tBI
tBI
"}
(19,1,1) = {"
tBI
tBI
tBI
tBI
tBI
tBI
alr
tBI
tBI
tBI
tBI
tBI
tBI
tBI
tBI
"}
