//MAP CONVERTED BY dmm2tgm.py THIS HEADER COMMENT PREVENTS RECONVERSION, DO NOT REMOVE
"a" = (
/turf/open/floor/mineral/titanium/blue/airless,
/area/template_noop)
"d" = (
/obj/structure/closet/crate/freezer/blood,
/turf/open/floor/mineral/titanium/blue/airless,
/area/template_noop)
"g" = (
/turf/template_noop,
/area/template_noop)
"m" = (
/turf/closed/wall/mineral/titanium,
/area/template_noop)
"n" = (
/obj/machinery/door/poddoor{
	id = "QMLoaddoor";
	name = "supply dock loading door"
	},
/obj/machinery/conveyor{
	dir = 8;
	id = "QMLoad"
	},
/obj/machinery/door/firedoor/border_only{
	dir = 4
	},
/obj/machinery/door/firedoor/border_only{
	dir = 8
	},
/turf/open/floor/plating,
/area/template_noop)
"o" = (
/obj/machinery/conveyor{
	dir = 4;
	id = "QMLoad2"
	},
/obj/machinery/door/poddoor{
	id = "QMLoaddoor";
	name = "supply dock loading door"
	},
/obj/machinery/door/firedoor/border_only{
	dir = 4
	},
/obj/machinery/door/firedoor/border_only{
	dir = 8
	},
/turf/open/floor/plating,
/area/template_noop)
"p" = (
/obj/machinery/power/engine_capacitor_bank{
	dir = 1
	},
/obj/structure/window/reinforced{
	dir = 1
	},
/turf/open/floor/plating,
/area/template_noop)
"u" = (
/obj/structure/closet/crate/radiation,
/turf/open/floor/mineral/titanium/blue/airless,
/area/template_noop)
"v" = (
/mob/living/simple_animal/hostile/mimic/crate,
/turf/open/floor/mineral/titanium/blue/airless,
/area/template_noop)
"x" = (
/obj/effect/spawner/lootdrop/crate_spawner,
/turf/open/floor/mineral/titanium/blue/airless,
/area/template_noop)
"y" = (
/obj/machinery/door/airlock/titanium{
	name = "Supply Shuttle Airlock";
	req_access_txt = "31"
	},
/turf/open/space/basic,
/area/template_noop)
"B" = (
/obj/structure/closet/crate/engineering/electrical,
/turf/open/floor/mineral/titanium/blue/airless,
/area/template_noop)
"C" = (
/obj/machinery/shuttle/engine{
	dir = 1
	},
/turf/open/floor/plating,
/area/template_noop)
"R" = (
/obj/structure/closet/crate/freezer/surplus_limbs,
/turf/open/floor/mineral/titanium/blue/airless,
/area/template_noop)
"S" = (
/obj/structure/closet/crate/sphere,
/turf/open/floor/mineral/titanium/blue/airless,
/area/template_noop)

(1,1,1) = {"
m
m
m
m
m
m
m
m
m
m
m
g
"}
(2,1,1) = {"
m
x
a
a
d
a
a
a
R
m
m
C
"}
(3,1,1) = {"
m
a
a
a
a
a
x
a
a
a
p
C
"}
(4,1,1) = {"
m
v
a
a
a
S
a
a
a
a
p
C
"}
(5,1,1) = {"
m
a
a
x
a
a
a
a
a
a
p
C
"}
(6,1,1) = {"
m
a
a
a
a
a
a
a
a
B
p
C
"}
(7,1,1) = {"
m
u
a
a
a
a
a
a
a
m
m
C
"}
(8,1,1) = {"
m
m
m
o
y
m
y
n
m
m
m
g
"}
