//MAP CONVERTED BY dmm2tgm.py THIS HEADER COMMENT PREVENTS RECONVERSION, DO NOT REMOVE
"a" = (
/obj/effect/clockwork/overlay/floor/bloodcult,
/turf/open/floor/plasteel/cult/airless,
/area/template_noop)
"h" = (
/obj/effect/clockwork/overlay/floor/bloodcult,
/obj/effect/decal/cleanable/blood/gibs,
/obj/structure/bed,
/obj/item/bedsheet/cult,
/turf/open/floor/plasteel/cult/airless,
/area/template_noop)
"i" = (
/obj/effect/clockwork/overlay/floor/bloodcult,
/obj/machinery/door/airlock/cult/friendly,
/turf/open/floor/plasteel/cult/airless,
/area/template_noop)
"q" = (
/obj/effect/clockwork/overlay/floor/bloodcult,
/obj/structure/destructible/cult/pillar,
/obj/effect/decal/cleanable/blood/gibs/down,
/turf/open/floor/plasteel/cult/airless,
/area/template_noop)
"x" = (
/obj/effect/clockwork/overlay/floor/bloodcult,
/obj/structure/destructible/cult/pillar,
/turf/open/floor/plasteel/cult/airless,
/area/template_noop)
"y" = (
/obj/effect/clockwork/overlay/floor/bloodcult,
/obj/machinery/door/airlock/cult/friendly,
/obj/effect/decal/cleanable/blood/gibs/down,
/turf/open/floor/plasteel/cult/airless,
/area/template_noop)
"z" = (
/obj/effect/clockwork/overlay/floor/bloodcult,
/mob/living/simple_animal/hostile/netherworld/fcult/blindone,
/turf/open/floor/plasteel/cult/airless,
/area/template_noop)
"A" = (
/obj/effect/clockwork/overlay/floor/bloodcult,
/obj/item/toy/plush/narplush,
/turf/open/floor/plasteel/cult/airless,
/area/template_noop)
"C" = (
/obj/effect/clockwork/overlay/floor/bloodcult,
/obj/effect/decal/cleanable/blood/gibs/down,
/turf/open/floor/plasteel/cult/airless,
/area/template_noop)
"H" = (
/turf/closed/wall/mineral/cult,
/area/template_noop)
"J" = (
/obj/effect/clockwork/overlay/floor/bloodcult,
/obj/machinery/door/airlock/cult/unruned/glass/friendly,
/turf/open/floor/plasteel/cult/airless,
/area/template_noop)
"M" = (
/obj/effect/clockwork/overlay/floor/bloodcult,
/obj/effect/decal/cleanable/blood/gibs,
/turf/open/floor/plasteel/cult/airless,
/area/template_noop)
"N" = (
/obj/effect/clockwork/overlay/floor/bloodcult,
/turf/closed/wall/mineral/cult,
/area/template_noop)
"P" = (
/obj/effect/clockwork/overlay/floor/bloodcult,
/obj/item/toy/toy_dagger,
/turf/open/floor/plasteel/cult/airless,
/area/template_noop)
"W" = (
/obj/effect/clockwork/overlay/floor/bloodcult,
/obj/structure/destructible/cult/forge,
/turf/open/floor/plasteel/cult/airless,
/area/template_noop)
"Z" = (
/turf/template_noop,
/area/template_noop)

(1,1,1) = {"
N
N
N
Z
Z
Z
Z
Z
H
N
N
N
"}
(2,1,1) = {"
N
h
N
Z
Z
Z
Z
Z
H
M
W
N
"}
(3,1,1) = {"
N
z
y
N
N
N
N
N
N
i
A
N
"}
(4,1,1) = {"
H
H
a
x
a
M
a
P
a
a
H
H
"}
(5,1,1) = {"
H
H
a
C
a
a
a
q
a
a
H
H
"}
(6,1,1) = {"
N
a
i
N
N
J
N
N
N
i
a
N
"}
(7,1,1) = {"
N
h
N
Z
Z
Z
Z
Z
H
a
W
N
"}
(8,1,1) = {"
N
N
N
Z
Z
Z
Z
Z
H
N
N
N
"}
