//MAP CONVERTED BY dmm2tgm.py THIS HEADER COMMENT PREVENTS RECONVERSION, DO NOT REMOVE
"a" = (
/obj/effect/turf_decal/ramp_middle,
/obj/effect/decal/cleanable/dirt,
/turf/open/floor/carpet/red,
/area/template_noop)
"c" = (
/obj/item/storage/fancy/candle_box,
/turf/open/floor/plasteel/cult/airless,
/area/template_noop)
"d" = (
/turf/closed/wall/mineral/titanium/nodiagonal,
/area/template_noop)
"g" = (
/turf/closed/wall/mineral/titanium,
/area/template_noop)
"j" = (
/obj/machinery/door/airlock/shuttle{
	welded = 1
	},
/obj/machinery/door/firedoor/border_only{
	dir = 8
	},
/obj/machinery/door/firedoor/border_only{
	dir = 4
	},
/turf/open/floor/carpet/red,
/area/template_noop)
"n" = (
/obj/structure/chair/pew{
	dir = 1
	},
/obj/effect/decal/cleanable/dirt,
/turf/open/floor/plasteel/cult/airless,
/area/template_noop)
"u" = (
/obj/structure/rack/skeletal/left,
/obj/item/kitchen/knife/ritual,
/obj/effect/decal/cleanable/blood/old,
/obj/effect/turf_decal/siding/wood,
/obj/effect/turf_decal/siding/wood{
	dir = 8
	},
/obj/effect/turf_decal/siding/wood/corner{
	dir = 8
	},
/turf/open/floor/plasteel/cult/airless,
/area/template_noop)
"w" = (
/obj/machinery/shuttle/engine{
	dir = 1
	},
/turf/open/floor/plating,
/area/template_noop)
"x" = (
/obj/structure/fluff/drake_statue{
	pixel_x = 0
	},
/turf/open/floor/plasteel/cult/airless,
/area/template_noop)
"y" = (
/obj/effect/decal/cleanable/cobweb,
/obj/effect/decal/cleanable/dirt,
/turf/open/floor/plasteel/cult/airless,
/area/template_noop)
"B" = (
/obj/structure/statue/resin/ashwalker,
/obj/item/candle/resin{
	pixel_y = -10;
	pixel_x = -12
	},
/obj/item/trash/candle/resin{
	pixel_y = -10;
	pixel_x = 10
	},
/turf/open/floor/plasteel/cult/airless,
/area/template_noop)
"C" = (
/obj/effect/turf_decal/ramp_middle{
	dir = 1
	},
/turf/open/floor/plasteel/stairs/goon/wood_stairs_alone,
/area/template_noop)
"D" = (
/obj/structure/grille,
/obj/structure/window/shuttle/tinted,
/obj/machinery/door/firedoor/border_only{
	dir = 1
	},
/turf/open/floor/plating/airless,
/area/template_noop)
"F" = (
/obj/machinery/power/engine_capacitor_bank{
	dir = 1
	},
/obj/structure/window/reinforced/tinted{
	dir = 1
	},
/turf/open/floor/plating/airless,
/area/template_noop)
"I" = (
/obj/effect/decal/cleanable/cobweb/cobweb2,
/obj/effect/decal/cleanable/dirt,
/turf/open/floor/plasteel/cult/airless,
/area/template_noop)
"M" = (
/obj/effect/decal/cleanable/dirt,
/turf/open/floor/carpet/red,
/area/template_noop)
"N" = (
/obj/structure/rack/skeletal/right,
/obj/item/organ/heart,
/obj/effect/decal/cleanable/blood/old,
/obj/item/candle/resin,
/obj/effect/turf_decal/siding/wood,
/obj/effect/turf_decal/siding/wood{
	dir = 4
	},
/obj/effect/turf_decal/siding/wood/corner,
/turf/open/floor/plasteel/cult/airless,
/area/template_noop)
"Q" = (
/turf/open/floor/plasteel/cult/airless,
/area/template_noop)
"R" = (
/obj/structure/window/reinforced/tinted{
	dir = 1
	},
/obj/machinery/power/engine_capacitor_bank{
	dir = 1
	},
/turf/open/floor/plating/airless,
/area/template_noop)
"V" = (
/obj/structure/chair/pew/left{
	dir = 1
	},
/obj/effect/decal/cleanable/dirt,
/turf/open/floor/plasteel/cult/airless,
/area/template_noop)
"W" = (
/obj/structure/statue/resin/ashwalker,
/obj/item/candle/resin{
	pixel_y = -10;
	pixel_x = 12
	},
/obj/item/trash/candle/resin{
	pixel_y = -10;
	pixel_x = -10
	},
/turf/open/floor/plasteel/cult/airless,
/area/template_noop)
"X" = (
/turf/template_noop,
/area/template_noop)
"Y" = (
/obj/structure/chair/pew/right{
	dir = 1
	},
/obj/effect/decal/cleanable/dirt,
/turf/open/floor/plasteel/cult/airless,
/area/template_noop)
"Z" = (
/obj/item/storage/box/holy/follower,
/turf/open/floor/plasteel/cult/airless,
/area/template_noop)

(1,1,1) = {"
X
X
X
X
X
X
X
X
X
X
X
X
"}
(2,1,1) = {"
X
X
g
d
d
d
j
d
d
d
g
X
"}
(3,1,1) = {"
X
g
d
W
Z
C
a
M
M
M
F
w
"}
(4,1,1) = {"
X
D
y
x
Q
u
a
V
V
V
R
w
"}
(5,1,1) = {"
X
D
I
Q
Q
N
a
n
n
n
R
w
"}
(6,1,1) = {"
X
g
d
B
c
C
a
Y
Y
Y
R
w
"}
(7,1,1) = {"
X
X
g
d
d
d
d
d
d
d
g
X
"}
(8,1,1) = {"
X
X
X
X
X
X
X
X
X
X
X
X
"}
