//MAP CONVERTED BY dmm2tgm.py THIS HEADER COMMENT PREVENTS RECONVERSION, DO NOT REMOVE
"a" = (
/turf/closed/wall/mineral/titanium,
/area/template_noop)
"c" = (
/turf/open/floor/plating,
/area/template_noop)
"d" = (
/obj/structure/table/reinforced,
/obj/machinery/door/window/northleft,
/obj/item/clothing/accessory/armband/science,
/turf/open/floor/mineral/titanium/purple/airless,
/area/template_noop)
"e" = (
/obj/structure/table/reinforced,
/obj/machinery/door/window/northleft,
/obj/item/clothing/accessory/medal/plasma/nobel_science,
/turf/open/floor/mineral/titanium/purple/airless,
/area/template_noop)
"f" = (
/obj/structure/showcase/horrific_experiment,
/turf/open/floor/plating,
/area/template_noop)
"h" = (
/obj/machinery/shuttle/engine{
	dir = 1
	},
/turf/open/floor/plating,
/area/template_noop)
"m" = (
/obj/machinery/door/airlock/science,
/obj/machinery/door/firedoor/border_only{
	dir = 1
	},
/obj/machinery/door/firedoor/border_only,
/turf/open/floor/plating,
/area/template_noop)
"n" = (
/obj/structure/table/reinforced,
/obj/machinery/door/window/northleft,
/turf/open/floor/mineral/titanium/purple/airless,
/area/template_noop)
"p" = (
/turf/open/floor/mineral/titanium/purple/airless,
/area/template_noop)
"q" = (
/obj/machinery/door/airlock/science,
/obj/machinery/door/firedoor/border_only,
/obj/machinery/door/firedoor/border_only{
	dir = 1
	},
/turf/open/floor/plating,
/area/template_noop)
"s" = (
/turf/open/floor/plasteel/bluespace,
/area/template_noop)
"v" = (
/obj/item/relic,
/turf/open/floor/mineral/titanium/airless/broken/two,
/area/template_noop)
"w" = (
/obj/structure/sign/directions/minsky/science,
/turf/closed/wall/mineral/titanium,
/area/template_noop)
"x" = (
/obj/machinery/door/airlock/hatch,
/turf/open/floor/mineral/titanium/purple/airless,
/area/template_noop)
"F" = (
/obj/item/banner/science,
/turf/open/floor/mineral/titanium/purple/airless,
/area/template_noop)
"J" = (
/obj/item/relic,
/turf/open/floor/mineral/titanium/airless/broken/four,
/area/template_noop)
"N" = (
/obj/structure/chair/office,
/turf/open/floor/mineral/titanium/purple/airless,
/area/template_noop)
"S" = (
/obj/effect/spawner/structure/window/shuttle,
/turf/open/floor/plating,
/area/template_noop)
"V" = (
/obj/machinery/power/engine_capacitor_bank{
	dir = 1
	},
/obj/structure/window/reinforced{
	dir = 1
	},
/turf/open/floor/plating,
/area/template_noop)
"Y" = (
/obj/machinery/rnd/experimentor,
/turf/open/floor/plating,
/area/template_noop)

(1,1,1) = {"
a
a
a
a
a
a
x
x
a
a
a
a
"}
(2,1,1) = {"
S
f
c
c
s
a
p
p
n
F
V
h
"}
(3,1,1) = {"
S
c
J
c
s
m
p
p
n
N
V
h
"}
(4,1,1) = {"
S
c
Y
c
c
a
p
p
d
p
V
h
"}
(5,1,1) = {"
S
s
c
v
c
w
p
p
n
p
V
h
"}
(6,1,1) = {"
S
s
c
c
c
q
p
p
e
N
V
h
"}
(7,1,1) = {"
S
c
c
c
f
a
p
p
n
F
V
h
"}
(8,1,1) = {"
a
a
a
a
a
a
x
x
a
a
a
a
"}
