//MAP CONVERTED BY dmm2tgm.py THIS HEADER COMMENT PREVENTS RECONVERSION, DO NOT REMOVE
"a" = (
/turf/open/space/basic,
/area/template_noop)
"c" = (
/obj/structure/window/plastitanium,
/obj/structure/window/plastitanium,
/turf/open/floor/plating,
/area/template_noop)
"m" = (
/obj/machinery/door/poddoor/shutters/window,
/turf/open/floor/plating,
/area/template_noop)
"n" = (
/obj/machinery/shuttle/engine/void,
/turf/open/floor/plating,
/area/template_noop)
"o" = (
/turf/open/floor/engine/airless,
/area/template_noop)
"r" = (
/obj/structure/window/plastitanium,
/turf/open/floor/plating,
/area/template_noop)
"s" = (
/obj/machinery/door/airlock/external/glass,
/turf/open/floor/plating,
/area/template_noop)
"t" = (
/obj/item/organ/cyberimp/chest/spinalspeed/toy,
/turf/open/floor/engine/airless,
/area/template_noop)
"w" = (
/obj/structure/chair,
/turf/open/floor/engine/airless,
/area/template_noop)
"x" = (
/turf/closed/wall/mineral/titanium,
/area/template_noop)
"D" = (
/obj/machinery/mecha_part_fabricator,
/turf/open/floor/engine/airless,
/area/template_noop)
"E" = (
/obj/machinery/computer/rdconsole/robotics,
/turf/open/floor/engine/airless,
/area/template_noop)
"G" = (
/obj/structure/bed/surgical_mat,
/turf/open/floor/engine/airless,
/area/template_noop)
"H" = (
/obj/item/circular_saw,
/turf/open/floor/engine/airless,
/area/template_noop)
"I" = (
/obj/structure/table/reinforced,
/obj/item/stack/sheet/mineral/gold,
/obj/item/stack/sheet/mineral/gold,
/obj/item/stack/sheet/mineral/gold,
/obj/item/stack/sheet/mineral/gold,
/obj/item/stack/sheet/mineral/gold,
/obj/item/stack/sheet/mineral/gold,
/obj/item/stack/sheet/mineral/gold,
/obj/item/stack/sheet/mineral/gold,
/obj/item/stack/sheet/mineral/gold,
/obj/item/stack/sheet/mineral/gold,
/obj/item/stack/sheet/mineral/gold,
/obj/item/stack/sheet/mineral/gold,
/obj/item/stack/sheet/mineral/gold,
/obj/item/stack/sheet/mineral/gold,
/turf/open/floor/engine/airless,
/area/template_noop)
"K" = (
/obj/structure/table/reinforced,
/obj/item/stack/sheet/mineral/silver,
/obj/item/stack/sheet/mineral/silver,
/obj/item/stack/sheet/mineral/silver,
/obj/item/stack/sheet/mineral/silver,
/obj/item/stack/sheet/mineral/silver,
/obj/item/stack/sheet/mineral/silver,
/obj/item/stack/sheet/mineral/silver,
/obj/item/stack/sheet/mineral/silver,
/obj/item/stack/sheet/mineral/silver,
/obj/item/stack/sheet/mineral/silver,
/obj/item/stack/sheet/mineral/silver,
/obj/item/stack/sheet/mineral/silver,
/obj/item/stack/sheet/mineral/silver,
/obj/item/stack/sheet/mineral/silver,
/obj/item/stack/sheet/mineral/silver,
/turf/open/floor/engine/airless,
/area/template_noop)
"L" = (
/obj/structure/shuttle/engine/heater,
/obj/structure/window/reinforced/spawner/north,
/turf/open/floor/plating,
/area/template_noop)
"X" = (
/obj/item/storage/fancy/cigarettes/cigpack_robustgold,
/turf/open/floor/engine/airless,
/area/template_noop)
"Y" = (
/obj/structure/chair/comfy/shuttle,
/turf/open/floor/engine/airless,
/area/template_noop)

(1,1,1) = {"
a
a
a
a
a
a
a
a
a
a
a
a
"}
(2,1,1) = {"
a
a
a
x
x
m
m
m
x
x
x
a
"}
(3,1,1) = {"
x
x
x
x
o
o
o
o
K
I
x
a
"}
(4,1,1) = {"
r
E
Y
o
o
o
o
o
o
o
L
n
"}
(5,1,1) = {"
c
E
Y
o
H
o
o
o
D
o
L
n
"}
(6,1,1) = {"
x
x
x
x
G
t
o
o
w
X
x
a
"}
(7,1,1) = {"
a
a
a
x
x
x
s
x
x
x
x
a
"}
(8,1,1) = {"
a
a
a
a
a
a
a
a
a
a
a
a
"}
