//MAP CONVERTED BY dmm2tgm.py THIS HEADER COMMENT PREVENTS RECONVERSION, DO NOT REMOVE
"a" = (
/obj/structure/table/reinforced,
/obj/machinery/door/window/northleft{
	dir = 8;
	name = "Reception Window"
	},
/obj/machinery/door/firedoor/border_only{
	dir = 8
	},
/obj/machinery/door/firedoor/border_only{
	dir = 4
	},
/turf/open/floor/grass/fairy/green,
/area/template_noop)
"j" = (
/obj/machinery/power/engine_capacitor_bank{
	dir = 1
	},
/obj/structure/window/reinforced{
	dir = 1
	},
/turf/open/floor/plating,
/area/template_noop)
"l" = (
/obj/item/reagent_containers/glass/bucket,
/turf/open/floor/grass/fairy/green,
/area/template_noop)
"r" = (
/turf/template_noop,
/area/template_noop)
"t" = (
/obj/structure/reagent_dispensers/watertank/high,
/turf/open/floor/grass/fairy/green,
/area/template_noop)
"x" = (
/turf/closed/wall/mineral/titanium,
/area/template_noop)
"A" = (
/obj/effect/spawner/structure/window/shuttle,
/turf/open/floor/plating,
/area/template_noop)
"E" = (
/obj/machinery/light{
	dir = 4
	},
/turf/closed/wall/mineral/titanium,
/area/template_noop)
"K" = (
/obj/item/gun/energy/floragun,
/turf/open/floor/grass/fairy/green,
/area/template_noop)
"M" = (
/turf/open/floor/grass/fairy/green,
/area/template_noop)
"P" = (
/obj/machinery/shuttle/engine{
	dir = 1
	},
/turf/open/floor/plating,
/area/template_noop)
"X" = (
/obj/machinery/hydroponics/constructable,
/obj/item/seeds/random,
/turf/open/floor/grass/fairy/green,
/area/template_noop)

(1,1,1) = {"
r
r
r
r
r
r
r
r
r
r
r
r
"}
(2,1,1) = {"
r
x
E
x
E
x
E
x
E
j
P
r
"}
(3,1,1) = {"
r
x
X
M
X
M
X
M
X
x
x
r
"}
(4,1,1) = {"
r
A
M
M
M
M
M
M
M
x
x
r
"}
(5,1,1) = {"
r
A
M
M
M
M
M
M
t
x
x
r
"}
(6,1,1) = {"
r
x
K
M
M
M
M
M
l
x
x
r
"}
(7,1,1) = {"
r
x
a
a
a
a
a
a
a
j
P
r
"}
(8,1,1) = {"
r
r
r
r
r
r
r
r
r
r
r
r
"}
