//MAP CONVERTED BY dmm2tgm.py THIS HEADER COMMENT PREVENTS RECONVERSION, DO NOT REMOVE
"a" = (
/turf/closed/wall/mineral/titanium/nodiagonal,
/area/template_noop)
"b" = (
/obj/structure/table/wood,
/obj/effect/turf_decal/siding/wood,
/obj/effect/decal/cleanable/dirt/dust,
/obj/effect/decal/cleanable/dirt/dust,
/obj/item/reagent_containers/glass/beaker/large,
/obj/item/kitchen/knife,
/obj/item/clothing/suit/apron/chef,
/obj/item/clothing/head/chefhat,
/obj/item/kitchen/rollingpin,
/turf/open/floor/wood/airless/broken/three,
/area/template_noop)
"c" = (
/obj/machinery/door/firedoor/border_only,
/obj/machinery/door/firedoor/border_only{
	dir = 1
	},
/obj/effect/decal/cleanable/dirt/dust,
/turf/open/floor/wood/airless,
/area/template_noop)
"d" = (
/obj/effect/turf_decal/ameritard,
/turf/open/floor/plasteel/airless,
/area/template_noop)
"e" = (
/obj/machinery/door/firedoor/border_only,
/obj/machinery/door/firedoor/border_only{
	dir = 1
	},
/obj/effect/decal/cleanable/dirt/dust,
/turf/open/floor/wood/airless/broken/three,
/area/template_noop)
"f" = (
/obj/effect/turf_decal/ameritard,
/obj/structure/table/glass,
/turf/open/floor/plasteel/airless,
/area/template_noop)
"g" = (
/obj/structure/window/reinforced/tinted{
	dir = 1
	},
/obj/machinery/power/engine_capacitor_bank{
	dir = 1
	},
/obj/structure/window/reinforced/tinted{
	dir = 8
	},
/turf/open/floor/plating,
/area/template_noop)
"i" = (
/obj/effect/turf_decal/ameritard,
/obj/structure/table/glass,
/obj/effect/decal/cleanable/dirt/dust,
/turf/open/floor/plasteel/airless,
/area/template_noop)
"j" = (
/obj/effect/turf_decal/ameritard,
/obj/machinery/jukebox,
/obj/effect/decal/cleanable/dirt/dust,
/turf/open/floor/plasteel/airless,
/area/template_noop)
"l" = (
/obj/effect/decal/cleanable/dirt/dust,
/obj/structure/sink/kitchen{
	pixel_y = 28
	},
/turf/open/floor/wood/airless/broken/three,
/area/template_noop)
"m" = (
/obj/machinery/door/airlock/glass_large{
	doorOpen = 'sound/machines/defib_success.ogg'
	},
/obj/machinery/door/firedoor/border_only,
/obj/machinery/door/firedoor/border_only{
	dir = 1
	},
/obj/effect/decal/cleanable/dirt/dust,
/turf/open/floor/wood/airless,
/area/template_noop)
"n" = (
/obj/effect/turf_decal/ameritard,
/obj/structure/chair/americandiner/booth/end_left,
/turf/open/floor/plasteel/airless,
/area/template_noop)
"o" = (
/obj/effect/turf_decal/ameritard,
/obj/structure/chair/stool/bar,
/turf/open/floor/plasteel/airless,
/area/template_noop)
"p" = (
/obj/effect/turf_decal/ameritard,
/obj/item/kirbyplants,
/turf/open/floor/plasteel/airless,
/area/template_noop)
"q" = (
/obj/structure/table/wood,
/obj/effect/turf_decal/siding/wood,
/obj/machinery/coffeemaker,
/obj/item/reagent_containers/food/drinks/bottle/coffeepot,
/obj/effect/decal/cleanable/dirt/dust,
/turf/open/floor/wood/airless,
/area/template_noop)
"t" = (
/obj/effect/turf_decal/ameritard,
/obj/structure/chair/americandiner/booth/end_right{
	dir = 1
	},
/obj/effect/decal/cleanable/dirt/dust,
/turf/open/floor/plasteel/airless,
/area/template_noop)
"u" = (
/obj/structure/table/wood,
/obj/effect/turf_decal/siding/wood,
/obj/effect/decal/cleanable/dirt/dust,
/turf/open/floor/wood/airless,
/area/template_noop)
"w" = (
/obj/effect/turf_decal/ameritard,
/obj/structure/chair/americandiner/booth/end_right,
/turf/open/floor/plasteel/airless,
/area/template_noop)
"y" = (
/obj/machinery/oven,
/obj/effect/decal/cleanable/dirt/dust,
/turf/open/floor/wood/airless,
/area/template_noop)
"z" = (
/obj/machinery/griddle,
/obj/effect/decal/cleanable/dirt/dust,
/obj/item/melee/fryingpan,
/turf/open/floor/wood/airless,
/area/template_noop)
"A" = (
/obj/structure/closet/secure_closet/freezer/fridge/open,
/obj/effect/decal/cleanable/dirt/dust,
/obj/item/reagent_containers/food/snacks/raw_patty,
/obj/item/reagent_containers/food/snacks/raw_patty,
/obj/item/reagent_containers/food/snacks/raw_patty,
/turf/open/floor/wood/airless,
/area/template_noop)
"B" = (
/obj/machinery/shuttle/engine{
	dir = 1
	},
/turf/open/floor/plating,
/area/template_noop)
"C" = (
/turf/template_noop,
/area/template_noop)
"D" = (
/obj/structure/table/wood,
/obj/effect/turf_decal/siding/wood,
/obj/effect/decal/cleanable/dirt/dust,
/turf/open/floor/wood/airless/broken/four,
/area/template_noop)
"E" = (
/obj/structure/window/reinforced/tinted{
	dir = 1
	},
/obj/machinery/power/engine_capacitor_bank{
	dir = 1
	},
/obj/structure/window/reinforced/tinted{
	dir = 4
	},
/turf/open/floor/plating,
/area/template_noop)
"F" = (
/turf/open/floor/wood/airless/broken/two,
/area/template_noop)
"H" = (
/obj/structure/table,
/obj/machinery/microwave,
/obj/effect/decal/cleanable/dirt/dust,
/turf/open/floor/wood/airless,
/area/template_noop)
"I" = (
/turf/open/floor/wood/airless/broken/six,
/area/template_noop)
"J" = (
/obj/effect/turf_decal/ameritard,
/obj/structure/chair/americandiner/booth/end_left{
	dir = 1
	},
/obj/effect/decal/cleanable/dirt/dust,
/turf/open/floor/plasteel/airless,
/area/template_noop)
"K" = (
/obj/machinery/door/window,
/obj/effect/turf_decal/siding/wood,
/turf/open/floor/wood/airless,
/area/template_noop)
"L" = (
/obj/effect/decal/cleanable/dirt/dust,
/turf/open/floor/wood/airless,
/area/template_noop)
"O" = (
/obj/machinery/door/airlock/glass_large{
	doorOpen = 'sound/machines/defib_success.ogg'
	},
/obj/machinery/door/firedoor/border_only,
/obj/machinery/door/firedoor/border_only{
	dir = 1
	},
/obj/effect/decal/cleanable/dirt/dust,
/turf/open/floor/wood/airless/broken/six,
/area/template_noop)
"P" = (
/obj/effect/decal/cleanable/dirt/dust,
/turf/open/floor/wood/airless/broken/two,
/area/template_noop)
"Q" = (
/turf/open/floor/wood/airless/broken/four,
/area/template_noop)
"T" = (
/turf/open/floor/wood/airless,
/area/template_noop)
"V" = (
/obj/effect/spawner/structure/window/shuttle,
/turf/open/floor/plating,
/area/template_noop)
"W" = (
/turf/closed/wall/mineral/titanium,
/area/template_noop)
"X" = (
/obj/machinery/deepfryer,
/obj/effect/decal/cleanable/dirt/dust,
/obj/item/reagent_containers/food/snacks/deadmouse/fat,
/turf/open/floor/wood/airless/broken/three,
/area/template_noop)

(1,1,1) = {"
C
W
a
a
a
a
V
V
V
a
g
B
"}
(2,1,1) = {"
W
a
l
K
d
d
n
i
J
a
E
B
"}
(3,1,1) = {"
a
H
T
D
o
d
w
f
t
a
a
W
"}
(4,1,1) = {"
a
z
F
u
o
d
d
d
d
O
P
m
"}
(5,1,1) = {"
a
y
Q
u
o
d
d
d
d
e
L
c
"}
(6,1,1) = {"
a
X
I
b
o
d
n
f
J
a
a
W
"}
(7,1,1) = {"
W
a
A
q
j
p
w
i
t
a
g
B
"}
(8,1,1) = {"
C
W
a
a
a
a
V
V
V
a
E
B
"}
