//MAP CONVERTED BY dmm2tgm.py THIS HEADER COMMENT PREVENTS RECONVERSION, DO NOT REMOVE
"a" = (
/turf/closed/wall/mineral/cult,
/area/template_noop)
"b" = (
/obj/effect/clockwork/overlay/floor/bloodcult,
/obj/machinery/door/airlock/cult/unruned/glass/friendly,
/turf/open/floor/plasteel/cult/airless,
/area/template_noop)
"e" = (
/obj/effect/clockwork/overlay/floor/bloodcult,
/obj/structure/destructible/cult/pillar,
/obj/effect/decal/cleanable/blood/gibs/down,
/turf/open/floor/plasteel/cult/airless,
/area/template_noop)
"f" = (
/obj/effect/clockwork/overlay/floor/bloodcult,
/turf/open/floor/plasteel/cult/airless,
/area/template_noop)
"h" = (
/obj/effect/clockwork/overlay/floor/bloodcult,
/obj/effect/decal/cleanable/blood/gibs,
/turf/open/floor/plasteel/cult/airless,
/area/template_noop)
"i" = (
/obj/effect/clockwork/overlay/floor/bloodcult,
/turf/closed/wall/mineral/cult,
/area/template_noop)
"k" = (
/obj/effect/clockwork/overlay/floor/bloodcult,
/obj/item/toy/plush/narplush,
/turf/open/floor/plasteel/cult/airless,
/area/template_noop)
"v" = (
/obj/effect/clockwork/overlay/floor/bloodcult,
/obj/effect/decal/cleanable/blood/gibs/down,
/turf/open/floor/plasteel/cult/airless,
/area/template_noop)
"w" = (
/obj/effect/clockwork/overlay/floor/bloodcult,
/obj/item/toy/toy_dagger,
/turf/open/floor/plasteel/cult/airless,
/area/template_noop)
"B" = (
/obj/effect/clockwork/overlay/floor/bloodcult,
/obj/machinery/door/airlock/cult/friendly,
/obj/effect/decal/cleanable/blood/gibs/down,
/turf/open/floor/plasteel/cult/airless,
/area/template_noop)
"J" = (
/obj/effect/clockwork/overlay/floor/bloodcult,
/obj/effect/decal/cleanable/blood/gibs,
/obj/structure/bed,
/obj/item/bedsheet/cult,
/turf/open/floor/plasteel/cult/airless,
/area/template_noop)
"M" = (
/obj/effect/clockwork/overlay/floor/bloodcult,
/mob/living/simple_animal/hostile/netherworld/fcult/blindone,
/turf/open/floor/plasteel/cult/airless,
/area/template_noop)
"O" = (
/turf/template_noop,
/area/template_noop)
"P" = (
/obj/effect/clockwork/overlay/floor/bloodcult,
/obj/structure/destructible/cult/forge,
/turf/open/floor/plasteel/cult/airless,
/area/template_noop)
"W" = (
/obj/effect/clockwork/overlay/floor/bloodcult,
/obj/structure/destructible/cult/pillar,
/turf/open/floor/plasteel/cult/airless,
/area/template_noop)
"X" = (
/obj/effect/clockwork/overlay/floor/bloodcult,
/obj/machinery/door/airlock/cult/friendly,
/turf/open/floor/plasteel/cult/airless,
/area/template_noop)

(1,1,1) = {"
i
i
i
O
O
O
O
O
a
i
i
i
"}
(2,1,1) = {"
i
J
i
O
O
O
O
O
a
h
P
i
"}
(3,1,1) = {"
i
M
B
i
i
i
i
i
i
X
k
i
"}
(4,1,1) = {"
a
a
f
W
f
h
f
w
f
f
a
a
"}
(5,1,1) = {"
a
a
f
v
f
f
f
e
f
f
a
a
"}
(6,1,1) = {"
i
f
X
i
i
b
i
i
i
X
f
i
"}
(7,1,1) = {"
i
J
i
O
O
O
O
O
a
f
P
i
"}
(8,1,1) = {"
i
i
i
O
O
O
O
O
a
i
i
i
"}
