//MAP CONVERTED BY dmm2tgm.py THIS HEADER COMMENT PREVENTS RECONVERSION, DO NOT REMOVE
"a" = (
/obj/effect/clockwork/overlay/floor/bloodcult,
/turf/closed/wall/mineral/cult,
/area/template_noop)
"b" = (
/obj/effect/clockwork/overlay/floor/bloodcult,
/obj/structure/destructible/cult/forge,
/turf/open/floor/plasteel/cult/airless,
/area/template_noop)
"e" = (
/turf/template_noop,
/area/template_noop)
"h" = (
/obj/effect/clockwork/overlay/floor/bloodcult,
/obj/structure/destructible/cult/pillar,
/turf/open/floor/plasteel/cult/airless,
/area/template_noop)
"i" = (
/obj/effect/clockwork/overlay/floor/bloodcult,
/obj/effect/decal/cleanable/blood/gibs/down,
/turf/open/floor/plasteel/cult/airless,
/area/template_noop)
"l" = (
/turf/closed/wall/mineral/cult,
/area/template_noop)
"n" = (
/obj/effect/clockwork/overlay/floor/bloodcult,
/obj/machinery/door/airlock/cult/unruned/glass/friendly,
/turf/open/floor/plasteel/cult/airless,
/area/template_noop)
"q" = (
/obj/effect/clockwork/overlay/floor/bloodcult,
/obj/item/toy/toy_dagger,
/turf/open/floor/plasteel/cult/airless,
/area/template_noop)
"s" = (
/obj/effect/clockwork/overlay/floor/bloodcult,
/obj/structure/destructible/cult/pillar,
/obj/effect/decal/cleanable/blood/gibs/down,
/turf/open/floor/plasteel/cult/airless,
/area/template_noop)
"C" = (
/obj/effect/clockwork/overlay/floor/bloodcult,
/obj/effect/decal/cleanable/blood/gibs,
/turf/open/floor/plasteel/cult/airless,
/area/template_noop)
"D" = (
/obj/effect/clockwork/overlay/floor/bloodcult,
/turf/open/floor/plasteel/cult/airless,
/area/template_noop)
"N" = (
/obj/effect/clockwork/overlay/floor/bloodcult,
/obj/item/toy/plush/narplush,
/turf/open/floor/plasteel/cult/airless,
/area/template_noop)
"O" = (
/obj/effect/clockwork/overlay/floor/bloodcult,
/obj/machinery/door/airlock/cult/friendly,
/turf/open/floor/plasteel/cult/airless,
/area/template_noop)
"Q" = (
/obj/effect/clockwork/overlay/floor/bloodcult,
/mob/living/simple_animal/hostile/netherworld/fcult/blindone,
/turf/open/floor/plasteel/cult/airless,
/area/template_noop)
"V" = (
/obj/effect/clockwork/overlay/floor/bloodcult,
/obj/machinery/door/airlock/cult/friendly,
/obj/effect/decal/cleanable/blood/gibs/down,
/turf/open/floor/plasteel/cult/airless,
/area/template_noop)
"Y" = (
/obj/effect/clockwork/overlay/floor/bloodcult,
/obj/effect/decal/cleanable/blood/gibs,
/obj/structure/bed,
/obj/item/bedsheet/cult,
/turf/open/floor/plasteel/cult/airless,
/area/template_noop)

(1,1,1) = {"
a
a
a
e
e
e
e
e
l
a
a
a
"}
(2,1,1) = {"
a
Y
a
e
e
e
e
e
l
C
b
a
"}
(3,1,1) = {"
a
Q
V
a
a
a
a
a
a
O
N
a
"}
(4,1,1) = {"
l
l
D
h
D
C
D
q
D
D
l
l
"}
(5,1,1) = {"
l
l
D
i
D
D
D
s
D
D
l
l
"}
(6,1,1) = {"
a
D
O
a
a
n
a
a
a
O
D
a
"}
(7,1,1) = {"
a
Y
a
e
e
e
e
e
l
D
b
a
"}
(8,1,1) = {"
a
a
a
e
e
e
e
e
l
a
a
a
"}
