//MAP CONVERTED BY dmm2tgm.py THIS HEADER COMMENT PREVENTS RECONVERSION, DO NOT REMOVE
"a" = (
/turf/closed/wall/mineral/titanium/interior,
/area/template_noop)
"f" = (
/obj/structure/window/plastitanium,
/turf/open/floor/plating,
/area/template_noop)
"h" = (
/obj/item/banner/medical,
/turf/open/floor/plating,
/area/template_noop)
"j" = (
/obj/structure/shuttle/engine/heater,
/obj/structure/window/reinforced/spawner/north,
/turf/open/floor/plating,
/area/template_noop)
"m" = (
/obj/item/clothing/accessory/armband/medblue,
/turf/open/floor/plating,
/area/template_noop)
"o" = (
/obj/structure/shuttle/engine/propulsion,
/turf/open/floor/plating,
/area/template_noop)
"r" = (
/obj/structure/table/reinforced,
/obj/item/pen/fountain/captain,
/obj/item/clothing/accessory/armband/medblue,
/turf/open/floor/plating,
/area/template_noop)
"s" = (
/turf/open/floor/plating,
/area/template_noop)
"t" = (
/turf/closed/wall/mineral/titanium,
/area/template_noop)
"x" = (
/turf/open/floor/mineral/titanium/airless,
/area/template_noop)
"y" = (
/obj/machinery/computer/shuttle,
/turf/open/floor/plating,
/area/template_noop)
"z" = (
/obj/structure/statue/gold/cmo,
/turf/open/floor/mineral/titanium/airless,
/area/template_noop)
"B" = (
/obj/machinery/suit_storage_unit/cmo,
/turf/open/floor/mineral/titanium/blue/airless,
/area/template_noop)
"C" = (
/obj/machinery/sleeper,
/turf/open/floor/mineral/titanium/blue/airless,
/area/template_noop)
"D" = (
/turf/open/floor/mineral/titanium/blue/airless,
/area/template_noop)
"F" = (
/obj/machinery/door/airlock/titanium,
/turf/open/floor/plating,
/area/template_noop)
"G" = (
/turf/open/space/basic,
/area/template_noop)
"M" = (
/turf/open/floor/mineral/titanium/white,
/area/template_noop)
"Q" = (
/obj/structure/statue/gold/cmo,
/turf/open/floor/mineral/titanium/blue/airless,
/area/template_noop)
"S" = (
/obj/item/clothing/accessory/armband/medblue,
/turf/open/floor/mineral/titanium/white,
/area/template_noop)
"T" = (
/mob/living/simple_animal/bot/medbot,
/turf/open/floor/mineral/titanium/blue/airless,
/area/template_noop)
"W" = (
/obj/structure/chair/comfy/shuttle,
/turf/open/floor/plating,
/area/template_noop)
"Y" = (
/obj/structure/sign/departments/minsky/medical/medical2,
/turf/closed/wall/mineral/titanium/interior,
/area/template_noop)

(1,1,1) = {"
G
t
t
F
t
t
t
F
t
t
t
G
"}
(2,1,1) = {"
t
z
x
s
m
s
M
M
S
M
j
o
"}
(3,1,1) = {"
t
x
x
s
s
M
s
M
s
s
j
o
"}
(4,1,1) = {"
f
y
W
x
s
s
h
M
s
h
j
o
"}
(5,1,1) = {"
f
r
W
s
s
D
a
Y
F
a
j
o
"}
(6,1,1) = {"
t
D
D
D
D
D
a
D
T
D
j
o
"}
(7,1,1) = {"
t
Q
D
D
D
D
a
B
C
C
j
o
"}
(8,1,1) = {"
G
t
t
t
t
t
t
t
t
t
t
G
"}
