//MAP CONVERTED BY dmm2tgm.py THIS HEADER COMMENT PREVENTS RECONVERSION, DO NOT REMOVE
"a" = (
/turf/template_noop,
/area/template_noop)
"d" = (
/obj/structure/grille/ratvar,
/obj/structure/window/reinforced/clockwork/fulltile,
/turf/open/floor/clockwork/reebe,
/area/template_noop)
"l" = (
/obj/structure/chair/brass{
	dir = 1
	},
/turf/open/floor/clockwork/reebe,
/area/template_noop)
"t" = (
/turf/closed/wall/clockwork,
/area/template_noop)
"w" = (
/obj/structure/chair/brass{
	dir = 8
	},
/turf/open/floor/clockwork/reebe,
/area/template_noop)
"x" = (
/obj/item/toy/plush/plushvar,
/turf/open/floor/clockwork/reebe,
/area/template_noop)
"y" = (
/obj/machinery/door/airlock/clockwork/brass,
/turf/open/floor/clockwork/reebe,
/area/template_noop)
"A" = (
/obj/structure/table/reinforced/brass,
/obj/item/reagent_containers/food/snacks/spaghetti/pastatomato,
/obj/item/reagent_containers/food/snacks/spaghetti/pastatomato,
/obj/item/reagent_containers/food/snacks/spaghetti/pastatomato,
/obj/item/reagent_containers/food/snacks/spaghetti/pastatomato,
/obj/item/reagent_containers/food/snacks/spaghetti/pastatomato,
/obj/item/reagent_containers/food/snacks/spaghetti/pastatomato,
/obj/item/reagent_containers/food/snacks/spaghetti/pastatomato,
/obj/item/reagent_containers/food/snacks/spaghetti/pastatomato,
/obj/item/reagent_containers/food/snacks/spaghetti/pastatomato,
/turf/open/floor/clockwork/reebe,
/area/template_noop)
"H" = (
/obj/item/kitchen/fork,
/turf/open/floor/clockwork/reebe,
/area/template_noop)
"Q" = (
/turf/open/floor/clockwork/reebe,
/area/template_noop)
"U" = (
/obj/structure/chair/brass,
/turf/open/floor/clockwork/reebe,
/area/template_noop)
"V" = (
/obj/structure/chair/brass{
	dir = 4
	},
/turf/open/floor/clockwork/reebe,
/area/template_noop)

(1,1,1) = {"
a
a
d
d
d
d
d
d
d
d
a
a
"}
(2,1,1) = {"
a
a
d
Q
Q
V
Q
Q
x
d
a
a
"}
(3,1,1) = {"
a
a
y
Q
l
A
U
Q
Q
y
a
a
"}
(4,1,1) = {"
a
a
a
t
Q
w
H
Q
t
a
a
a
"}
(5,1,1) = {"
a
a
a
a
t
Q
Q
t
a
a
a
a
"}
(6,1,1) = {"
a
a
a
a
a
y
y
a
a
a
a
a
"}
(7,1,1) = {"
a
a
a
a
a
a
a
a
a
a
a
a
"}
(8,1,1) = {"
a
a
a
a
a
a
a
a
a
a
a
a
"}
