//MAP CONVERTED BY dmm2tgm.py THIS HEADER COMMENT PREVENTS RECONVERSION, DO NOT REMOVE
"a" = (
/obj/effect/clockwork/overlay/floor/bloodcult,
/turf/open/floor/plasteel/cult/airless,
/area/template_noop)
"c" = (
/obj/effect/clockwork/overlay/floor/bloodcult,
/obj/structure/destructible/cult/pillar,
/turf/open/floor/plasteel/cult/airless,
/area/template_noop)
"d" = (
/turf/template_noop,
/area/template_noop)
"e" = (
/turf/closed/wall/mineral/cult,
/area/template_noop)
"j" = (
/obj/effect/clockwork/overlay/floor/bloodcult,
/obj/item/toy/toy_dagger,
/turf/open/floor/plasteel/cult/airless,
/area/template_noop)
"q" = (
/obj/effect/clockwork/overlay/floor/bloodcult,
/obj/effect/decal/cleanable/blood/gibs,
/obj/structure/bed,
/obj/item/bedsheet/cult,
/turf/open/floor/plasteel/cult/airless,
/area/template_noop)
"v" = (
/obj/effect/clockwork/overlay/floor/bloodcult,
/obj/machinery/door/airlock/cult/unruned/glass/friendly,
/turf/open/floor/plasteel/cult/airless,
/area/template_noop)
"x" = (
/obj/effect/clockwork/overlay/floor/bloodcult,
/mob/living/simple_animal/hostile/netherworld/fcult/blindone,
/turf/open/floor/plasteel/cult/airless,
/area/template_noop)
"y" = (
/obj/effect/clockwork/overlay/floor/bloodcult,
/obj/machinery/door/airlock/cult/friendly,
/turf/open/floor/plasteel/cult/airless,
/area/template_noop)
"A" = (
/obj/effect/clockwork/overlay/floor/bloodcult,
/obj/effect/decal/cleanable/blood/gibs,
/turf/open/floor/plasteel/cult/airless,
/area/template_noop)
"C" = (
/obj/effect/clockwork/overlay/floor/bloodcult,
/turf/closed/wall/mineral/cult,
/area/template_noop)
"F" = (
/obj/effect/clockwork/overlay/floor/bloodcult,
/obj/machinery/door/airlock/cult/friendly,
/obj/effect/decal/cleanable/blood/gibs/down,
/turf/open/floor/plasteel/cult/airless,
/area/template_noop)
"H" = (
/obj/effect/clockwork/overlay/floor/bloodcult,
/obj/structure/destructible/cult/pillar,
/obj/effect/decal/cleanable/blood/gibs/down,
/turf/open/floor/plasteel/cult/airless,
/area/template_noop)
"P" = (
/obj/effect/clockwork/overlay/floor/bloodcult,
/obj/item/toy/plush/narplush,
/turf/open/floor/plasteel/cult/airless,
/area/template_noop)
"Y" = (
/obj/effect/clockwork/overlay/floor/bloodcult,
/obj/effect/decal/cleanable/blood/gibs/down,
/turf/open/floor/plasteel/cult/airless,
/area/template_noop)
"Z" = (
/obj/effect/clockwork/overlay/floor/bloodcult,
/obj/structure/destructible/cult/forge,
/turf/open/floor/plasteel/cult/airless,
/area/template_noop)

(1,1,1) = {"
C
C
C
d
d
d
d
d
e
C
C
C
"}
(2,1,1) = {"
C
q
C
d
d
d
d
d
e
A
Z
C
"}
(3,1,1) = {"
C
x
F
C
C
C
C
C
C
y
P
C
"}
(4,1,1) = {"
e
e
a
c
a
A
a
j
a
a
e
e
"}
(5,1,1) = {"
e
e
a
Y
a
a
a
H
a
a
e
e
"}
(6,1,1) = {"
C
a
y
C
C
v
C
C
C
y
a
C
"}
(7,1,1) = {"
C
q
C
d
d
d
d
d
e
a
Z
C
"}
(8,1,1) = {"
C
C
C
d
d
d
d
d
e
C
C
C
"}
