//MAP CONVERTED BY dmm2tgm.py THIS HEADER COMMENT PREVENTS RECONVERSION, DO NOT REMOVE
"a" = (
/turf/open/space/basic,
/area/template_noop)
"e" = (
/turf/open/floor/engine/airless,
/area/template_noop)
"j" = (
/turf/closed/wall/mineral/titanium,
/area/template_noop)
"k" = (
/obj/machinery/door/poddoor/shutters/window,
/turf/open/floor/plating,
/area/template_noop)
"n" = (
/obj/machinery/computer/rdconsole/robotics,
/turf/open/floor/engine/airless,
/area/template_noop)
"r" = (
/obj/structure/window/plastitanium,
/turf/open/floor/plating,
/area/template_noop)
"t" = (
/obj/structure/chair/comfy/shuttle,
/turf/open/floor/engine/airless,
/area/template_noop)
"u" = (
/obj/structure/shuttle/engine/heater,
/obj/structure/window/reinforced/spawner/north,
/turf/open/floor/plating,
/area/template_noop)
"y" = (
/obj/structure/bed/surgical_mat,
/turf/open/floor/engine/airless,
/area/template_noop)
"F" = (
/obj/machinery/mecha_part_fabricator,
/turf/open/floor/engine/airless,
/area/template_noop)
"H" = (
/obj/item/circular_saw,
/turf/open/floor/engine/airless,
/area/template_noop)
"M" = (
/obj/machinery/door/airlock/external/glass,
/turf/open/floor/plating,
/area/template_noop)
"N" = (
/obj/item/organ/cyberimp/chest/spinalspeed/toy,
/turf/open/floor/engine/airless,
/area/template_noop)
"O" = (
/obj/machinery/shuttle/engine/void,
/turf/open/floor/plating,
/area/template_noop)
"Q" = (
/obj/item/storage/fancy/cigarettes/cigpack_robustgold,
/turf/open/floor/engine/airless,
/area/template_noop)
"S" = (
/obj/structure/table/reinforced,
/obj/item/stack/sheet/mineral/silver,
/obj/item/stack/sheet/mineral/silver,
/obj/item/stack/sheet/mineral/silver,
/obj/item/stack/sheet/mineral/silver,
/obj/item/stack/sheet/mineral/silver,
/obj/item/stack/sheet/mineral/silver,
/obj/item/stack/sheet/mineral/silver,
/obj/item/stack/sheet/mineral/silver,
/obj/item/stack/sheet/mineral/silver,
/obj/item/stack/sheet/mineral/silver,
/obj/item/stack/sheet/mineral/silver,
/obj/item/stack/sheet/mineral/silver,
/obj/item/stack/sheet/mineral/silver,
/obj/item/stack/sheet/mineral/silver,
/obj/item/stack/sheet/mineral/silver,
/turf/open/floor/engine/airless,
/area/template_noop)
"U" = (
/obj/structure/window/plastitanium,
/obj/structure/window/plastitanium,
/turf/open/floor/plating,
/area/template_noop)
"Y" = (
/obj/structure/chair,
/turf/open/floor/engine/airless,
/area/template_noop)
"Z" = (
/obj/structure/table/reinforced,
/obj/item/stack/sheet/mineral/gold,
/obj/item/stack/sheet/mineral/gold,
/obj/item/stack/sheet/mineral/gold,
/obj/item/stack/sheet/mineral/gold,
/obj/item/stack/sheet/mineral/gold,
/obj/item/stack/sheet/mineral/gold,
/obj/item/stack/sheet/mineral/gold,
/obj/item/stack/sheet/mineral/gold,
/obj/item/stack/sheet/mineral/gold,
/obj/item/stack/sheet/mineral/gold,
/obj/item/stack/sheet/mineral/gold,
/obj/item/stack/sheet/mineral/gold,
/obj/item/stack/sheet/mineral/gold,
/obj/item/stack/sheet/mineral/gold,
/turf/open/floor/engine/airless,
/area/template_noop)

(1,1,1) = {"
a
a
a
a
a
a
a
a
a
a
a
a
"}
(2,1,1) = {"
a
a
a
j
j
k
k
k
j
j
j
a
"}
(3,1,1) = {"
j
j
j
j
e
e
e
e
S
Z
j
a
"}
(4,1,1) = {"
r
n
t
e
e
e
e
e
e
e
u
O
"}
(5,1,1) = {"
U
n
t
e
H
e
e
e
F
e
u
O
"}
(6,1,1) = {"
j
j
j
j
y
N
e
e
Y
Q
j
a
"}
(7,1,1) = {"
a
a
a
j
j
j
M
j
j
j
j
a
"}
(8,1,1) = {"
a
a
a
a
a
a
a
a
a
a
a
a
"}
