//MAP CONVERTED BY dmm2tgm.py THIS HEADER COMMENT PREVENTS RECONVERSION, DO NOT REMOVE
"aa" = (
/turf/template_noop,
/area/template_noop)
"ab" = (
/turf/closed/wall,
/area/crew_quarters/bar)
"ac" = (
/obj/machinery/door/airlock{
	name = "Theatre Backstage";
	req_access_txt = "46"
	},
/obj/machinery/atmospherics/pipe/simple/supply/hidden/layer1,
/obj/machinery/atmospherics/pipe/simple/scrubbers/hidden/layer3,
/obj/effect/turf_decal/ameritard,
/obj/machinery/door/firedoor/border_only{
	dir = 1
	},
/obj/machinery/door/firedoor/border_only,
/turf/open/floor/plasteel,
/area/crew_quarters/theatre)
"ad" = (
/obj/item/storage/secure/safe,
/turf/closed/wall,
/area/crew_quarters/bar)
"ae" = (
/obj/machinery/door/airlock/maintenance{
	name = "Bar Maintenance";
	req_access_txt = "12"
	},
/obj/structure/disposalpipe/segment,
/obj/machinery/door/firedoor/border_only{
	dir = 1
	},
/obj/machinery/door/firedoor/border_only,
/turf/open/floor/plating,
/area/maintenance/starboard/fore)
"af" = (
/obj/item/reagent_containers/food/drinks/shaker,
/obj/structure/table/wood,
/obj/item/stack/sheet/metal{
	amount = 50
	},
/obj/item/stack/sheet/glass{
	amount = 50
	},
/obj/item/stack/cable_coil,
/turf/open/floor/wood,
/area/crew_quarters/bar)
"ag" = (
/obj/structure/disposalpipe/segment,
/turf/open/floor/wood,
/area/crew_quarters/bar)
"ah" = (
/obj/structure/sink/kitchen{
	pixel_y = 28
	},
/turf/open/floor/wood,
/area/crew_quarters/bar)
"ai" = (
/obj/machinery/door/window/southleft{
	base_state = "left";
	dir = 2;
	icon_state = "left";
	name = "Bar Delivery";
	req_access_txt = "25"
	},
/obj/effect/turf_decal/delivery,
/turf/open/floor/plasteel,
/area/crew_quarters/bar)
"aj" = (
/turf/closed/wall,
/area/crew_quarters/kitchen)
"ak" = (
/obj/machinery/door/airlock/maintenance{
	name = "Kitchen Maintenance";
	req_access_txt = "28"
	},
/obj/structure/disposalpipe/segment,
/obj/machinery/atmospherics/pipe/simple/scrubbers/hidden/layer3,
/obj/machinery/atmospherics/pipe/simple/supply/hidden/layer1,
/obj/machinery/door/firedoor/border_only,
/obj/machinery/door/firedoor/border_only{
	dir = 1
	},
/turf/open/floor/plating,
/area/maintenance/starboard/fore)
"al" = (
/obj/machinery/navbeacon{
	codes_txt = "delivery;dir=2";
	freq = 1400;
	location = "Kitchen"
	},
/obj/structure/plasticflaps{
	opacity = 1
	},
/turf/open/floor/plasteel,
/area/crew_quarters/kitchen)
"am" = (
/obj/machinery/light{
	dir = 1
	},
/obj/effect/turf_decal/ameritard,
/turf/open/floor/plasteel,
/area/crew_quarters/bar)
"an" = (
/obj/machinery/atmospherics/pipe/simple/supply/hidden/layer1,
/obj/machinery/atmospherics/pipe/simple/scrubbers/hidden/layer3,
/obj/effect/turf_decal/ameritard,
/turf/open/floor/plasteel,
/area/crew_quarters/bar)
"ao" = (
/obj/machinery/airalarm{
	dir = 2;
	pixel_y = 24
	},
/obj/effect/turf_decal/ameritard,
/turf/open/floor/plasteel,
/area/crew_quarters/bar)
"ap" = (
/obj/machinery/camera{
	c_tag = "Theatre Stage";
	dir = 2
	},
/obj/effect/turf_decal/ameritard,
/turf/open/floor/plasteel,
/area/crew_quarters/bar)
"aq" = (
/obj/effect/turf_decal/ameritard,
/obj/structure/chair/americandiner/booth/end_left,
/turf/open/floor/plasteel,
/area/crew_quarters/bar)
"ar" = (
/obj/structure/disposalpipe/segment{
	dir = 5
	},
/obj/effect/turf_decal/ameritard,
/turf/open/floor/plasteel,
/area/crew_quarters/bar)
"as" = (
/obj/machinery/disposal/bin,
/obj/structure/disposalpipe/trunk{
	dir = 8
	},
/obj/effect/turf_decal/ameritard,
/obj/machinery/firealarm{
	dir = 2;
	pixel_y = 26
	},
/turf/open/floor/plasteel,
/area/crew_quarters/bar)
"at" = (
/obj/machinery/reagentgrinder,
/obj/structure/table/wood,
/turf/open/floor/wood,
/area/crew_quarters/bar)
"au" = (
/turf/open/floor/wood,
/area/crew_quarters/bar)
"av" = (
/obj/machinery/camera{
	c_tag = "Bar Storage"
	},
/turf/open/floor/wood,
/area/crew_quarters/bar)
"aw" = (
/obj/structure/closet/secure_closet/freezer/meat,
/turf/open/floor/plasteel{
	icon_state = "showroomfloor"
	},
/area/crew_quarters/kitchen)
"ax" = (
/obj/structure/disposalpipe/segment,
/obj/machinery/atmospherics/pipe/simple/scrubbers/hidden/layer3,
/obj/machinery/atmospherics/pipe/simple/supply/hidden/layer1,
/turf/open/floor/plasteel{
	icon_state = "showroomfloor"
	},
/area/crew_quarters/kitchen)
"ay" = (
/obj/machinery/door/window/southleft{
	base_state = "left";
	dir = 2;
	icon_state = "left";
	name = "Kitchen Delivery";
	req_access_txt = "28"
	},
/obj/effect/turf_decal/delivery,
/turf/open/floor/plasteel,
/area/crew_quarters/kitchen)
"az" = (
/obj/effect/turf_decal/ameritard,
/turf/open/floor/plasteel,
/area/crew_quarters/bar)
"aA" = (
/obj/structure/chair/americandiner/booth/single,
/obj/effect/turf_decal/ameritard,
/turf/open/floor/plasteel,
/area/crew_quarters/bar)
"aB" = (
/obj/machinery/atmospherics/components/unary/vent_scrubber/on/layer3{
	dir = 4;
	icon_state = "scrub_map_on-3"
	},
/obj/effect/turf_decal/ameritard,
/obj/structure/chair/americandiner/booth/end_right,
/turf/open/floor/plasteel,
/area/crew_quarters/bar)
"aC" = (
/obj/machinery/atmospherics/components/unary/vent_pump/on/layer1{
	dir = 8;
	icon_state = "vent_map_on-1"
	},
/obj/effect/turf_decal/ameritard,
/turf/open/floor/plasteel,
/area/crew_quarters/bar)
"aD" = (
/obj/effect/turf_decal/ameritard,
/obj/structure/chair/americandiner/booth/end_right,
/turf/open/floor/plasteel,
/area/crew_quarters/bar)
"aE" = (
/obj/machinery/computer/security/telescreen/entertainment{
	pixel_x = -31
	},
/obj/effect/turf_decal/ameritard,
/turf/open/floor/plasteel,
/area/crew_quarters/bar)
"aF" = (
/obj/effect/landmark/start/assistant,
/obj/effect/turf_decal/ameritard,
/obj/structure/chair/americandiner/booth/end_right{
	dir = 4;
	icon_state = "ameribooth-end2"
	},
/turf/open/floor/plasteel,
/area/crew_quarters/bar)
"aG" = (
/obj/machinery/airalarm{
	dir = 4;
	icon_state = "alarm0";
	pixel_x = -24
	},
/obj/machinery/light/small{
	dir = 8
	},
/obj/structure/reagent_dispensers/beerkeg,
/obj/machinery/atmospherics/components/unary/vent_scrubber/on/layer3{
	dir = 4;
	icon_state = "scrub_map_on-3"
	},
/turf/open/floor/wood,
/area/crew_quarters/bar)
"aH" = (
/obj/structure/disposalpipe/segment,
/obj/effect/landmark/xeno_spawn,
/obj/machinery/atmospherics/pipe/simple/scrubbers/hidden/layer3{
	dir = 9
	},
/obj/machinery/atmospherics/pipe/simple/supply/hidden/layer1{
	dir = 5
	},
/turf/open/floor/wood,
/area/crew_quarters/bar)
"aI" = (
/obj/machinery/atmospherics/components/unary/vent_pump/on/layer1{
	dir = 8;
	icon_state = "vent_map_on-1"
	},
/turf/open/floor/wood,
/area/crew_quarters/bar)
"aJ" = (
/obj/structure/bed,
/turf/open/floor/wood,
/area/crew_quarters/bar)
"aK" = (
/obj/machinery/icecream_vat,
/turf/open/floor/plasteel{
	icon_state = "showroomfloor"
	},
/area/crew_quarters/kitchen)
"aL" = (
/obj/machinery/chem_master/condimaster{
	name = "CondiMaster Neo"
	},
/obj/machinery/camera{
	c_tag = "Kitchen Cold Room"
	},
/turf/open/floor/plasteel{
	icon_state = "showroomfloor"
	},
/area/crew_quarters/kitchen)
"aM" = (
/obj/effect/turf_decal/loading_area,
/turf/open/floor/plasteel{
	icon_state = "showroomfloor"
	},
/area/crew_quarters/kitchen)
"aN" = (
/obj/machinery/light{
	dir = 8
	},
/obj/effect/turf_decal/ameritard,
/turf/open/floor/plasteel,
/area/crew_quarters/bar)
"aO" = (
/obj/structure/table,
/obj/effect/turf_decal/ameritard,
/turf/open/floor/plasteel,
/area/crew_quarters/bar)
"aP" = (
/obj/machinery/airalarm{
	dir = 4;
	icon_state = "alarm0";
	pixel_x = -24
	},
/obj/machinery/camera{
	c_tag = "Bar West";
	dir = 4;
	network = list("SS13")
	},
/obj/effect/turf_decal/ameritard,
/turf/open/floor/plasteel,
/area/crew_quarters/bar)
"aQ" = (
/obj/machinery/computer/security/telescreen/entertainment{
	pixel_x = -31
	},
/obj/machinery/light{
	dir = 8
	},
/obj/effect/turf_decal/ameritard,
/turf/open/floor/plasteel,
/area/crew_quarters/bar)
"aR" = (
/obj/machinery/computer/arcade,
/obj/effect/turf_decal/ameritard,
/turf/open/floor/plasteel,
/area/crew_quarters/bar)
"aS" = (
/obj/machinery/computer/slot_machine,
/obj/effect/turf_decal/ameritard,
/turf/open/floor/plasteel,
/area/crew_quarters/bar)
"aT" = (
/obj/machinery/disposal/bin,
/obj/structure/disposalpipe/trunk{
	dir = 4
	},
/obj/structure/window/reinforced{
	dir = 8
	},
/obj/structure/window/reinforced,
/turf/open/floor/plasteel{
	icon_state = "cafeteria"
	},
/area/crew_quarters/bar)
"aU" = (
/obj/structure/disposalpipe/segment{
	dir = 9
	},
/turf/open/floor/plasteel{
	icon_state = "cafeteria"
	},
/area/crew_quarters/bar)
"aV" = (
/obj/structure/closet/secure_closet/bar{
	req_access_txt = "25"
	},
/obj/item/gun/ballistic/revolver/russian,
/turf/open/floor/wood,
/area/crew_quarters/bar)
"aW" = (
/obj/machinery/vending/wardrobe/bar_wardrobe,
/turf/open/floor/wood,
/area/crew_quarters/bar)
"aX" = (
/obj/structure/kitchenspike,
/obj/machinery/light/small{
	dir = 8
	},
/turf/open/floor/plasteel{
	icon_state = "showroomfloor"
	},
/area/crew_quarters/kitchen)
"aY" = (
/obj/machinery/atmospherics/components/unary/vent_scrubber/on/layer3{
	dir = 8;
	icon_state = "scrub_map_on-3"
	},
/obj/effect/spawner/lootdrop/mob/kitchen_animal,
/turf/open/floor/plasteel{
	icon_state = "showroomfloor"
	},
/area/crew_quarters/kitchen)
"aZ" = (
/turf/open/floor/plasteel{
	icon_state = "showroomfloor"
	},
/area/crew_quarters/kitchen)
"ba" = (
/obj/machinery/light/small{
	dir = 4
	},
/obj/machinery/airalarm{
	dir = 8;
	icon_state = "alarm0";
	pixel_x = 24
	},
/obj/machinery/vending/wardrobe/chef_wardrobe,
/turf/open/floor/plasteel{
	icon_state = "showroomfloor"
	},
/area/crew_quarters/kitchen)
"bb" = (
/obj/structure/table/american/end{
	dir = 1;
	icon_state = "table-end";
	tag = ""
	},
/obj/item/reagent_containers/food/snacks/burger/plain,
/obj/effect/turf_decal/stripes/red/line{
	dir = 8;
	icon_state = "warningline_red"
	},
/obj/machinery/door/firedoor/border_only{
	dir = 8
	},
/turf/open/floor/plasteel{
	icon_state = "cafeteria"
	},
/area/crew_quarters/bar)
"bc" = (
/obj/effect/turf_decal/ameritard,
/obj/structure/chair/americandiner/booth/end_left{
	dir = 1;
	icon_state = "ameribooth-end1"
	},
/turf/open/floor/plasteel,
/area/crew_quarters/bar)
"bd" = (
/obj/effect/turf_decal/ameritard,
/obj/structure/chair/americandiner/booth/end_left{
	dir = 4;
	icon_state = "ameribooth-end1";
	tag = ""
	},
/turf/open/floor/plasteel,
/area/crew_quarters/bar)
"be" = (
/obj/effect/landmark/start/assistant,
/obj/effect/turf_decal/ameritard,
/obj/structure/chair/americandiner/booth/end_left,
/turf/open/floor/plasteel,
/area/crew_quarters/bar)
"bf" = (
/obj/machinery/door/airlock{
	name = "Bar Storage";
	req_access_txt = "25"
	},
/obj/structure/disposalpipe/segment,
/obj/machinery/door/firedoor/border_only,
/obj/machinery/door/firedoor/border_only{
	dir = 1
	},
/turf/open/floor/plasteel{
	icon_state = "wood"
	},
/area/crew_quarters/bar)
"bg" = (
/obj/machinery/vending/dinnerware,
/turf/open/floor/plasteel{
	icon_state = "cafeteria"
	},
/area/crew_quarters/kitchen)
"bh" = (
/obj/effect/landmark/blobstart,
/turf/open/floor/plating,
/area/crew_quarters/bar)
"bi" = (
/obj/structure/kitchenspike,
/turf/open/floor/plasteel{
	icon_state = "showroomfloor"
	},
/area/crew_quarters/kitchen)
"bj" = (
/obj/structure/disposalpipe/segment,
/obj/machinery/atmospherics/pipe/simple/scrubbers/hidden/layer3,
/obj/machinery/atmospherics/pipe/manifold/supply/hidden/layer1{
	dir = 8
	},
/turf/open/floor/plasteel{
	icon_state = "showroomfloor"
	},
/area/crew_quarters/kitchen)
"bk" = (
/obj/effect/landmark/event_spawn,
/obj/machinery/atmospherics/components/unary/vent_pump/on/layer1{
	dir = 8;
	icon_state = "vent_map_on-1"
	},
/turf/open/floor/plasteel{
	icon_state = "showroomfloor"
	},
/area/crew_quarters/kitchen)
"bl" = (
/obj/machinery/gibber,
/turf/open/floor/plasteel{
	icon_state = "showroomfloor"
	},
/area/crew_quarters/kitchen)
"bm" = (
/obj/structure/extinguisher_cabinet{
	pixel_x = -5;
	pixel_y = 30
	},
/obj/machinery/food_cart,
/turf/open/floor/plasteel{
	icon_state = "cafeteria"
	},
/area/crew_quarters/kitchen)
"bn" = (
/obj/structure/sink/kitchen{
	pixel_y = 28
	},
/turf/open/floor/plasteel{
	icon_state = "cafeteria"
	},
/area/crew_quarters/kitchen)
"bo" = (
/obj/structure/disposalpipe/segment{
	dir = 4
	},
/turf/open/floor/plasteel{
	icon_state = "cafeteria"
	},
/area/crew_quarters/bar)
"bp" = (
/obj/structure/disposalpipe/segment,
/obj/machinery/atmospherics/pipe/simple/scrubbers/hidden/layer3,
/obj/machinery/atmospherics/pipe/simple/supply/hidden/layer1,
/turf/open/floor/plasteel{
	icon_state = "cafeteria"
	},
/area/crew_quarters/kitchen)
"bq" = (
/obj/structure/table,
/obj/machinery/firealarm{
	dir = 8;
	pixel_x = 26
	},
/obj/machinery/chem_dispenser/drinks/beer{
	dir = 8
	},
/turf/open/floor/plasteel{
	icon_state = "cafeteria"
	},
/area/crew_quarters/bar)
"br" = (
/obj/machinery/camera{
	c_tag = "Kitchen";
	dir = 2;
	network = list("SS13")
	},
/obj/structure/closet/secure_closet/freezer/fridge,
/turf/open/floor/plasteel{
	icon_state = "cafeteria"
	},
/area/crew_quarters/kitchen)
"bs" = (
/obj/machinery/door/airlock{
	name = "Kitchen cold room";
	req_access_txt = "28"
	},
/obj/structure/disposalpipe/segment,
/obj/machinery/atmospherics/pipe/simple/scrubbers/hidden/layer3,
/obj/machinery/atmospherics/pipe/simple/supply/hidden/layer1,
/obj/machinery/door/firedoor/border_only{
	dir = 1
	},
/obj/machinery/door/firedoor/border_only,
/turf/open/floor/plasteel{
	icon_state = "showroomfloor"
	},
/area/crew_quarters/kitchen)
"bt" = (
/obj/structure/table,
/obj/machinery/microwave{
	pixel_x = -3;
	pixel_y = 6
	},
/obj/machinery/airalarm{
	pixel_y = 24
	},
/obj/machinery/light{
	dir = 1
	},
/turf/open/floor/plasteel{
	icon_state = "cafeteria"
	},
/area/crew_quarters/kitchen)
"bu" = (
/obj/structure/chair/americandiner{
	dir = 4;
	icon_state = "americhair";
	tag = ""
	},
/obj/effect/turf_decal/ameritard,
/turf/open/floor/plasteel,
/area/crew_quarters/bar)
"bv" = (
/obj/structure/table,
/obj/machinery/microwave{
	pixel_x = -3;
	pixel_y = 6
	},
/obj/item/storage/box/donkpockets,
/turf/open/floor/plasteel{
	icon_state = "cafeteria"
	},
/area/crew_quarters/kitchen)
"bw" = (
/obj/structure/closet/secure_closet/freezer/kitchen,
/turf/open/floor/plasteel{
	icon_state = "cafeteria"
	},
/area/crew_quarters/kitchen)
"bx" = (
/obj/machinery/light{
	dir = 4;
	icon_state = "tube1"
	},
/turf/open/floor/plasteel{
	icon_state = "cafeteria"
	},
/area/crew_quarters/bar)
"by" = (
/obj/machinery/vending/boozeomat,
/turf/open/floor/plasteel{
	icon_state = "cafeteria"
	},
/area/crew_quarters/bar)
"bz" = (
/obj/structure/table/american,
/obj/item/clothing/head/that,
/obj/effect/turf_decal/stripes/red/line{
	dir = 8;
	icon_state = "warningline_red"
	},
/obj/item/book/manual/wiki/barman_recipes,
/obj/item/reagent_containers/glass/rag,
/obj/machinery/door/firedoor/border_only{
	dir = 8
	},
/turf/open/floor/plasteel{
	icon_state = "cafeteria"
	},
/area/crew_quarters/bar)
"bA" = (
/obj/structure/chair/americandiner/black{
	dir = 4;
	icon_state = "americhair_black";
	tag = ""
	},
/obj/effect/landmark/start/assistant,
/obj/effect/turf_decal/ameritard,
/turf/open/floor/plasteel,
/area/crew_quarters/bar)
"bB" = (
/obj/structure/table,
/obj/item/book/manual/chef_recipes,
/obj/item/book/manual/wiki/cooking_to_serve_man{
	pixel_x = -4;
	pixel_y = 4
	},
/turf/open/floor/plasteel{
	icon_state = "cafeteria"
	},
/area/crew_quarters/kitchen)
"bC" = (
/obj/structure/table/reinforced,
/obj/machinery/door/firedoor,
/obj/machinery/door/window/westright,
/turf/open/floor/plasteel{
	icon_state = "cafeteria"
	},
/area/crew_quarters/kitchen)
"bD" = (
/turf/open/floor/plasteel{
	icon_state = "cafeteria"
	},
/area/crew_quarters/kitchen)
"bE" = (
/obj/machinery/atmospherics/components/unary/vent_scrubber/on/layer3{
	dir = 4;
	icon_state = "scrub_map_on-3"
	},
/turf/open/floor/plasteel{
	icon_state = "cafeteria"
	},
/area/crew_quarters/kitchen)
"bF" = (
/obj/machinery/atmospherics/pipe/simple/scrubbers/hidden/layer3{
	dir = 9
	},
/obj/machinery/atmospherics/pipe/simple/supply/hidden/layer1{
	dir = 5
	},
/obj/structure/disposalpipe/segment{
	dir = 5
	},
/turf/open/floor/plasteel{
	icon_state = "cafeteria"
	},
/area/crew_quarters/kitchen)
"bG" = (
/obj/structure/disposalpipe/segment{
	dir = 4
	},
/obj/machinery/atmospherics/components/unary/vent_pump/on/layer1{
	dir = 8;
	icon_state = "vent_map_on-1"
	},
/turf/open/floor/plasteel{
	icon_state = "cafeteria"
	},
/area/crew_quarters/kitchen)
"bH" = (
/obj/structure/disposalpipe/segment{
	dir = 4
	},
/turf/open/floor/plasteel{
	icon_state = "cafeteria"
	},
/area/crew_quarters/kitchen)
"bI" = (
/obj/structure/disposalpipe/segment{
	dir = 10
	},
/turf/open/floor/plasteel{
	icon_state = "cafeteria"
	},
/area/crew_quarters/kitchen)
"bJ" = (
/obj/machinery/processor,
/obj/machinery/firealarm{
	dir = 8;
	pixel_x = 26
	},
/turf/open/floor/plasteel{
	icon_state = "cafeteria"
	},
/area/crew_quarters/kitchen)
"bK" = (
/obj/machinery/light/small{
	dir = 4
	},
/turf/open/floor/wood,
/area/crew_quarters/bar)
"bL" = (
/obj/structure/table/american,
/obj/item/reagent_containers/food/snacks/burger/plain,
/obj/effect/turf_decal/stripes/red/line{
	dir = 8;
	icon_state = "warningline_red"
	},
/obj/machinery/door/firedoor/border_only{
	dir = 8
	},
/turf/open/floor/plasteel{
	icon_state = "cafeteria"
	},
/area/crew_quarters/bar)
"bM" = (
/obj/machinery/deepfryer,
/turf/open/floor/plasteel{
	icon_state = "cafeteria"
	},
/area/crew_quarters/kitchen)
"bN" = (
/obj/structure/chair/americandiner/black{
	dir = 4;
	icon_state = "americhair_black";
	tag = ""
	},
/obj/effect/turf_decal/ameritard,
/turf/open/floor/plasteel,
/area/crew_quarters/bar)
"bO" = (
/obj/structure/table,
/obj/item/stack/packageWrap,
/obj/item/reagent_containers/food/condiment/enzyme,
/turf/open/floor/plasteel{
	icon_state = "cafeteria"
	},
/area/crew_quarters/kitchen)
"bP" = (
/obj/item/stack/sheet/metal/fifty,
/obj/item/stack/sheet/glass/fifty,
/obj/item/stack/cable_coil,
/obj/item/flashlight/lamp,
/obj/item/flashlight/lamp/green,
/obj/structure/closet/secure_closet/bartender,
/turf/open/floor/wood,
/area/crew_quarters/bar)
"bR" = (
/obj/structure/disposalpipe/segment,
/turf/open/floor/plasteel{
	icon_state = "cafeteria"
	},
/area/crew_quarters/kitchen)
"bS" = (
/obj/effect/turf_decal/ameritard,
/obj/structure/chair/americandiner/booth/end_right{
	dir = 1;
	icon_state = "ameribooth-end2"
	},
/turf/open/floor/plasteel,
/area/crew_quarters/bar)
"bT" = (
/obj/structure/table/american,
/obj/item/reagent_containers/food/snacks/burger/superbite,
/obj/effect/turf_decal/stripes/red/line{
	dir = 8;
	icon_state = "warningline_red"
	},
/obj/machinery/door/firedoor/border_only{
	dir = 8
	},
/turf/open/floor/plasteel{
	icon_state = "cafeteria"
	},
/area/crew_quarters/bar)
"bU" = (
/obj/effect/landmark/start/cook,
/turf/open/floor/plasteel{
	icon_state = "cafeteria"
	},
/area/crew_quarters/kitchen)
"bV" = (
/obj/effect/turf_decal/ameritard,
/obj/structure/chair/americandiner/booth/single{
	dir = 1;
	icon_state = "ameribooth_single"
	},
/turf/open/floor/plasteel,
/area/crew_quarters/bar)
"bW" = (
/obj/machinery/requests_console{
	department = "Bar";
	departmentType = 2;
	pixel_x = 30
	},
/obj/machinery/camera{
	c_tag = "Bar";
	dir = 8;
	network = list("SS13")
	},
/obj/structure/table,
/obj/machinery/chem_dispenser/drinks{
	dir = 8
	},
/turf/open/floor/plasteel{
	icon_state = "cafeteria"
	},
/area/crew_quarters/bar)
"bX" = (
/obj/structure/table/american/end,
/obj/structure/window/reinforced,
/obj/effect/turf_decal/stripes/red/line{
	dir = 8;
	icon_state = "warningline_red"
	},
/obj/machinery/door/firedoor/border_only{
	dir = 8
	},
/turf/open/floor/plasteel{
	icon_state = "cafeteria"
	},
/area/crew_quarters/bar)
"bY" = (
/obj/machinery/door/window/southright{
	name = "Bar Door";
	req_access_txt = "25";
	req_one_access_txt = "25;28"
	},
/turf/open/floor/plasteel{
	icon_state = "cafeteria"
	},
/area/crew_quarters/bar)
"bZ" = (
/obj/machinery/smartfridge/drinks,
/turf/open/floor/plasteel{
	icon_state = "cafeteria"
	},
/area/crew_quarters/bar)
"ca" = (
/obj/structure/chair/americandiner,
/obj/effect/turf_decal/ameritard,
/turf/open/floor/plasteel,
/area/crew_quarters/bar)
"cf" = (
/obj/machinery/door/airlock{
	name = "Kitchen";
	req_access_txt = "28"
	},
/obj/machinery/door/firedoor/border_only{
	dir = 4
	},
/obj/machinery/door/firedoor/border_only{
	dir = 8
	},
/turf/open/floor/plasteel/blackwhite,
/area/crew_quarters/kitchen)
"cg" = (
/obj/effect/landmark/start/bartender,
/turf/open/floor/plasteel{
	icon_state = "cafeteria"
	},
/area/crew_quarters/bar)
"ch" = (
/obj/machinery/light_switch{
	pixel_y = -25
	},
/turf/open/floor/plasteel{
	icon_state = "cafeteria"
	},
/area/crew_quarters/kitchen)
"cj" = (
/obj/machinery/light,
/turf/open/floor/plasteel{
	icon_state = "cafeteria"
	},
/area/crew_quarters/kitchen)
"ck" = (
/obj/effect/landmark/event_spawn,
/turf/open/floor/plasteel{
	icon_state = "cafeteria"
	},
/area/crew_quarters/kitchen)
"cl" = (
/obj/machinery/button/door{
	id = "kitchen";
	name = "Kitchen Shutters Control";
	pixel_x = -1;
	pixel_y = -24;
	req_access_txt = "28"
	},
/obj/structure/disposalpipe/segment{
	dir = 5
	},
/turf/open/floor/plasteel{
	icon_state = "cafeteria"
	},
/area/crew_quarters/kitchen)
"cm" = (
/obj/machinery/disposal/bin,
/obj/structure/disposalpipe/trunk{
	dir = 8
	},
/turf/open/floor/plasteel{
	icon_state = "cafeteria"
	},
/area/crew_quarters/kitchen)
"cp" = (
/obj/machinery/door/airlock/public/glass{
	name = "Diner"
	},
/obj/machinery/door/firedoor/border_only,
/obj/machinery/door/firedoor/border_only{
	dir = 1
	},
/turf/open/floor/plasteel,
/area/crew_quarters/bar)
"cs" = (
/obj/structure/table,
/obj/effect/landmark/event_spawn,
/obj/effect/turf_decal/ameritard,
/turf/open/floor/plasteel,
/area/crew_quarters/bar)
"cv" = (
/turf/open/floor/plasteel{
	icon_state = "cafeteria"
	},
/area/crew_quarters/bar)
"cF" = (
/obj/structure/chair/americandiner{
	dir = 1;
	icon_state = "americhair";
	tag = ""
	},
/obj/effect/turf_decal/ameritard,
/turf/open/floor/plasteel,
/area/crew_quarters/bar)
"cJ" = (
/obj/machinery/vending/cola,
/obj/structure/window/reinforced,
/turf/open/floor/plasteel{
	icon_state = "cafeteria"
	},
/area/crew_quarters/bar)
"cQ" = (
/obj/effect/landmark/event_spawn,
/obj/effect/turf_decal/ameritard,
/turf/open/floor/plasteel,
/area/crew_quarters/bar)
"da" = (
/obj/machinery/newscaster{
	pixel_y = -28
	},
/obj/structure/piano,
/obj/effect/turf_decal/ameritard,
/turf/open/floor/plasteel,
/area/crew_quarters/bar)
"db" = (
/obj/structure/chair/americandiner{
	dir = 8;
	icon_state = "americhair";
	tag = ""
	},
/obj/machinery/light,
/obj/effect/turf_decal/ameritard,
/turf/open/floor/plasteel,
/area/crew_quarters/bar)
"dc" = (
/obj/machinery/light,
/obj/effect/turf_decal/ameritard,
/turf/open/floor/plasteel,
/area/crew_quarters/bar)
"dd" = (
/obj/machinery/camera{
	c_tag = "Bar South";
	dir = 1
	},
/obj/effect/turf_decal/ameritard,
/turf/open/floor/plasteel,
/area/crew_quarters/bar)
"df" = (
/obj/machinery/airalarm{
	dir = 1;
	icon_state = "alarm0";
	pixel_y = -24
	},
/obj/effect/turf_decal/ameritard,
/turf/open/floor/plasteel,
/area/crew_quarters/bar)
"dh" = (
/obj/structure/extinguisher_cabinet{
	pixel_y = -30
	},
/obj/effect/turf_decal/ameritard,
/turf/open/floor/plasteel,
/area/crew_quarters/bar)
"di" = (
/obj/structure/table/reinforced,
/obj/machinery/door/firedoor/border_only,
/obj/machinery/door/poddoor/shutters/preopen{
	id = "kitchen";
	name = "kitchen shutters"
	},
/obj/item/storage/box/fancy/donut_box,
/turf/open/floor/plasteel{
	icon_state = "cafeteria"
	},
/area/crew_quarters/kitchen)
"dj" = (
/obj/structure/sign/barsign,
/turf/closed/wall,
/area/crew_quarters/bar)
"ko" = (
/obj/structure/table,
/obj/item/reagent_containers/food/snacks/burger/baseball{
	pixel_x = 7;
	pixel_y = 6
	},
/obj/item/reagent_containers/glass/mixbowl{
	pixel_x = -10;
	pixel_y = 3
	},
/turf/open/floor/plasteel{
	icon_state = "cafeteria"
	},
/area/crew_quarters/kitchen)
"mc" = (
/obj/effect/spawner/structure/window,
/turf/open/floor/plating,
/area/crew_quarters/bar)
"pQ" = (
/obj/structure/table/reinforced,
/obj/machinery/door/firedoor/border_only,
/obj/machinery/door/poddoor/shutters/preopen{
	id = "kitchen";
	name = "kitchen shutters"
	},
/obj/item/reagent_containers/food/snacks/mint,
/turf/open/floor/plasteel{
	icon_state = "cafeteria"
	},
/area/crew_quarters/kitchen)
"vO" = (
/obj/machinery/atmospherics/pipe/simple/supply/hidden/layer1{
	dir = 5
	},
/obj/machinery/atmospherics/pipe/simple/scrubbers/hidden/layer3{
	dir = 9
	},
/obj/effect/turf_decal/ameritard,
/turf/open/floor/plasteel,
/area/crew_quarters/bar)
"xx" = (
/obj/structure/sign/plaques/deempisi,
/turf/closed/wall,
/area/crew_quarters/bar)
"Aw" = (
/obj/structure/table,
/obj/machinery/requests_console{
	department = "Kitchen";
	departmentType = 2;
	pixel_x = 30
	},
/obj/machinery/reagentgrinder/kitchen{
	pixel_y = 6
	},
/turf/open/floor/plasteel{
	icon_state = "cafeteria"
	},
/area/crew_quarters/kitchen)
"Dn" = (
/obj/structure/table/reinforced,
/obj/machinery/door/firedoor/border_only,
/obj/machinery/door/poddoor/shutters/preopen{
	id = "kitchen";
	name = "kitchen shutters"
	},
/obj/item/reagent_containers/food/snacks/burger/superbite,
/turf/open/floor/plasteel{
	icon_state = "cafeteria"
	},
/area/crew_quarters/kitchen)
"HO" = (
/obj/structure/table,
/obj/item/clothing/head/hardhat/cakehat,
/obj/effect/turf_decal/ameritard,
/turf/open/floor/plasteel,
/area/crew_quarters/bar)
"HV" = (
/obj/structure/chair/americandiner/booth/end_left,
/obj/effect/turf_decal/ameritard,
/turf/open/floor/plasteel,
/area/crew_quarters/bar)
"Ns" = (
/obj/structure/disposalpipe/segment,
/obj/machinery/atmospherics/pipe/manifold/scrubbers/hidden/layer3{
	dir = 8
	},
/obj/machinery/atmospherics/pipe/simple/supply/hidden/layer1,
/turf/open/floor/plasteel{
	icon_state = "showroomfloor"
	},
/area/crew_quarters/kitchen)
"Tm" = (
/obj/structure/table/reinforced,
/obj/machinery/door/firedoor/border_only,
/obj/machinery/door/poddoor/shutters/preopen{
	id = "kitchen";
	name = "kitchen shutters"
	},
/obj/item/reagent_containers/food/snacks/burger/plain,
/turf/open/floor/plasteel{
	icon_state = "cafeteria"
	},
/area/crew_quarters/kitchen)
"WE" = (
/obj/structure/disposalpipe/segment,
/obj/machinery/atmospherics/pipe/simple/scrubbers/hidden/layer3,
/obj/machinery/atmospherics/pipe/simple/supply/hidden/layer1,
/turf/open/floor/wood,
/area/crew_quarters/bar)

(1,1,1) = {"
aa
ab
ab
ab
ab
ab
ab
mc
ab
mc
ab
mc
ab
ab
"}
(2,1,1) = {"
aa
ab
az
aF
bd
aE
aN
az
aP
az
aQ
ca
aR
ab
"}
(3,1,1) = {"
ab
ab
aq
aO
aO
bc
az
az
az
bu
az
ca
aS
ab
"}
(4,1,1) = {"
ab
az
aB
aO
aO
bS
az
az
ca
HO
cF
az
da
ab
"}
(5,1,1) = {"
ac
an
vO
az
az
az
az
az
az
az
az
az
db
ab
"}
(6,1,1) = {"
ab
ao
aC
az
az
az
az
az
az
az
az
az
az
cp
"}
(7,1,1) = {"
ab
ap
aq
aO
bc
be
aO
bc
HV
cs
bc
az
az
mc
"}
(8,1,1) = {"
ab
am
aD
aO
bS
aD
aO
bS
aD
aO
bS
az
az
cp
"}
(9,1,1) = {"
ab
az
az
az
az
az
az
az
az
az
az
az
dc
dj
"}
(10,1,1) = {"
ae
ar
az
az
az
az
az
az
az
az
az
az
dd
ab
"}
(11,1,1) = {"
ab
as
aA
aO
bV
az
bu
bA
bu
bN
bu
az
az
ab
"}
(12,1,1) = {"
ab
ab
ab
ab
xx
aT
bb
bz
bL
bT
bX
az
az
ab
"}
(13,1,1) = {"
af
at
aG
aV
ad
bo
cv
cv
cg
cv
cJ
cQ
df
ab
"}
(14,1,1) = {"
WE
WE
aH
ag
bf
aU
bx
cv
cv
cv
bY
az
dc
ab
"}
(15,1,1) = {"
ah
au
aI
aW
ab
bq
by
cv
bW
cv
bZ
az
dh
ab
"}
(16,1,1) = {"
ab
av
aJ
ab
ab
aj
aj
bC
aj
bC
aj
cf
aj
aj
"}
(17,1,1) = {"
ai
bK
bP
ab
bh
aj
bg
bD
bD
bD
bD
ch
aj
aa
"}
(18,1,1) = {"
aj
aj
aj
aj
aj
aj
bm
bD
bD
bD
bD
cj
aj
aa
"}
(19,1,1) = {"
aj
aw
aK
aX
bi
aj
bn
bE
bM
bU
bD
bD
di
aa
"}
(20,1,1) = {"
ak
ax
ax
Ns
bj
bs
bp
bF
bO
bD
bD
bD
pQ
aa
"}
(21,1,1) = {"
aj
aj
aL
aY
bk
aj
br
bG
bB
bU
bD
ck
Dn
aa
"}
(22,1,1) = {"
al
ay
aM
aZ
aZ
aj
bt
bH
ko
bD
bD
bD
Tm
aa
"}
(23,1,1) = {"
aj
aj
aj
ba
bl
aj
bv
bI
bR
bR
bR
cl
aj
aa
"}
(24,1,1) = {"
aa
aa
aj
aj
aj
aj
bw
bD
bD
bJ
Aw
cm
aj
aa
"}
