// This map has been converted using maphash
"anr" = (/obj/structure/sink/kitchen{pixel_y = 28},/turf/open/floor/wood,/area/crew_quarters/bar)
"aog" = (/obj/machinery/icecream_vat,/turf/open/floor/plasteel/showroomfloor,/area/crew_quarters/kitchen)
"arG" = (/turf/template_noop,/area/template_noop)
"aup" = (/obj/structure/piano{icon_state = "piano"},/turf/open/floor/wood,/area/crew_quarters/theatre)
"aAI" = (/obj/machinery/light/small{dir = 4},/obj/machinery/airalarm{dir = 8; pixel_x = 24},/obj/machinery/vending/wardrobe/chef_wardrobe,/turf/open/floor/plasteel/showroomfloor,/area/crew_quarters/kitchen)
"aJx" = (/obj/effect/landmark/event_spawn,/obj/structure/chair/stool/bar,/obj/effect/turf_decal/tile/bar,/obj/effect/turf_decal/tile/bar{dir = 1},/turf/open/floor/plasteel,/area/crew_quarters/bar)
"aTN" = (/obj/effect/landmark/event_spawn,/turf/open/floor/plasteel/cafeteria,/area/crew_quarters/kitchen)
"ban" = (/obj/machinery/disposal/bin,/obj/structure/disposalpipe/trunk{dir = 4},/obj/structure/window/reinforced{dir = 8},/turf/open/floor/plasteel/cafeteria,/area/crew_quarters/bar)
"bUJ" = (/obj/machinery/airalarm{dir = 4; pixel_x = -22},/obj/machinery/camera{c_tag = "Bar West"; dir = 4},/obj/effect/turf_decal/tile/bar,/obj/effect/turf_decal/tile/bar{dir = 1},/turf/open/floor/plasteel,/area/crew_quarters/bar)
"cQK" = (/obj/structure/table,/obj/item/reagent_containers/food/condiment/saltshaker{pixel_x = -3},/obj/item/reagent_containers/food/condiment/peppermill{pixel_x = 3},/turf/open/floor/plasteel/cafeteria,/area/crew_quarters/kitchen)
"cSt" = (/obj/structure/disposalpipe/segment,/obj/machinery/atmospherics/pipe/simple/supply/hidden/layer1,/obj/machinery/atmospherics/pipe/manifold/scrubbers/hidden/layer3{dir = 8; icon_state = "manifold-3"},/turf/open/floor/plasteel/showroomfloor,/area/crew_quarters/kitchen)
"diP" = (/obj/machinery/door/airlock/public/glass{name = "Diner"},/obj/machinery/door/firedoor/border_only,/obj/machinery/door/firedoor/border_only{dir = 1},/turf/open/floor/plasteel,/area/crew_quarters/bar)
"dBJ" = (/obj/structure/disposalpipe/segment,/obj/machinery/atmospherics/pipe/simple/supply/hidden/layer1,/obj/machinery/atmospherics/pipe/simple/scrubbers/hidden/layer3,/turf/open/floor/plasteel/cafeteria,/area/crew_quarters/kitchen)
"dTx" = (/obj/machinery/airalarm{dir = 1; pixel_y = -22},/obj/effect/turf_decal/tile/bar,/obj/effect/turf_decal/tile/bar{dir = 1},/turf/open/floor/plasteel,/area/crew_quarters/bar)
"eac" = (/obj/machinery/atmospherics/pipe/simple/supply/hidden/layer1,/obj/machinery/atmospherics/pipe/simple/scrubbers/hidden/layer3,/turf/open/floor/wood,/area/crew_quarters/theatre)
"eaM" = (/obj/structure/disposalpipe/segment,/obj/machinery/atmospherics/pipe/simple/supply/hidden/layer1,/obj/machinery/atmospherics/pipe/simple/scrubbers/hidden/layer3,/turf/open/floor/plasteel/showroomfloor,/area/crew_quarters/kitchen)
"ego" = (/turf/open/floor/plasteel/cafeteria,/area/crew_quarters/kitchen)
"euf" = (/mob/living/carbon/monkey/punpun,/turf/open/floor/plasteel/cafeteria,/area/crew_quarters/bar)
"exl" = (/obj/structure/closet/secure_closet/freezer/meat,/turf/open/floor/plasteel/showroomfloor,/area/crew_quarters/kitchen)
"eAP" = (/obj/machinery/door/window/southright{name = "Bar Door"; req_one_access_txt = "25;28"},/turf/open/floor/plasteel/cafeteria,/area/crew_quarters/bar)
"eBE" = (/obj/structure/sign/barsign,/turf/closed/wall,/area/crew_quarters/bar)
"eNi" = (/obj/machinery/atmospherics/pipe/simple/supply/hidden/layer1{dir = 5; icon_state = "pipe11-1"},/obj/machinery/atmospherics/pipe/simple/scrubbers/hidden/layer3{dir = 9; icon_state = "pipe11-3"},/turf/open/floor/wood,/area/crew_quarters/theatre)
"eWY" = (/obj/machinery/door/window{dir = 4; name = "Theatre Stage"},/obj/machinery/door/firedoor/border_only{dir = 4},/turf/open/floor/wood,/area/crew_quarters/theatre)
"eXC" = (/obj/effect/landmark/start/bartender,/turf/open/floor/plasteel/cafeteria,/area/crew_quarters/bar)
"feg" = (/obj/item/radio/intercom{pixel_y = 25},/obj/machinery/camera{c_tag = "Kitchen"; dir = 2},/obj/structure/closet/secure_closet/freezer/fridge,/turf/open/floor/plasteel/cafeteria,/area/crew_quarters/kitchen)
"frB" = (/obj/machinery/vending/cigarette,/obj/effect/turf_decal/tile/bar,/obj/effect/turf_decal/tile/bar{dir = 1},/turf/open/floor/plasteel,/area/crew_quarters/bar)
"fvl" = (/obj/machinery/holopad,/obj/structure/table/reinforced,/turf/open/floor/plasteel/cafeteria,/area/crew_quarters/bar)
"fyo" = (/obj/machinery/button/door{id = "barShutters"; name = "bar shutters"; pixel_x = 4; pixel_y = 28},/obj/structure/disposalpipe/segment{dir = 4},/turf/open/floor/plasteel/cafeteria,/area/crew_quarters/bar)
"fLR" = (/obj/structure/extinguisher_cabinet{pixel_x = -5; pixel_y = 30},/turf/open/floor/plasteel/cafeteria,/area/crew_quarters/kitchen)
"fXL" = (/obj/effect/landmark/event_spawn,/obj/structure/table/reinforced,/turf/open/floor/plasteel/cafeteria,/area/crew_quarters/bar)
"gfv" = (/obj/structure/table/wood,/obj/item/instrument/guitar{pixel_x = -7},/obj/item/instrument/eguitar{pixel_x = 5},/turf/open/floor/wood,/area/crew_quarters/theatre)
"gwB" = (/obj/structure/table,/obj/item/reagent_containers/food/condiment/enzyme{layer = 5},/obj/item/stack/packageWrap,/turf/open/floor/plasteel/cafeteria,/area/crew_quarters/kitchen)
"gLH" = (/turf/closed/wall,/area/crew_quarters/theatre)
"gMm" = (/obj/effect/turf_decal/loading_area,/turf/open/floor/plasteel/showroomfloor,/area/crew_quarters/kitchen)
"hlB" = (/obj/machinery/reagentgrinder,/obj/structure/table/wood,/turf/open/floor/wood,/area/crew_quarters/bar)
"hpb" = (/obj/structure/extinguisher_cabinet{pixel_y = -30},/obj/effect/turf_decal/tile/bar,/obj/effect/turf_decal/tile/bar{dir = 1},/turf/open/floor/plasteel,/area/crew_quarters/bar)
"hwJ" = (/obj/machinery/gibber,/turf/open/floor/plasteel/showroomfloor,/area/crew_quarters/kitchen)
"hET" = (/obj/machinery/door/window/southleft{base_state = "left"; dir = 2; icon_state = "left"; name = "Bar Delivery"; req_access_txt = "25"},/obj/effect/turf_decal/delivery,/turf/open/floor/plasteel,/area/crew_quarters/bar)
"hFz" = (/obj/machinery/airalarm{dir = 2; pixel_y = 24},/turf/open/floor/wood,/area/crew_quarters/theatre)
"hPU" = (/obj/machinery/light/small{dir = 4},/turf/open/floor/wood,/area/crew_quarters/bar)
"ies" = (/obj/machinery/camera{c_tag = "Bar South"; dir = 1},/obj/effect/turf_decal/tile/bar,/obj/effect/turf_decal/tile/bar{dir = 1},/turf/open/floor/plasteel,/area/crew_quarters/bar)
"iqB" = (/mob/living/simple_animal/bot/honkbot,/turf/open/floor/wood,/area/crew_quarters/theatre)
"isv" = (/obj/effect/spawner/structure/window,/obj/machinery/door/poddoor/preopen{id = "barShutters"; name = "privacy shutters"},/turf/open/floor/plating,/area/crew_quarters/bar)
"iAU" = (/obj/machinery/door/window/southleft{base_state = "left"; dir = 2; icon_state = "left"; name = "Kitchen Delivery"; req_access_txt = "28"},/obj/effect/turf_decal/delivery,/obj/structure/window/reinforced{dir = 8},/turf/open/floor/plasteel,/area/crew_quarters/kitchen)
"iCY" = (/obj/effect/landmark/blobstart,/obj/item/toy/beach_ball/holoball,/turf/open/floor/plating,/area/crew_quarters/bar)
"iOS" = (/obj/structure/disposalpipe/segment{dir = 5},/obj/machinery/atmospherics/pipe/simple/supply/hidden/layer1{dir = 5; icon_state = "pipe11-1"},/obj/machinery/atmospherics/pipe/simple/scrubbers/hidden/layer3{dir = 9; icon_state = "pipe11-3"},/turf/open/floor/plasteel/cafeteria,/area/crew_quarters/kitchen)
"iPb" = (/obj/structure/window/reinforced,/obj/machinery/door/firedoor/border_only,/turf/open/floor/wood,/area/crew_quarters/theatre)
"iPt" = (/obj/structure/table,/obj/machinery/reagentgrinder,/obj/machinery/requests_console{department = "Kitchen"; departmentType = 2; pixel_x = 30},/turf/open/floor/plasteel/cafeteria,/area/crew_quarters/kitchen)
"iSB" = (/obj/machinery/vending/boozeomat,/obj/machinery/requests_console{department = "Bar"; departmentType = 2; pixel_x = 30; receive_ore_updates = 1},/turf/open/floor/plasteel/cafeteria,/area/crew_quarters/bar)
"iTv" = (/obj/structure/disposalpipe/segment,/obj/machinery/atmospherics/pipe/simple/scrubbers/hidden/layer3,/obj/machinery/atmospherics/pipe/simple/supply/hidden/layer1,/turf/open/floor/wood,/area/crew_quarters/bar)
"jtC" = (/obj/machinery/vending/coffee,/turf/open/floor/wood,/area/crew_quarters/bar)
"jzN" = (/obj/effect/landmark/start/cook,/turf/open/floor/plasteel/cafeteria,/area/crew_quarters/kitchen)
"jIb" = (/turf/closed/wall,/area/crew_quarters/kitchen)
"jLt" = (/obj/structure/noticeboard{pixel_y = -27},/obj/effect/turf_decal/tile/bar,/obj/effect/turf_decal/tile/bar{dir = 1},/turf/open/floor/plasteel,/area/crew_quarters/bar)
"kQj" = (/obj/machinery/camera{c_tag = "Bar Storage"},/turf/open/floor/wood,/area/crew_quarters/bar)
"kXE" = (/obj/machinery/vending/dinnerware,/turf/open/floor/plasteel/cafeteria,/area/crew_quarters/kitchen)
"lBK" = (/obj/structure/kitchenspike,/turf/open/floor/plasteel/showroomfloor,/area/crew_quarters/kitchen)
"lJg" = (/obj/effect/landmark/start/cook,/obj/machinery/atmospherics/components/unary/vent_scrubber/on/layer3{dir = 4; icon_state = "scrub_map_on-3"},/turf/open/floor/plasteel/cafeteria,/area/crew_quarters/kitchen)
"mdC" = (/obj/structure/sink/kitchen{pixel_y = 28},/obj/machinery/food_cart,/turf/open/floor/plasteel/cafeteria,/area/crew_quarters/kitchen)
"mkn" = (/obj/machinery/smartfridge/drinks,/turf/open/floor/plasteel/cafeteria,/area/crew_quarters/bar)
"myU" = (/obj/machinery/atmospherics/components/unary/vent_scrubber/on/layer3{dir = 8; icon_state = "scrub_map_on-3"},/obj/effect/spawner/lootdrop/mob/kitchen_animal,/turf/open/floor/plasteel/showroomfloor,/area/crew_quarters/kitchen)
"mCX" = (/obj/structure/table/reinforced,/obj/machinery/door/poddoor/shutters/preopen{id = "kitchen"; name = "kitchen shutters"},/obj/machinery/door/window/westright,/turf/open/floor/plasteel/cafeteria,/area/crew_quarters/kitchen)
"mVW" = (/obj/structure/table,/obj/machinery/chem_dispenser/drinks/beer{dir = 8},/obj/item/radio/intercom{pixel_y = 25},/obj/machinery/camera{c_tag = "Bar"; dir = 8},/obj/machinery/firealarm{dir = 8; pixel_x = 26; pixel_y = 0},/turf/open/floor/plasteel/cafeteria,/area/crew_quarters/bar)
"nqd" = (/turf/closed/wall,/area/crew_quarters/bar)
"nrk" = (/obj/machinery/door/airlock{name = "Kitchen"; req_access_txt = "28"},/obj/effect/turf_decal/tile/bar,/obj/effect/turf_decal/tile/bar{dir = 1},/obj/machinery/door/firedoor/border_only{dir = 4},/obj/machinery/door/firedoor/border_only{dir = 8},/turf/open/floor/plasteel,/area/crew_quarters/kitchen)
"nHx" = (/obj/machinery/light,/obj/effect/turf_decal/tile/bar,/obj/effect/turf_decal/tile/bar{dir = 1},/obj/machinery/firealarm{dir = 1; pixel_y = -26},/turf/open/floor/plasteel,/area/crew_quarters/bar)
"nJf" = (/obj/structure/disposalpipe/segment{dir = 5},/obj/machinery/button/door{id = "kitchen"; name = "Kitchen Shutters Control"; pixel_x = -1; pixel_y = -24; req_access_txt = "28"},/turf/open/floor/plasteel/cafeteria,/area/crew_quarters/kitchen)
"orW" = (/obj/structure/table,/obj/item/storage/box/donkpockets{pixel_x = 3; pixel_y = 3},/obj/item/reagent_containers/glass/beaker{pixel_x = 5},/turf/open/floor/plasteel/cafeteria,/area/crew_quarters/kitchen)
"ouJ" = (/obj/structure/chair/stool/bar,/obj/effect/turf_decal/tile/bar,/obj/effect/turf_decal/tile/bar{dir = 1},/turf/open/floor/plasteel,/area/crew_quarters/bar)
"oyl" = (/obj/structure/table,/obj/item/kitchen/rollingpin,/turf/open/floor/plasteel/cafeteria,/area/crew_quarters/kitchen)
"oBC" = (/obj/machinery/light,/turf/open/floor/plasteel/cafeteria,/area/crew_quarters/kitchen)
"oOr" = (/obj/structure/table/reinforced,/turf/open/floor/plasteel/cafeteria,/area/crew_quarters/bar)
"oTc" = (/obj/machinery/camera{c_tag = "Kitchen Cold Room"},/obj/structure/reagent_dispensers/cooking_oil,/turf/open/floor/plasteel/showroomfloor,/area/crew_quarters/kitchen)
"oXC" = (/obj/structure/disposalpipe/segment,/obj/machinery/atmospherics/pipe/simple/scrubbers/hidden/layer3,/obj/machinery/atmospherics/pipe/manifold/supply/hidden/layer1{dir = 8; icon_state = "manifold-1"},/turf/open/floor/plasteel/showroomfloor,/area/crew_quarters/kitchen)
"paO" = (/obj/machinery/atmospherics/components/unary/vent_pump/on/layer1{dir = 8; icon_state = "vent_map_on-1"},/turf/open/floor/wood,/area/crew_quarters/theatre)
"pbN" = (/obj/machinery/airalarm{dir = 4; pixel_x = -22},/obj/machinery/light/small{dir = 8},/obj/structure/reagent_dispensers/beerkeg,/obj/machinery/atmospherics/components/unary/vent_scrubber/on/layer3{dir = 4; icon_state = "scrub_map_on-3"},/turf/open/floor/wood,/area/crew_quarters/bar)
"peA" = (/obj/machinery/vending/wardrobe/bar_wardrobe,/turf/open/floor/wood,/area/crew_quarters/bar)
"pmz" = (/obj/structure/disposalpipe/segment,/obj/effect/landmark/xeno_spawn,/obj/machinery/atmospherics/pipe/simple/scrubbers/hidden/layer3{dir = 9; icon_state = "pipe11-3"},/obj/machinery/atmospherics/pipe/simple/supply/hidden/layer1{dir = 5; icon_state = "pipe11-1"},/turf/open/floor/wood,/area/crew_quarters/bar)
"pwB" = (/obj/structure/window/reinforced,/obj/structure/table/wood,/obj/item/instrument/violin,/obj/machinery/door/firedoor/border_only,/turf/open/floor/wood,/area/crew_quarters/theatre)
"pFj" = (/obj/machinery/light{dir = 4},/turf/open/floor/plasteel/cafeteria,/area/crew_quarters/bar)
"pHz" = (/obj/structure/table/reinforced,/obj/item/storage/fancy/donut_box,/obj/machinery/door/firedoor,/obj/machinery/door/poddoor/shutters/preopen{id = "kitchen"; name = "kitchen shutters"},/turf/open/floor/plasteel/cafeteria,/area/crew_quarters/kitchen)
"pQj" = (/obj/structure/table,/obj/item/reagent_containers/food/snacks/mint,/turf/open/floor/plasteel/cafeteria,/area/crew_quarters/kitchen)
"pZz" = (/obj/structure/window/reinforced{dir = 4},/obj/machinery/door/firedoor/border_only{dir = 4},/turf/open/floor/wood,/area/crew_quarters/theatre)
"qek" = (/obj/item/radio/intercom{pixel_y = 25},/obj/machinery/camera{c_tag = "Theatre Stage"; dir = 2},/turf/open/floor/wood,/area/crew_quarters/theatre)
"qAG" = (/obj/machinery/door/airlock{name = "Theatre Backstage"; req_access_txt = "46"},/obj/machinery/atmospherics/pipe/simple/supply/hidden/layer1,/obj/machinery/atmospherics/pipe/simple/scrubbers/hidden/layer3,/obj/machinery/door/firedoor/border_only,/obj/machinery/door/firedoor/border_only{dir = 1},/turf/open/floor/plasteel,/area/crew_quarters/theatre)
"qEU" = (/obj/effect/landmark/event_spawn,/turf/open/floor/wood,/area/crew_quarters/theatre)
"qYr" = (/obj/structure/disposalpipe/segment{dir = 9},/turf/open/floor/plasteel/cafeteria,/area/crew_quarters/bar)
"qYM" = (/turf/template_noop,/area/space)
"rbg" = (/obj/item/reagent_containers/food/drinks/shaker,/obj/structure/table/wood,/obj/item/stack/spacecash/c10,/obj/item/stack/spacecash/c100,/turf/open/floor/wood,/area/crew_quarters/bar)
"rnJ" = (/obj/machinery/computer/security/telescreen/entertainment{pixel_x = -31},/obj/effect/turf_decal/tile/bar,/obj/effect/turf_decal/tile/bar{dir = 1},/turf/open/floor/plasteel,/area/crew_quarters/bar)
"rBb" = (/obj/machinery/light/small,/obj/effect/turf_decal/tile/bar,/obj/effect/turf_decal/tile/bar{dir = 1},/turf/open/floor/plasteel,/area/crew_quarters/bar)
"rCm" = (/obj/structure/window/reinforced,/obj/structure/window/reinforced{dir = 4},/obj/machinery/door/firedoor/border_only{dir = 4},/obj/machinery/door/firedoor/border_only,/turf/open/floor/wood,/area/crew_quarters/theatre)
"rGA" = (/obj/machinery/door/airlock/maintenance{name = "Bar Maintenance"; req_access_txt = "12"},/obj/structure/disposalpipe/segment,/obj/machinery/door/firedoor/border_only,/obj/machinery/door/firedoor/border_only{dir = 1},/turf/open/floor/plating,/area/maintenance/starboard/fore)
"rHA" = (/obj/machinery/light{dir = 8},/obj/machinery/computer/security/telescreen/entertainment{pixel_x = -31},/obj/effect/turf_decal/tile/bar,/obj/effect/turf_decal/tile/bar{dir = 1},/turf/open/floor/plasteel,/area/crew_quarters/bar)
"rLH" = (/obj/machinery/atmospherics/components/unary/vent_pump/on/layer1{dir = 8; icon_state = "vent_map_on-1"},/turf/open/floor/plasteel/showroomfloor,/area/crew_quarters/kitchen)
"sDl" = (/obj/machinery/disposal/bin,/obj/structure/disposalpipe/trunk{dir = 8},/turf/open/floor/plasteel/cafeteria,/area/crew_quarters/kitchen)
"sRh" = (/obj/structure/table/reinforced,/obj/structure/window/reinforced{dir = 8},/obj/item/book/manual/wiki/barman_recipes,/obj/item/reagent_containers/glass/rag,/turf/open/floor/plasteel/cafeteria,/area/crew_quarters/bar)
"sRi" = (/obj/machinery/light_switch{pixel_y = 28},/obj/machinery/light{dir = 1},/turf/open/floor/wood,/area/crew_quarters/theatre)
"sVd" = (/turf/open/floor/wood,/area/crew_quarters/theatre)
"sXc" = (/obj/structure/closet/secure_closet/freezer/kitchen,/turf/open/floor/plasteel/cafeteria,/area/crew_quarters/kitchen)
"tdr" = (/obj/machinery/light{dir = 8},/obj/effect/turf_decal/tile/bar,/obj/effect/turf_decal/tile/bar{dir = 1},/turf/open/floor/plasteel,/area/crew_quarters/bar)
"tes" = (/obj/structure/disposalpipe/segment{dir = 4},/turf/open/floor/plasteel/cafeteria,/area/crew_quarters/kitchen)
"tuw" = (/obj/machinery/deepfryer,/turf/open/floor/plasteel/cafeteria,/area/crew_quarters/kitchen)
"tBu" = (/turf/open/floor/plasteel/showroomfloor,/area/crew_quarters/kitchen)
"tGW" = (/obj/effect/turf_decal/tile/bar,/obj/effect/turf_decal/tile/bar{dir = 1},/obj/structure/disposalpipe/segment{dir = 5},/turf/open/floor/plasteel,/area/crew_quarters/bar)
"tNo" = (/obj/item/stack/sheet/metal/fifty,/obj/item/stack/sheet/glass/fifty,/obj/item/stack/cable_coil,/obj/item/flashlight/lamp,/obj/item/flashlight/lamp/green,/obj/structure/closet/secure_closet/bartender,/turf/open/floor/wood,/area/crew_quarters/bar)
"tPD" = (/obj/structure/chair/stool{pixel_y = 8},/turf/open/floor/wood,/area/crew_quarters/theatre)
"tQk" = (/obj/machinery/light/small{dir = 4},/obj/effect/turf_decal/tile/bar,/obj/effect/turf_decal/tile/bar{dir = 1},/turf/open/floor/plasteel,/area/crew_quarters/bar)
"umH" = (/obj/structure/disposalpipe/segment{dir = 4},/obj/machinery/atmospherics/components/unary/vent_pump/on/layer1{dir = 8; icon_state = "vent_map_on-1"},/turf/open/floor/plasteel/cafeteria,/area/crew_quarters/kitchen)
"upI" = (/turf/open/floor/wood,/area/crew_quarters/bar)
"utB" = (/obj/effect/turf_decal/tile/bar,/obj/effect/turf_decal/tile/bar{dir = 1},/turf/open/floor/plasteel,/area/crew_quarters/bar)
"uBq" = (/obj/machinery/navbeacon{codes_txt = "delivery;dir=2"; freq = 1400; location = "Kitchen"},/obj/structure/plasticflaps{opacity = 1},/obj/effect/turf_decal/bot{dir = 2},/turf/open/floor/plasteel{dir = 2},/area/crew_quarters/kitchen)
"uDl" = (/obj/machinery/chem_master/condimaster{name = "CondiMaster Neo"},/turf/open/floor/plasteel/showroomfloor,/area/crew_quarters/kitchen)
"uDJ" = (/obj/structure/table,/obj/machinery/microwave{pixel_x = -3; pixel_y = 6},/obj/machinery/airalarm{pixel_y = 24},/obj/machinery/light{dir = 1},/turf/open/floor/plasteel/cafeteria,/area/crew_quarters/kitchen)
"uNn" = (/obj/machinery/atmospherics/components/unary/vent_scrubber/on/layer3{dir = 4; icon_state = "scrub_map_on-3"},/turf/open/floor/wood,/area/crew_quarters/theatre)
"uRN" = (/obj/effect/spawner/xmastree,/obj/effect/turf_decal/tile/bar,/obj/effect/turf_decal/tile/bar{dir = 1},/turf/open/floor/plasteel,/area/crew_quarters/bar)
"uUz" = (/obj/structure/table/reinforced,/obj/machinery/door/firedoor,/obj/machinery/door/poddoor/shutters/preopen{id = "kitchen"; name = "kitchen shutters"},/turf/open/floor/plasteel/cafeteria,/area/crew_quarters/kitchen)
"vfr" = (/obj/structure/table/reinforced,/obj/item/clothing/head/hardhat/cakehat,/turf/open/floor/plasteel/cafeteria,/area/crew_quarters/bar)
"vnw" = (/obj/structure/disposalpipe/segment{dir = 10},/turf/open/floor/plasteel/cafeteria,/area/crew_quarters/kitchen)
"vJB" = (/obj/machinery/light,/obj/effect/turf_decal/tile/bar,/obj/effect/turf_decal/tile/bar{dir = 1},/turf/open/floor/plasteel,/area/crew_quarters/bar)
"vMf" = (/obj/structure/table,/obj/machinery/microwave{pixel_x = -3; pixel_y = 6},/turf/open/floor/plasteel/cafeteria,/area/crew_quarters/kitchen)
"vNN" = (/obj/structure/disposalpipe/segment,/turf/open/floor/wood,/area/crew_quarters/bar)
"wmj" = (/obj/machinery/computer/arcade,/obj/effect/turf_decal/tile/bar,/obj/effect/turf_decal/tile/bar{dir = 1},/turf/open/floor/plasteel,/area/crew_quarters/bar)
"wFp" = (/obj/effect/turf_decal/tile/bar,/obj/effect/turf_decal/tile/bar{dir = 1},/obj/item/twohanded/required/kirbyplants/random,/turf/open/floor/plasteel,/area/crew_quarters/bar)
"wKZ" = (/obj/machinery/light_switch{pixel_y = -25},/turf/open/floor/plasteel/cafeteria,/area/crew_quarters/kitchen)
"wSU" = (/obj/machinery/disposal/bin,/obj/structure/disposalpipe/trunk{dir = 8},/obj/effect/turf_decal/tile/bar,/obj/effect/turf_decal/tile/bar{dir = 1},/obj/machinery/firealarm{dir = 2; pixel_y = 26},/turf/open/floor/plasteel,/area/crew_quarters/bar)
"wZA" = (/turf/open/floor/plasteel/cafeteria,/area/crew_quarters/bar)
"xct" = (/obj/machinery/chem_dispenser/drinks,/obj/structure/table/reinforced,/turf/open/floor/plasteel/cafeteria,/area/crew_quarters/bar)
"xlD" = (/obj/machinery/door/airlock/maintenance{name = "Kitchen Maintenance"; req_access_txt = "28"},/obj/structure/disposalpipe/segment,/obj/machinery/atmospherics/pipe/simple/supply/hidden/layer1,/obj/machinery/atmospherics/pipe/simple/scrubbers/hidden/layer3,/obj/machinery/door/firedoor/border_only,/obj/machinery/door/firedoor/border_only{dir = 1},/turf/open/floor/plating,/area/maintenance/starboard/fore)
"xoV" = (/obj/structure/table,/obj/item/book/manual/chef_recipes,/obj/item/book/manual/wiki/cooking_to_serve_man{pixel_x = -4; pixel_y = 4},/turf/open/floor/plasteel/cafeteria,/area/crew_quarters/kitchen)
"xpf" = (/obj/machinery/atmospherics/components/unary/vent_pump/on/layer1{dir = 8; icon_state = "vent_map_on-1"},/turf/open/floor/wood,/area/crew_quarters/bar)
"xqO" = (/obj/structure/kitchenspike,/obj/machinery/light/small{dir = 8},/turf/open/floor/plasteel/showroomfloor,/area/crew_quarters/kitchen)
"xta" = (/obj/machinery/processor,/obj/machinery/firealarm{dir = 8; pixel_x = 26; pixel_y = 0},/turf/open/floor/plasteel/cafeteria,/area/crew_quarters/kitchen)
"xTn" = (/obj/machinery/newscaster{pixel_y = -28},/obj/effect/turf_decal/tile/bar,/obj/effect/turf_decal/tile/bar{dir = 1},/obj/item/twohanded/required/kirbyplants/random,/turf/open/floor/plasteel,/area/crew_quarters/bar)
"xWf" = (/obj/machinery/door/airlock{name = "Kitchen cold room"; req_access_txt = "28"},/obj/structure/disposalpipe/segment,/obj/machinery/atmospherics/pipe/simple/supply/hidden/layer1,/obj/machinery/atmospherics/pipe/simple/scrubbers/hidden/layer3,/obj/machinery/door/firedoor/border_only,/obj/machinery/door/firedoor/border_only{dir = 1},/turf/open/floor/plasteel/showroomfloor,/area/crew_quarters/kitchen)
"xXj" = (/obj/machinery/door/airlock{name = "Bar Storage"; req_access_txt = "25"},/obj/structure/disposalpipe/segment,/obj/machinery/door/firedoor/border_only,/obj/machinery/door/firedoor/border_only{dir = 1},/turf/open/floor/plasteel{icon_state = "wood"},/area/crew_quarters/bar)
"yfl" = (/obj/structure/closet/secure_closet/bar{req_access_txt = "25"},/turf/open/floor/wood,/area/crew_quarters/bar)
"yjE" = (/obj/effect/landmark/event_spawn,/turf/closed/wall,/area/crew_quarters/bar)
"ymm" = (/obj/structure/disposalpipe/segment,/turf/open/floor/plasteel/cafeteria,/area/crew_quarters/kitchen)

(1,1,1) = {"
qYM
qYM
gLH
gLH
gLH
nqd
yjE
isv
nqd
isv
nqd
isv
nqd
nqd
"}
(2,1,1) = {"
qYM
qYM
aup
gfv
pwB
rnJ
tdr
utB
bUJ
utB
rHA
utB
wmj
nqd
"}
(3,1,1) = {"
qYM
qYM
tPD
sVd
iPb
utB
utB
utB
uRN
utB
utB
utB
frB
nqd
"}
(4,1,1) = {"
gLH
sRi
uNn
sVd
iPb
utB
utB
utB
utB
utB
utB
utB
xTn
nqd
"}
(5,1,1) = {"
qAG
eac
eNi
iqB
iPb
utB
utB
ouJ
ouJ
ouJ
ouJ
utB
nHx
nqd
"}
(6,1,1) = {"
gLH
hFz
paO
qEU
iPb
utB
ouJ
vfr
fXL
fvl
oOr
ouJ
utB
diP
"}
(7,1,1) = {"
gLH
qek
sVd
sVd
iPb
utB
ouJ
oOr
wZA
wZA
oOr
ouJ
utB
isv
"}
(8,1,1) = {"
gLH
pZz
pZz
eWY
rCm
utB
ouJ
oOr
wZA
wZA
oOr
ouJ
utB
diP
"}
(9,1,1) = {"
nqd
wFp
utB
utB
utB
utB
ouJ
oOr
wZA
wZA
oOr
ouJ
vJB
eBE
"}
(10,1,1) = {"
rGA
tGW
utB
utB
utB
utB
ouJ
oOr
wZA
wZA
oOr
ouJ
ies
nqd
"}
(11,1,1) = {"
nqd
wSU
utB
tQk
utB
utB
ouJ
oOr
wZA
wZA
oOr
ouJ
jLt
nqd
"}
(12,1,1) = {"
nqd
nqd
nqd
nqd
nqd
ban
sRh
xct
eXC
wZA
oOr
ouJ
hpb
nqd
"}
(13,1,1) = {"
rbg
hlB
pbN
yfl
nqd
fyo
wZA
wZA
wZA
wZA
oOr
aJx
dTx
nqd
"}
(14,1,1) = {"
iTv
iTv
pmz
vNN
xXj
qYr
pFj
euf
wZA
wZA
eAP
utB
rBb
nqd
"}
(15,1,1) = {"
anr
upI
xpf
tNo
nqd
mVW
iSB
wZA
wZA
wZA
mkn
utB
utB
nqd
"}
(16,1,1) = {"
nqd
kQj
peA
nqd
nqd
jIb
jIb
mCX
mCX
mCX
jIb
nrk
jIb
jIb
"}
(17,1,1) = {"
hET
hPU
jtC
nqd
iCY
jIb
kXE
ego
ego
ego
ego
wKZ
jIb
arG
"}
(18,1,1) = {"
jIb
jIb
jIb
jIb
jIb
jIb
mdC
ego
ego
ego
ego
oBC
jIb
arG
"}
(19,1,1) = {"
jIb
exl
aog
xqO
lBK
jIb
fLR
lJg
pQj
gwB
ego
ego
pHz
arG
"}
(20,1,1) = {"
xlD
eaM
eaM
cSt
oXC
xWf
dBJ
iOS
cQK
orW
jzN
ego
uUz
arG
"}
(21,1,1) = {"
jIb
oTc
uDl
myU
rLH
jIb
feg
umH
oyl
tuw
ego
aTN
uUz
arG
"}
(22,1,1) = {"
uBq
iAU
gMm
tBu
tBu
jIb
uDJ
tes
xoV
tuw
ego
ego
uUz
arG
"}
(23,1,1) = {"
jIb
jIb
jIb
aAI
hwJ
jIb
vMf
vnw
ymm
ymm
ymm
nJf
jIb
arG
"}
(24,1,1) = {"
arG
arG
jIb
jIb
jIb
jIb
sXc
ego
ego
xta
iPt
sDl
jIb
arG
"}
