// This map has been converted using maphash
"arG" = (/turf/template_noop,/area/template_noop)
"aMP" = (/obj/machinery/light_switch{pixel_y = -25},/turf/open/floor/plasteel/ameridiner,/area/crew_quarters/kitchen)
"aYQ" = (/obj/machinery/airalarm{dir = 4; icon_state = "alarm0"; pixel_x = -22},/obj/machinery/camera{c_tag = "Bar West"; dir = 4; network = list("SS13")},/turf/open/floor/plasteel/dark,/area/crew_quarters/bar)
"bxC" = (/mob/living/simple_animal/hostile/retaliate/dolphin/bouncer{desc = "A bouncer in space."},/turf/open/floor/plasteel/dark,/area/crew_quarters/bar)
"bDR" = (/obj/structure/table/reinforced,/obj/machinery/door/firedoor,/obj/machinery/door/window/westright,/turf/open/floor/plasteel/ameridiner,/area/crew_quarters/kitchen)
"bHp" = (/obj/machinery/newscaster{pixel_y = -28},/obj/structure/chair/americandiner/booth/single{dir = 8; icon_state = "ameribooth_single"; tag = ""},/turf/open/floor/plasteel/dark,/area/crew_quarters/bar)
"ced" = (/obj/effect/landmark/event_spawn,/turf/open/floor/plasteel/dark,/area/crew_quarters/bar)
"cfC" = (/obj/machinery/disposal/bin,/obj/structure/disposalpipe/trunk{dir = 8},/turf/open/floor/plasteel/ameridiner,/area/crew_quarters/kitchen)
"cgI" = (/obj/machinery/atmospherics/pipe/simple/supply/hidden/layer1{dir = 5; icon_state = "pipe11-1"},/obj/machinery/atmospherics/pipe/simple/scrubbers/hidden/layer3{dir = 9; icon_state = "pipe11-3"},/obj/structure/disposalpipe/segment{dir = 5},/turf/open/floor/plasteel/ameridiner,/area/crew_quarters/kitchen)
"ciA" = (/obj/structure/disposalpipe/segment,/obj/machinery/atmospherics/pipe/simple/supply/hidden/layer1,/obj/machinery/atmospherics/pipe/simple/scrubbers/hidden/layer3,/turf/open/floor/plasteel/ameridiner,/area/crew_quarters/bar)
"ciU" = (/obj/machinery/disposal/bin,/obj/structure/disposalpipe/trunk{dir = 8},/obj/machinery/firealarm{dir = 2; pixel_y = 26},/turf/open/floor/plasteel/dark,/area/crew_quarters/bar)
"cLa" = (/obj/structure/disposalpipe/segment{dir = 4},/obj/machinery/atmospherics/components/unary/vent_pump/on/layer1{dir = 8; icon_state = "vent_map_on-1"},/turf/open/floor/plasteel/ameridiner,/area/crew_quarters/kitchen)
"deB" = (/obj/item/clothing/head/hardhat/cakehat,/obj/structure/table/reinforced,/turf/open/floor/plasteel/dark,/area/crew_quarters/bar)
"dyv" = (/obj/effect/landmark/blobstart,/turf/open/floor/plating,/area/crew_quarters/bar)
"dJq" = (/obj/machinery/camera{c_tag = "Theatre Stage"; dir = 2},/obj/machinery/light{dir = 1},/turf/open/floor/plasteel/dark,/area/crew_quarters/bar)
"dMi" = (/obj/machinery/smartfridge/drinks,/turf/open/floor/wood,/area/crew_quarters/bar)
"dOE" = (/obj/structure/chair/americandiner/black{dir = 4; icon_state = "americhair_black"; tag = ""},/turf/open/floor/plasteel/dark,/area/crew_quarters/bar)
"dRi" = (/obj/structure/sink/kitchen{pixel_y = 28},/turf/open/floor/plasteel/ameridiner,/area/crew_quarters/bar)
"dUl" = (/obj/machinery/door/airlock{name = "Bar Storage"; req_access_txt = "25"},/obj/structure/disposalpipe/segment,/obj/machinery/door/firedoor/border_only,/obj/machinery/door/firedoor/border_only{dir = 1},/turf/open/floor/plasteel/ameridiner,/area/crew_quarters/bar)
"eir" = (/obj/structure/chair/stool,/turf/open/floor/plasteel/dark,/area/crew_quarters/bar)
"elg" = (/obj/structure/disposalpipe/segment,/turf/open/floor/plasteel/ameridiner,/area/crew_quarters/bar)
"elQ" = (/obj/structure/chair/americandiner/booth/single{dir = 4; icon_state = "ameribooth_single"; tag = ""},/turf/open/floor/plasteel/dark,/area/crew_quarters/bar)
"esY" = (/obj/structure/closet/secure_closet/freezer/meat,/turf/open/floor/plasteel{icon_state = "showroomfloor"},/area/crew_quarters/kitchen)
"eBE" = (/obj/structure/sign/barsign,/turf/closed/wall,/area/crew_quarters/bar)
"eHJ" = (/obj/structure/table,/obj/item/stack/packageWrap,/obj/item/reagent_containers/food/condiment/enzyme,/turf/open/floor/plasteel/ameridiner,/area/crew_quarters/kitchen)
"eOq" = (/obj/structure/table/reinforced,/turf/open/floor/plasteel/dark,/area/crew_quarters/bar)
"eTK" = (/obj/machinery/airalarm{dir = 4; icon_state = "alarm0"; pixel_x = -22},/obj/machinery/light/small{dir = 8},/obj/structure/reagent_dispensers/beerkeg,/obj/machinery/atmospherics/components/unary/vent_scrubber/on/layer3{dir = 4; icon_state = "scrub_map_on-3"},/turf/open/floor/plasteel/ameridiner,/area/crew_quarters/bar)
"eUw" = (/obj/structure/disposalpipe/segment,/obj/effect/landmark/xeno_spawn,/obj/machinery/atmospherics/pipe/simple/supply/hidden/layer1{dir = 5; icon_state = "pipe11-1"},/obj/machinery/atmospherics/pipe/simple/scrubbers/hidden/layer3{dir = 9; icon_state = "pipe11-3"},/turf/open/floor/plasteel/ameridiner,/area/crew_quarters/bar)
"eZi" = (/obj/structure/disposalpipe/segment,/obj/machinery/atmospherics/pipe/simple/supply/hidden/layer1,/obj/machinery/atmospherics/pipe/simple/scrubbers/hidden/layer3,/turf/open/floor/plasteel/ameridiner,/area/crew_quarters/kitchen)
"fgR" = (/obj/machinery/computer/security/telescreen/entertainment{pixel_x = -31},/obj/machinery/light{dir = 8},/turf/open/floor/plasteel/dark,/area/crew_quarters/bar)
"fvA" = (/obj/structure/disposalpipe/segment{dir = 10},/turf/open/floor/plasteel/ameridiner,/area/crew_quarters/kitchen)
"gmR" = (/obj/machinery/vending/dinnerware,/turf/open/floor/plasteel/ameridiner,/area/crew_quarters/kitchen)
"gZX" = (/obj/structure/extinguisher_cabinet{pixel_y = -30},/obj/structure/chair/americandiner/black{dir = 8; icon_state = "americhair_black"; tag = ""},/turf/open/floor/plasteel/dark,/area/crew_quarters/bar)
"hdA" = (/turf/open/floor/plasteel/ameridiner,/area/crew_quarters/bar)
"hfQ" = (/obj/machinery/deepfryer,/turf/open/floor/plasteel/ameridiner,/area/crew_quarters/kitchen)
"hgE" = (/obj/structure/table/reinforced,/obj/item/clothing/head/that,/turf/open/floor/wood,/area/crew_quarters/bar)
"hmv" = (/obj/machinery/light_switch,/turf/closed/wall,/area/crew_quarters/bar)
"huP" = (/obj/machinery/door/airlock{name = "Theatre Backstage"; req_access_txt = "46"},/obj/machinery/atmospherics/pipe/simple/supply/hidden/layer1,/obj/machinery/atmospherics/pipe/simple/scrubbers/hidden/layer3,/obj/machinery/door/firedoor,/obj/machinery/door/firedoor/border_only,/obj/machinery/door/firedoor/border_only{dir = 1},/turf/open/floor/plasteel,/area/crew_quarters/theatre)
"hvi" = (/obj/machinery/atmospherics/components/unary/vent_scrubber/on/layer3{dir = 4; icon_state = "scrub_map_on-3"},/turf/open/floor/plasteel/ameridiner,/area/crew_quarters/kitchen)
"hyH" = (/obj/structure/disposalpipe/segment,/obj/machinery/atmospherics/pipe/simple/supply/hidden/layer1,/obj/machinery/atmospherics/pipe/simple/scrubbers/hidden/layer3,/turf/open/floor/plasteel{icon_state = "showroomfloor"},/area/crew_quarters/kitchen)
"hET" = (/obj/machinery/door/window/southleft{base_state = "left"; dir = 2; icon_state = "left"; name = "Bar Delivery"; req_access_txt = "25"},/obj/effect/turf_decal/delivery,/turf/open/floor/plasteel,/area/crew_quarters/bar)
"hSE" = (/obj/structure/disposalpipe/segment,/turf/open/floor/plasteel/ameridiner,/area/crew_quarters/kitchen)
"iwa" = (/obj/item/storage/secure/safe,/turf/closed/wall,/area/crew_quarters/bar)
"iCV" = (/obj/structure/disposalpipe/segment{dir = 4},/turf/open/floor/wood,/area/crew_quarters/bar)
"iYK" = (/obj/machinery/processor,/obj/machinery/firealarm{dir = 8; pixel_x = 26; pixel_y = 0},/turf/open/floor/plasteel/ameridiner,/area/crew_quarters/kitchen)
"iZz" = (/turf/open/floor/plasteel/ameridiner,/area/crew_quarters/kitchen)
"jok" = (/obj/machinery/requests_console{department = "Bar"; departmentType = 2; pixel_x = 30; pixel_y = 0},/obj/machinery/camera{c_tag = "Bar"; dir = 8; network = list("SS13")},/obj/structure/fermenting_barrel,/turf/open/floor/wood,/area/crew_quarters/bar)
"jug" = (/obj/machinery/navbeacon{codes_txt = "delivery;dir=2"; freq = 1400; location = "Kitchen"},/obj/structure/plasticflaps{opacity = 1},/turf/open/floor/plasteel,/area/crew_quarters/kitchen)
"jyB" = (/obj/structure/chair/americandiner/booth/end_left{dir = 4; icon_state = "ameribooth-end1"; tag = ""},/turf/open/floor/plasteel/dark,/area/crew_quarters/bar)
"jzU" = (/turf/open/floor/light/colour_cycle/dancefloor_a,/area/crew_quarters/bar)
"jIb" = (/turf/closed/wall,/area/crew_quarters/kitchen)
"jRl" = (/obj/machinery/light/small{dir = 4},/turf/open/floor/plasteel/ameridiner,/area/crew_quarters/bar)
"kdH" = (/obj/machinery/camera{c_tag = "Bar South"; dir = 1},/turf/open/floor/plasteel/dark,/area/crew_quarters/bar)
"khX" = (/obj/machinery/reagentgrinder,/obj/structure/table/wood,/turf/open/floor/plasteel/ameridiner,/area/crew_quarters/bar)
"koq" = (/obj/effect/landmark/event_spawn,/obj/machinery/atmospherics/components/unary/vent_pump/on/layer1{dir = 8; icon_state = "vent_map_on-1"},/turf/open/floor/plasteel{icon_state = "showroomfloor"},/area/crew_quarters/kitchen)
"kwB" = (/obj/structure/table/reinforced,/obj/machinery/door/firedoor/border_only,/obj/machinery/door/poddoor/shutters/preopen{id = "kitchen"; name = "kitchen shutters"},/obj/item/storage/fancy/donut_box,/turf/open/floor/plasteel/ameridiner,/area/crew_quarters/kitchen)
"kwZ" = (/obj/machinery/door/airlock/public/glass{name = "Diner"},/obj/machinery/door/firedoor/border_only,/obj/machinery/door/firedoor/border_only{dir = 1},/turf/open/floor/plasteel/dark,/area/crew_quarters/bar)
"lbG" = (/obj/machinery/atmospherics/components/unary/vent_scrubber/on/layer3{dir = 8; icon_state = "scrub_map_on-3"},/obj/effect/spawner/lootdrop/mob/kitchen_animal,/turf/open/floor/plasteel{icon_state = "showroomfloor"},/area/crew_quarters/kitchen)
"lwA" = (/obj/machinery/disposal/bin,/obj/structure/disposalpipe/trunk{dir = 4},/obj/structure/window/reinforced{dir = 8},/turf/open/floor/wood,/area/crew_quarters/bar)
"lyO" = (/obj/structure/sink/kitchen{pixel_y = 28},/turf/open/floor/plasteel/ameridiner,/area/crew_quarters/kitchen)
"lzO" = (/obj/machinery/door/airlock/maintenance{name = "Bar Maintenance"; req_access_txt = "12"},/obj/structure/disposalpipe/segment,/obj/machinery/door/firedoor/border_only{dir = 1},/obj/machinery/door/firedoor/border_only,/turf/open/floor/plating,/area/maintenance/starboard/fore)
"lIS" = (/obj/machinery/light,/turf/open/floor/plasteel/ameridiner,/area/crew_quarters/kitchen)
"mgc" = (/obj/item/reagent_containers/food/drinks/shaker,/obj/structure/table/wood,/obj/item/stack/sheet/metal{amount = 50},/obj/item/stack/sheet/glass{amount = 50},/obj/item/stack/cable_coil,/turf/open/floor/plasteel/ameridiner,/area/crew_quarters/bar)
"mij" = (/obj/structure/sign/plaques/deempisi,/turf/closed/wall,/area/crew_quarters/bar)
"mry" = (/obj/structure/chair/americandiner/booth/end_right{dir = 4; icon_state = "ameribooth-end2"; tag = ""},/turf/open/floor/plasteel/dark,/area/crew_quarters/bar)
"muL" = (/obj/machinery/light/small{dir = 4},/obj/machinery/airalarm{dir = 8; icon_state = "alarm0"; pixel_x = 24},/obj/machinery/vending/wardrobe/chef_wardrobe,/turf/open/floor/plasteel{icon_state = "showroomfloor"},/area/crew_quarters/kitchen)
"mwu" = (/obj/effect/turf_decal/loading_area,/turf/open/floor/plasteel{icon_state = "showroomfloor"},/area/crew_quarters/kitchen)
"mDQ" = (/obj/structure/table,/obj/machinery/microwave{pixel_x = -3; pixel_y = 6},/obj/machinery/airalarm{pixel_y = 24},/obj/machinery/light{dir = 1},/turf/open/floor/plasteel/ameridiner,/area/crew_quarters/kitchen)
"nqd" = (/turf/closed/wall,/area/crew_quarters/bar)
"nLt" = (/obj/machinery/chem_master/condimaster{name = "CondiMaster Neo"},/obj/machinery/camera{c_tag = "Kitchen Cold Room"},/turf/open/floor/plasteel{icon_state = "showroomfloor"},/area/crew_quarters/kitchen)
"okc" = (/turf/closed/wall/r_wall{icon = 'icons/turf/walls/wall.dmi'; icon_state = "wall"},/area/crew_quarters/kitchen)
"osW" = (/obj/structure/chair/americandiner/booth/end_right{dir = 8; icon_state = "ameribooth-end2"; tag = ""},/turf/open/floor/plasteel/dark,/area/crew_quarters/bar)
"ozM" = (/obj/machinery/door/airlock/maintenance{name = "Kitchen Maintenance"; req_access_txt = "28"},/obj/structure/disposalpipe/segment,/obj/machinery/atmospherics/pipe/simple/supply/hidden/layer1,/obj/machinery/atmospherics/pipe/simple/scrubbers/hidden/layer3,/obj/machinery/door/firedoor/border_only{dir = 1},/obj/machinery/door/firedoor/border_only,/turf/open/floor/plating,/area/maintenance/starboard/fore)
"oJC" = (/obj/effect/landmark/event_spawn,/turf/open/floor/light/colour_cycle/dancefloor_a,/area/crew_quarters/bar)
"oPw" = (/obj/structure/table/reinforced,/obj/item/book/manual/wiki/barman_recipes,/obj/item/reagent_containers/glass/rag,/turf/open/floor/wood,/area/crew_quarters/bar)
"pbg" = (/obj/structure/chair/americandiner/booth/end_right{dir = 8; icon_state = "ameribooth-end2"; tag = ""},/obj/machinery/atmospherics/components/unary/vent_scrubber/on/layer3{dir = 4; icon_state = "scrub_map_on-3"},/turf/open/floor/plasteel/dark,/area/crew_quarters/bar)
"pjf" = (/obj/machinery/gibber,/turf/open/floor/plasteel{icon_state = "showroomfloor"},/area/crew_quarters/kitchen)
"pqq" = (/obj/machinery/light,/obj/machinery/firealarm{dir = 1; pixel_y = -26},/turf/open/floor/plasteel/dark,/area/crew_quarters/bar)
"puE" = (/turf/open/floor/plasteel/dark,/area/crew_quarters/bar)
"pym" = (/obj/structure/disposalpipe/segment,/obj/machinery/atmospherics/pipe/simple/supply/hidden/layer1,/obj/machinery/atmospherics/pipe/manifold/scrubbers/hidden/layer3{dir = 8; icon_state = "manifold-3"},/turf/open/floor/plasteel{icon_state = "showroomfloor"},/area/crew_quarters/kitchen)
"pUQ" = (/obj/structure/rack,/obj/item/grenade/chem_grenade/glitter/blue,/obj/item/grenade/chem_grenade/glitter/pink,/obj/item/grenade/chem_grenade/glitter/white,/turf/open/floor/plasteel/ameridiner,/area/crew_quarters/bar)
"qdv" = (/obj/machinery/atmospherics/pipe/simple/supply/hidden/layer1,/obj/machinery/atmospherics/pipe/simple/scrubbers/hidden/layer3,/turf/open/floor/plasteel/dark,/area/crew_quarters/bar)
"qgy" = (/obj/item/stack/sheet/metal/fifty,/obj/item/stack/sheet/glass/fifty,/obj/item/stack/cable_coil,/obj/item/flashlight/lamp,/obj/item/flashlight/lamp/green,/obj/structure/closet/secure_closet/bartender,/turf/open/floor/plasteel/ameridiner,/area/crew_quarters/bar)
"qiB" = (/obj/machinery/airalarm{dir = 1; icon_state = "alarm0"; pixel_y = -22},/obj/structure/chair/americandiner/black{dir = 4; icon_state = "americhair_black"; tag = ""},/turf/open/floor/plasteel/dark,/area/crew_quarters/bar)
"qjv" = (/obj/machinery/airalarm{dir = 2; pixel_y = 24},/turf/open/floor/plasteel/dark,/area/crew_quarters/bar)
"qkX" = (/obj/structure/kitchenspike,/turf/open/floor/plasteel{icon_state = "showroomfloor"},/area/crew_quarters/kitchen)
"qlp" = (/obj/machinery/door/airlock{name = "Kitchen cold room"; req_access_txt = "28"},/obj/structure/disposalpipe/segment,/obj/machinery/atmospherics/pipe/simple/supply/hidden/layer1,/obj/machinery/atmospherics/pipe/simple/scrubbers/hidden/layer3,/obj/machinery/door/firedoor/border_only{dir = 1},/obj/machinery/door/firedoor/border_only,/turf/open/floor/plasteel{icon_state = "showroomfloor"},/area/crew_quarters/kitchen)
"qrI" = (/obj/structure/kitchenspike,/obj/machinery/light/small{dir = 8},/turf/open/floor/plasteel{icon_state = "showroomfloor"},/area/crew_quarters/kitchen)
"qHL" = (/obj/structure/noticeboard{dir = 1; pixel_y = -27},/turf/open/floor/plasteel/dark,/area/crew_quarters/bar)
"qJx" = (/obj/structure/table/reinforced,/obj/machinery/chem_dispenser/drinks,/obj/machinery/door/window/eastleft{dir = 8; icon_state = "right"; name = "Soda Dispenser"; req_access_txt = "0"},/turf/open/floor/wood,/area/crew_quarters/bar)
"qTU" = (/turf/open/floor/plasteel{icon_state = "showroomfloor"},/area/crew_quarters/kitchen)
"rpK" = (/obj/structure/table,/obj/item/book/manual/chef_recipes,/obj/item/book/manual/wiki/cooking_to_serve_man{pixel_x = -4; pixel_y = 4},/turf/open/floor/plasteel/ameridiner,/area/crew_quarters/kitchen)
"rAl" = (/obj/machinery/camera{c_tag = "Bar Storage"},/turf/open/floor/plasteel/ameridiner,/area/crew_quarters/bar)
"rTS" = (/obj/structure/table/reinforced,/obj/machinery/light,/turf/open/floor/plasteel/dark,/area/crew_quarters/bar)
"rYy" = (/obj/structure/table,/obj/machinery/chem_dispenser/drinks/beer,/obj/machinery/firealarm{dir = 8; pixel_x = 26; pixel_y = 0},/turf/open/floor/wood,/area/crew_quarters/bar)
"spB" = (/obj/machinery/light,/turf/open/floor/plasteel/dark,/area/crew_quarters/bar)
"sDu" = (/obj/structure/chair/americandiner/booth/end_left{dir = 8; icon_state = "ameribooth-end1"; tag = ""},/obj/effect/landmark/start/assistant,/turf/open/floor/plasteel/dark,/area/crew_quarters/bar)
"sQt" = (/obj/structure/table/reinforced,/turf/open/floor/wood,/area/crew_quarters/bar)
"sTf" = (/obj/item/wrench,/turf/open/floor/light/colour_cycle/dancefloor_a,/area/crew_quarters/bar)
"sVo" = (/obj/structure/disposalpipe/segment{dir = 4},/turf/open/floor/plasteel/ameridiner,/area/crew_quarters/kitchen)
"tbG" = (/obj/machinery/atmospherics/components/unary/vent_pump/on/layer1{dir = 8; icon_state = "vent_map_on-1"},/turf/open/floor/plasteel/ameridiner,/area/crew_quarters/bar)
"ttO" = (/obj/machinery/jukebox/disco,/turf/open/floor/light/colour_cycle/dancefloor_a,/area/crew_quarters/bar)
"tMb" = (/obj/structure/table,/obj/machinery/reagentgrinder,/obj/machinery/requests_console{department = "Kitchen"; departmentType = 2; pixel_x = 30; pixel_y = 0},/turf/open/floor/plasteel/ameridiner,/area/crew_quarters/kitchen)
"tSy" = (/obj/machinery/door/airlock{name = "Kitchen"; req_access_txt = "28"},/turf/open/floor/plasteel/dark,/area/crew_quarters/kitchen)
"tUB" = (/mob/living/carbon/monkey{name = "Pun Pun"},/turf/open/floor/wood,/area/crew_quarters/bar)
"tWi" = (/obj/machinery/light{dir = 4; light_color = "#e8eaff"},/turf/open/floor/wood,/area/crew_quarters/bar)
"uay" = (/obj/structure/table,/obj/machinery/microwave{pixel_x = -3; pixel_y = 6},/obj/item/storage/box/donkpockets,/turf/open/floor/plasteel/ameridiner,/area/crew_quarters/kitchen)
"ugZ" = (/obj/machinery/computer/slot_machine,/turf/open/floor/plasteel/dark,/area/crew_quarters/bar)
"ujK" = (/obj/effect/landmark/event_spawn,/turf/open/floor/plasteel/ameridiner,/area/crew_quarters/kitchen)
"upI" = (/turf/open/floor/wood,/area/crew_quarters/bar)
"urD" = (/obj/machinery/icecream_vat,/turf/open/floor/plasteel{icon_state = "showroomfloor"},/area/crew_quarters/kitchen)
"uwX" = (/obj/machinery/door/window/southleft{base_state = "left"; dir = 2; icon_state = "left"; name = "Kitchen Delivery"; req_access_txt = "28"},/obj/effect/turf_decal/delivery,/turf/open/floor/plasteel,/area/crew_quarters/kitchen)
"uEP" = (/obj/machinery/vending/boozeomat,/turf/open/floor/wood,/area/crew_quarters/bar)
"uFk" = (/obj/structure/chair/americandiner/booth/end_right{dir = 4; icon_state = "ameribooth-end2"; tag = ""},/obj/machinery/atmospherics/components/unary/vent_pump/on/layer1{dir = 8; icon_state = "vent_map_on-1"},/turf/open/floor/plasteel/dark,/area/crew_quarters/bar)
"uKL" = (/obj/structure/table/reinforced,/obj/machinery/door/firedoor/border_only,/obj/machinery/door/poddoor/shutters/preopen{id = "kitchen"; name = "kitchen shutters"},/obj/item/reagent_containers/food/snacks/mint,/turf/open/floor/plasteel/ameridiner,/area/crew_quarters/kitchen)
"uRG" = (/obj/machinery/door/window/southright{name = "Bar Door"; req_access_txt = "25"; req_one_access_txt = null},/turf/open/floor/wood,/area/crew_quarters/bar)
"uVI" = (/obj/structure/disposalpipe/segment{dir = 9},/turf/open/floor/wood,/area/crew_quarters/bar)
"uWg" = (/obj/effect/landmark/start/bartender,/turf/open/floor/wood,/area/crew_quarters/bar)
"vfn" = (/obj/structure/disposalpipe/segment,/obj/machinery/atmospherics/pipe/manifold/supply/hidden/layer1{dir = 8; icon_state = "manifold-1"},/obj/machinery/atmospherics/pipe/simple/scrubbers/hidden/layer3,/turf/open/floor/plasteel{icon_state = "showroomfloor"},/area/crew_quarters/kitchen)
"vIE" = (/obj/structure/closet/secure_closet/bar{req_access_txt = "25"},/obj/item/gun/ballistic/revolver/russian,/turf/open/floor/plasteel/ameridiner,/area/crew_quarters/bar)
"vOY" = (/obj/machinery/camera{c_tag = "Kitchen"; dir = 2; network = list("SS13")},/obj/structure/closet/secure_closet/freezer/fridge,/turf/open/floor/plasteel/ameridiner,/area/crew_quarters/kitchen)
"vTE" = (/obj/structure/disposalpipe/segment{dir = 5},/turf/open/floor/plasteel/dark,/area/crew_quarters/bar)
"vTP" = (/obj/effect/landmark/start/assistant,/turf/open/floor/light/colour_cycle/dancefloor_a,/area/crew_quarters/bar)
"wpD" = (/obj/structure/chair/americandiner/booth/end_left{dir = 8; icon_state = "ameribooth-end1"; tag = ""},/turf/open/floor/plasteel/dark,/area/crew_quarters/bar)
"wsM" = (/obj/effect/spawner/structure/window/plasma/reinforced,/turf/open/floor/plating,/area/crew_quarters/bar)
"wRt" = (/obj/structure/table,/obj/item/reagent_containers/food/snacks/salad/fruit,/turf/open/floor/plasteel/ameridiner,/area/crew_quarters/kitchen)
"xac" = (/obj/structure/closet/secure_closet/freezer/kitchen,/turf/open/floor/plasteel/ameridiner,/area/crew_quarters/kitchen)
"xif" = (/obj/machinery/vending/wardrobe/bar_wardrobe,/turf/open/floor/plasteel/ameridiner,/area/crew_quarters/bar)
"xyc" = (/obj/effect/landmark/start/cook,/turf/open/floor/plasteel/ameridiner,/area/crew_quarters/kitchen)
"xOJ" = (/obj/structure/table/reinforced,/obj/machinery/door/firedoor/border_only,/obj/machinery/door/poddoor/shutters/preopen{id = "kitchen"; name = "kitchen shutters"},/turf/open/floor/plasteel/ameridiner,/area/crew_quarters/kitchen)
"xVl" = (/obj/machinery/atmospherics/pipe/simple/supply/hidden/layer1{dir = 5; icon_state = "pipe11-1"},/obj/machinery/atmospherics/pipe/simple/scrubbers/hidden/layer3{dir = 9; icon_state = "pipe11-3"},/turf/open/floor/plasteel/dark,/area/crew_quarters/bar)
"yfY" = (/obj/structure/extinguisher_cabinet{pixel_x = -5; pixel_y = 30},/obj/machinery/food_cart,/turf/open/floor/plasteel/ameridiner,/area/crew_quarters/kitchen)
"ymb" = (/obj/machinery/button/door{id = "kitchen"; name = "Kitchen Shutters Control"; pixel_x = -1; pixel_y = -24; req_access_txt = "28"},/obj/structure/disposalpipe/segment{dir = 5},/turf/open/floor/plasteel/ameridiner,/area/crew_quarters/kitchen)

(1,1,1) = {"
arG
nqd
nqd
nqd
nqd
nqd
nqd
wsM
nqd
wsM
nqd
wsM
nqd
nqd
"}
(2,1,1) = {"
arG
nqd
mry
jyB
puE
fgR
puE
puE
aYQ
puE
fgR
puE
elQ
nqd
"}
(3,1,1) = {"
nqd
nqd
deB
eOq
puE
puE
puE
puE
puE
puE
puE
puE
eOq
nqd
"}
(4,1,1) = {"
hmv
puE
pbg
wpD
jzU
jzU
jzU
jzU
jzU
jzU
jzU
puE
bHp
nqd
"}
(5,1,1) = {"
huP
qdv
xVl
puE
jzU
jzU
vTP
jzU
jzU
jzU
jzU
puE
pqq
nqd
"}
(6,1,1) = {"
nqd
qjv
uFk
jyB
jzU
jzU
jzU
sTf
jzU
jzU
jzU
puE
puE
kwZ
"}
(7,1,1) = {"
nqd
dJq
eOq
eOq
jzU
jzU
vTP
ttO
jzU
oJC
jzU
bxC
puE
wsM
"}
(8,1,1) = {"
nqd
puE
osW
sDu
jzU
jzU
jzU
jzU
vTP
jzU
jzU
puE
puE
kwZ
"}
(9,1,1) = {"
nqd
puE
puE
puE
jzU
jzU
jzU
jzU
jzU
jzU
jzU
puE
spB
eBE
"}
(10,1,1) = {"
lzO
vTE
eir
eir
jzU
jzU
jzU
jzU
jzU
jzU
jzU
puE
kdH
nqd
"}
(11,1,1) = {"
nqd
ciU
ugZ
ugZ
puE
puE
puE
dOE
dOE
dOE
dOE
puE
qHL
nqd
"}
(12,1,1) = {"
nqd
nqd
nqd
nqd
mij
lwA
qJx
sQt
hgE
sQt
sQt
puE
puE
nqd
"}
(13,1,1) = {"
mgc
khX
eTK
vIE
iwa
iCV
upI
upI
uWg
upI
oPw
ced
qiB
nqd
"}
(14,1,1) = {"
ciA
ciA
eUw
elg
dUl
uVI
tWi
tUB
upI
upI
uRG
puE
rTS
nqd
"}
(15,1,1) = {"
dRi
hdA
tbG
xif
nqd
rYy
uEP
upI
jok
upI
dMi
puE
gZX
nqd
"}
(16,1,1) = {"
nqd
rAl
pUQ
nqd
nqd
jIb
jIb
bDR
jIb
bDR
jIb
tSy
jIb
jIb
"}
(17,1,1) = {"
hET
jRl
qgy
nqd
dyv
okc
gmR
iZz
iZz
iZz
iZz
aMP
okc
arG
"}
(18,1,1) = {"
jIb
jIb
jIb
jIb
jIb
jIb
yfY
iZz
iZz
iZz
iZz
lIS
jIb
arG
"}
(19,1,1) = {"
jIb
esY
urD
qrI
qkX
jIb
lyO
hvi
hfQ
xyc
iZz
iZz
kwB
arG
"}
(20,1,1) = {"
ozM
hyH
hyH
pym
vfn
qlp
eZi
cgI
eHJ
xyc
iZz
iZz
uKL
arG
"}
(21,1,1) = {"
jIb
jIb
nLt
lbG
koq
jIb
vOY
cLa
rpK
xyc
iZz
ujK
xOJ
arG
"}
(22,1,1) = {"
jug
uwX
mwu
qTU
qTU
jIb
mDQ
sVo
wRt
xyc
iZz
iZz
xOJ
arG
"}
(23,1,1) = {"
jIb
jIb
jIb
muL
pjf
jIb
uay
fvA
hSE
hSE
hSE
ymb
jIb
arG
"}
(24,1,1) = {"
arG
arG
jIb
jIb
jIb
jIb
xac
iZz
iZz
iYK
tMb
cfC
jIb
arG
"}
