// This map has been converted using maphash
"anr" = (/obj/structure/sink/kitchen{pixel_y = 28},/turf/open/floor/wood,/area/crew_quarters/bar)
"aof" = (/turf/open/floor/carpet/red,/area/crew_quarters/bar)
"arG" = (/turf/template_noop,/area/template_noop)
"aKu" = (/obj/machinery/atmospherics/pipe/manifold/scrubbers/hidden/layer3{dir = 4; icon_state = "manifold-3"},/obj/machinery/atmospherics/pipe/simple/supply/hidden/layer1,/turf/open/floor/wood,/area/crew_quarters/bar)
"bAq" = (/obj/machinery/requests_console{department = "Kitchen"; departmentType = 2; pixel_x = 30},/turf/open/floor/plasteel/cafeteria,/area/crew_quarters/kitchen)
"bIG" = (/obj/structure/window{dir = 4; icon_state = "window"},/obj/machinery/camera{c_tag = "Theatre Stage"; dir = 2},/obj/item/radio/intercom{pixel_y = 25},/turf/open/floor/wood,/area/crew_quarters/bar)
"coa" = (/obj/item/reagent_containers/food/drinks/bottle/wine{pixel_x = -4},/obj/item/reagent_containers/food/drinks/bottle/lizardwine,/obj/item/reagent_containers/food/drinks/bottle/wine{pixel_x = 4},/obj/structure/table/wood,/turf/open/floor/wood,/area/crew_quarters/bar)
"cql" = (/obj/item/reagent_containers/food/drinks/drinkingglass,/obj/item/reagent_containers/glass/rag,/obj/structure/table/wood,/turf/open/floor/wood,/area/crew_quarters/bar)
"cqC" = (/obj/structure/table,/obj/machinery/chem_dispenser/drinks/beer{dir = 8},/obj/machinery/firealarm{dir = 8; pixel_x = 26; pixel_y = 0},/obj/item/radio/intercom{pixel_y = 25},/turf/open/floor/wood,/area/crew_quarters/bar)
"cAr" = (/obj/structure/chair/stool/bar,/obj/machinery/atmospherics/pipe/simple/supply/hidden/layer1{dir = 8; icon_state = "pipe11-1"},/turf/open/floor/wood,/area/crew_quarters/bar)
"cTb" = (/obj/structure/table/wood,/obj/item/reagent_containers/food/snacks/store/cheesewheel/feta,/obj/structure/window/reinforced/tinted{dir = 1},/turf/open/floor/wood,/area/crew_quarters/bar)
"cXm" = (/obj/machinery/atmospherics/pipe/simple/scrubbers/hidden/layer3{dir = 4; icon_state = "pipe11-3"},/obj/structure/table/wood,/turf/open/floor/wood,/area/crew_quarters/bar)
"cYq" = (/obj/effect/landmark/start/assistant,/turf/open/floor/carpet/red,/area/crew_quarters/bar)
"dzJ" = (/obj/item/stack/sheet/metal/fifty,/obj/item/stack/sheet/glass/fifty,/obj/item/stack/cable_coil,/obj/item/flashlight/lamp,/obj/item/flashlight/lamp/green,/obj/structure/closet/secure_closet/bartender,/obj/machinery/light/small{dir = 4},/turf/open/floor/wood,/area/crew_quarters/bar)
"dBJ" = (/obj/structure/disposalpipe/segment,/obj/machinery/atmospherics/pipe/simple/supply/hidden/layer1,/obj/machinery/atmospherics/pipe/simple/scrubbers/hidden/layer3,/turf/open/floor/plasteel/cafeteria,/area/crew_quarters/kitchen)
"dFr" = (/obj/structure/disposalpipe/segment{dir = 9},/obj/machinery/atmospherics/pipe/simple/scrubbers/hidden/layer3,/obj/machinery/atmospherics/pipe/simple/supply/hidden/layer1,/turf/open/floor/wood,/area/crew_quarters/bar)
"dIO" = (/obj/structure/table/wood/fancy,/obj/machinery/paystand/register{dir = 1; icon_state = "register"},/turf/open/floor/wood,/area/crew_quarters/bar)
"dTQ" = (/obj/machinery/atmospherics/pipe/simple/scrubbers/hidden/layer3,/obj/machinery/atmospherics/pipe/simple/supply/hidden/layer1,/turf/open/floor/wood,/area/crew_quarters/bar)
"egm" = (/obj/structure/table/wood/fancy,/obj/item/reagent_containers/food/snacks/cheesewedge/american{pixel_x = -2; pixel_y = 4},/obj/item/reagent_containers/food/snacks/cheesewedge/american,/turf/open/floor/wood,/area/crew_quarters/bar)
"ego" = (/turf/open/floor/plasteel/cafeteria,/area/crew_quarters/kitchen)
"eoc" = (/obj/machinery/light{dir = 8},/obj/machinery/computer/security/telescreen/entertainment{pixel_x = -31},/obj/machinery/camera{c_tag = "Bar West"; dir = 4},/turf/open/floor/wood,/area/crew_quarters/bar)
"eBE" = (/obj/structure/sign/barsign,/turf/closed/wall,/area/crew_quarters/bar)
"eMz" = (/turf/open/floor/wood{icon_state = "wood-broken4"},/area/crew_quarters/bar)
"fxS" = (/obj/machinery/door/airlock{name = "Bar Storage"; req_access_txt = "25"},/obj/machinery/door/firedoor/border_only{dir = 1},/obj/machinery/door/firedoor/border_only,/turf/open/floor/wood,/area/crew_quarters/bar)
"fyB" = (/obj/structure/table/wood/fancy,/obj/item/kitchen/fork{dir = 1; icon_state = "fork"; pixel_x = -6},/obj/item/kitchen/fork{dir = 1; icon_state = "fork"; pixel_x = 6},/obj/item/kitchen/fork{dir = 1; icon_state = "fork"; pixel_x = 0},/turf/open/floor/wood,/area/crew_quarters/bar)
"fHE" = (/obj/structure/sink/kitchen{pixel_y = 28},/turf/open/floor/plasteel/cafeteria,/area/crew_quarters/kitchen)
"fQJ" = (/obj/machinery/atmospherics/components/unary/vent_scrubber/on/layer3{dir = 8; icon_state = "scrub_map_on-3"},/turf/open/floor/plasteel/showroomfloor,/area/crew_quarters/kitchen)
"fXa" = (/obj/structure/disposalpipe/segment,/obj/structure/table,/obj/item/reagent_containers/food/snacks/mint,/turf/open/floor/plasteel/cafeteria,/area/crew_quarters/kitchen)
"gdi" = (/obj/machinery/door/airlock/maintenance{name = "Kitchen Maintenance"; req_access_txt = "28"},/obj/structure/disposalpipe/segment,/obj/machinery/atmospherics/pipe/simple/supply/hidden/layer1,/obj/machinery/atmospherics/pipe/simple/scrubbers/hidden/layer3,/turf/open/floor/plating,/area/maintenance/starboard/fore)
"gft" = (/obj/machinery/door/window/eastleft,/obj/machinery/atmospherics/pipe/simple/scrubbers/hidden/layer3{dir = 4; icon_state = "pipe11-3"},/obj/machinery/atmospherics/pipe/simple/supply/hidden/layer1{dir = 8; icon_state = "pipe11-1"},/turf/open/floor/wood,/area/crew_quarters/bar)
"gzq" = (/obj/machinery/atmospherics/pipe/simple/scrubbers/hidden/layer3,/obj/machinery/atmospherics/pipe/manifold/supply/hidden/layer1{dir = 8; icon_state = "manifold-1"},/turf/open/floor/wood,/area/crew_quarters/bar)
"gLH" = (/turf/closed/wall,/area/crew_quarters/theatre)
"gNN" = (/obj/machinery/door/airlock/public/glass{name = "Diner"},/obj/machinery/door/firedoor/border_only{dir = 1},/obj/machinery/door/firedoor/border_only,/turf/open/floor/wood,/area/crew_quarters/bar)
"gPf" = (/obj/machinery/icecream_vat,/obj/machinery/light/small{dir = 8},/turf/open/floor/plasteel/showroomfloor,/area/crew_quarters/kitchen)
"gRs" = (/obj/machinery/atmospherics/pipe/simple/scrubbers/hidden/layer3{dir = 5; icon_state = "pipe11-3"},/obj/machinery/atmospherics/pipe/simple/supply/hidden/layer1{dir = 9; icon_state = "pipe11-1"},/turf/open/floor/wood,/area/crew_quarters/bar)
"hoZ" = (/obj/machinery/door/window/eastright,/turf/open/floor/wood,/area/crew_quarters/bar)
"hsC" = (/obj/item/reagent_containers/food/drinks/drinkingglass,/obj/structure/table/wood,/turf/open/floor/wood,/area/crew_quarters/bar)
"hvz" = (/obj/structure/table/wood,/obj/item/reagent_containers/food/snacks/store/cheesewheel/american,/obj/structure/window/reinforced/tinted{dir = 1},/turf/open/floor/wood,/area/crew_quarters/bar)
"hwJ" = (/obj/machinery/gibber,/turf/open/floor/plasteel/showroomfloor,/area/crew_quarters/kitchen)
"hBM" = (/obj/machinery/camera{c_tag = "Bar Storage"},/obj/machinery/atmospherics/components/unary/vent_pump/on/layer1{dir = 8; icon_state = "vent_map_on-1"},/turf/open/floor/wood,/area/crew_quarters/bar)
"hCV" = (/obj/machinery/food_cart,/turf/open/floor/plasteel/showroomfloor,/area/crew_quarters/kitchen)
"hET" = (/obj/machinery/door/window/southleft{base_state = "left"; dir = 2; icon_state = "left"; name = "Bar Delivery"; req_access_txt = "25"},/obj/effect/turf_decal/delivery,/turf/open/floor/plasteel,/area/crew_quarters/bar)
"hGz" = (/obj/machinery/atmospherics/components/unary/vent_scrubber/on/layer3{dir = 8; icon_state = "scrub_map_on-3"},/turf/open/floor/plasteel/cafeteria,/area/crew_quarters/kitchen)
"hIC" = (/obj/structure/table,/obj/item/reagent_containers/food/condiment/enzyme{layer = 5},/obj/item/reagent_containers/glass/beaker{pixel_x = 5},/turf/open/floor/plasteel/cafeteria,/area/crew_quarters/kitchen)
"hSu" = (/obj/structure/table/wood,/obj/structure/sign/poster/official/fruit_bowl{pixel_x = 32},/obj/item/reagent_containers/food/snacks/grown/grapes{pixel_x = -2; pixel_y = 7},/obj/item/reagent_containers/food/snacks/grown/grapes/green{pixel_x = 4; pixel_y = 3},/turf/open/floor/wood,/area/crew_quarters/bar)
"hUw" = (/obj/machinery/computer/slot_machine,/turf/open/floor/wood,/area/crew_quarters/bar)
"hZU" = (/obj/effect/turf_decal/delivery,/obj/structure/window/reinforced,/obj/machinery/door/window/westleft{name = "Kitchen Delivery"; req_access_txt = "28"},/turf/open/floor/plasteel,/area/crew_quarters/kitchen)
"idp" = (/obj/machinery/atmospherics/pipe/simple/supply/hidden/layer1{dir = 8; icon_state = "pipe11-1"},/obj/machinery/atmospherics/pipe/simple/scrubbers/hidden/layer3{dir = 4; icon_state = "pipe11-3"},/turf/open/floor/plasteel/cafeteria,/area/crew_quarters/kitchen)
"ima" = (/obj/item/book/manual/wiki/barman_recipes,/obj/item/reagent_containers/food/drinks/drinkingglass,/obj/structure/table/wood,/turf/open/floor/wood,/area/crew_quarters/bar)
"isv" = (/obj/effect/spawner/structure/window,/obj/machinery/door/poddoor/preopen{id = "barShutters"; name = "privacy shutters"},/turf/open/floor/plating,/area/crew_quarters/bar)
"ivu" = (/obj/structure/chair/stool/bar,/obj/machinery/atmospherics/pipe/simple/scrubbers/hidden/layer3{dir = 4; icon_state = "pipe11-3"},/turf/open/floor/wood,/area/crew_quarters/bar)
"ivJ" = (/obj/machinery/door/window/southright{name = "Bar Door"; req_one_access_txt = "25;28"},/turf/open/floor/wood,/area/crew_quarters/bar)
"iGZ" = (/obj/structure/table/wood,/obj/item/reagent_containers/food/snacks/store/cheesewheel/mozzarella,/obj/structure/window/reinforced/tinted,/turf/open/floor/wood,/area/crew_quarters/bar)
"iPE" = (/obj/effect/landmark/start/bartender,/obj/machinery/atmospherics/pipe/simple/supply/hidden/layer1{dir = 8; icon_state = "pipe11-1"},/turf/open/floor/wood,/area/crew_quarters/bar)
"jgE" = (/obj/machinery/light/small,/obj/machinery/computer/arcade,/turf/open/floor/wood,/area/crew_quarters/bar)
"jzN" = (/obj/effect/landmark/start/cook,/turf/open/floor/plasteel/cafeteria,/area/crew_quarters/kitchen)
"jBq" = (/obj/machinery/atmospherics/components/unary/vent_pump/on/layer1{dir = 4; icon_state = "vent_map_on-1"},/turf/open/floor/wood,/area/crew_quarters/bar)
"jCc" = (/obj/structure/fermenting_barrel,/turf/open/floor/wood,/area/crew_quarters/bar)
"jIb" = (/turf/closed/wall,/area/crew_quarters/kitchen)
"kwh" = (/obj/machinery/chem_master/condimaster{name = "CondiMaster Neo"},/obj/machinery/light/small{dir = 4},/turf/open/floor/plasteel/showroomfloor,/area/crew_quarters/kitchen)
"kxZ" = (/obj/machinery/door/airlock/maintenance{name = "Bar Maintenance"; req_access_txt = "12"},/obj/structure/disposalpipe/segment,/turf/open/floor/plating,/area/maintenance/starboard/fore)
"kVa" = (/obj/structure/chair/stool/bar,/obj/effect/landmark/start/assistant,/turf/open/floor/wood,/area/crew_quarters/bar)
"kXE" = (/obj/machinery/vending/dinnerware,/turf/open/floor/plasteel/cafeteria,/area/crew_quarters/kitchen)
"lBK" = (/obj/structure/kitchenspike,/turf/open/floor/plasteel/showroomfloor,/area/crew_quarters/kitchen)
"lLz" = (/obj/machinery/atmospherics/pipe/simple/scrubbers/hidden/layer3,/obj/machinery/atmospherics/pipe/simple/supply/hidden/layer1,/turf/open/floor/wood{icon_state = "wood-broken6"},/area/crew_quarters/bar)
"lLG" = (/obj/effect/landmark/event_spawn,/turf/open/floor/wood,/area/crew_quarters/bar)
"mpR" = (/obj/structure/table/wood,/obj/item/reagent_containers/food/snacks/store/cheesewheel/blue,/obj/structure/window/reinforced/tinted,/turf/open/floor/wood,/area/crew_quarters/bar)
"msT" = (/obj/machinery/atmospherics/pipe/simple/supply/hidden/layer1{dir = 8; icon_state = "pipe11-1"},/obj/structure/table/wood,/turf/open/floor/wood,/area/crew_quarters/bar)
"mTA" = (/obj/structure/reagent_dispensers/cooking_oil,/turf/open/floor/plasteel/showroomfloor,/area/crew_quarters/kitchen)
"neo" = (/obj/machinery/button/door{id = "kitchen"; name = "Kitchen Shutters Control"; pixel_x = -1; pixel_y = -24; req_access_txt = "28"},/obj/machinery/disposal/bin,/obj/structure/disposalpipe/trunk{dir = 4},/turf/open/floor/plasteel/cafeteria,/area/crew_quarters/kitchen)
"nqd" = (/turf/closed/wall,/area/crew_quarters/bar)
"nIc" = (/obj/machinery/atmospherics/components/unary/vent_pump/on/layer1{dir = 1; icon_state = "vent_map_on-1"},/turf/open/floor/plasteel/cafeteria,/area/crew_quarters/kitchen)
"nQF" = (/obj/machinery/atmospherics/pipe/simple/scrubbers/hidden/layer3{dir = 4; icon_state = "pipe11-3"},/turf/open/floor/wood,/area/crew_quarters/bar)
"ohC" = (/obj/structure/table/reinforced,/obj/machinery/door/firedoor,/obj/machinery/door/poddoor/shutters/preopen{id = "kitchen"; name = "kitchen shutters"},/obj/item/reagent_containers/food/snacks/baguette,/turf/open/floor/plasteel/cafeteria,/area/crew_quarters/kitchen)
"orC" = (/obj/structure/disposalpipe/segment,/obj/effect/landmark/start/cook,/obj/machinery/atmospherics/pipe/simple/supply/hidden/layer1{dir = 5; icon_state = "pipe11-1"},/obj/machinery/atmospherics/pipe/simple/scrubbers/hidden/layer3{dir = 5; icon_state = "pipe11-3"},/turf/open/floor/plasteel/cafeteria,/area/crew_quarters/kitchen)
"oxt" = (/obj/machinery/vending/wardrobe/chef_wardrobe,/turf/open/floor/plasteel/showroomfloor,/area/crew_quarters/kitchen)
"oOd" = (/obj/structure/table/wood,/obj/machinery/reagentgrinder,/turf/open/floor/wood,/area/crew_quarters/bar)
"oUQ" = (/obj/machinery/door/airlock{name = "Kitchen"; req_access_txt = "28"},/obj/machinery/door/firedoor/border_only{dir = 4},/obj/machinery/door/firedoor/border_only{dir = 8},/turf/open/floor/wood,/area/crew_quarters/kitchen)
"oVF" = (/obj/structure/closet/secure_closet/freezer/fridge,/obj/machinery/camera{c_tag = "Kitchen"; dir = 2},/obj/item/radio/intercom{pixel_y = 25},/turf/open/floor/plasteel/cafeteria,/area/crew_quarters/kitchen)
"oZD" = (/obj/machinery/processor,/turf/open/floor/plasteel/cafeteria,/area/crew_quarters/kitchen)
"pcm" = (/obj/structure/extinguisher_cabinet{pixel_y = -30},/obj/machinery/computer/arcade,/turf/open/floor/wood,/area/crew_quarters/bar)
"peA" = (/obj/machinery/vending/wardrobe/bar_wardrobe,/turf/open/floor/wood,/area/crew_quarters/bar)
"pfG" = (/obj/machinery/deepfryer,/obj/machinery/light{dir = 1; light_color = "#706891"},/turf/open/floor/plasteel/cafeteria,/area/crew_quarters/kitchen)
"pPw" = (/obj/machinery/light{dir = 1},/obj/machinery/light_switch{pixel_y = 28},/obj/effect/landmark/event_spawn,/turf/open/floor/wood,/area/crew_quarters/bar)
"pPz" = (/obj/machinery/door/window/eastleft,/obj/machinery/atmospherics/pipe/simple/supply/hidden/layer1{dir = 8; icon_state = "pipe11-1"},/turf/open/floor/wood,/area/crew_quarters/bar)
"pRy" = (/obj/machinery/airalarm{pixel_y = 24},/obj/machinery/vending/cigarette,/turf/open/floor/wood,/area/crew_quarters/bar)
"pSo" = (/obj/structure/table,/obj/machinery/reagentgrinder,/obj/machinery/firealarm{dir = 8; pixel_x = 26; pixel_y = 0},/turf/open/floor/plasteel/cafeteria,/area/crew_quarters/kitchen)
"qAG" = (/obj/machinery/door/airlock{name = "Theatre Backstage"; req_access_txt = "46"},/obj/machinery/atmospherics/pipe/simple/supply/hidden/layer1,/obj/machinery/atmospherics/pipe/simple/scrubbers/hidden/layer3,/obj/machinery/door/firedoor/border_only,/obj/machinery/door/firedoor/border_only{dir = 1},/turf/open/floor/plasteel,/area/crew_quarters/theatre)
"qCw" = (/obj/machinery/atmospherics/pipe/simple/scrubbers/hidden/layer3,/obj/machinery/atmospherics/pipe/simple/supply/hidden/layer1{dir = 5; icon_state = "pipe11-1"},/turf/open/floor/wood,/area/crew_quarters/bar)
"qEk" = (/obj/machinery/light,/obj/machinery/newscaster{pixel_y = -28},/turf/open/floor/wood,/area/crew_quarters/bar)
"qSv" = (/obj/machinery/status_display/evac{pixel_x = 32},/obj/structure/chair/stool/bar,/obj/machinery/light{dir = 1; light_color = "#c1caff"},/turf/open/floor/wood,/area/crew_quarters/bar)
"qSU" = (/obj/machinery/atmospherics/pipe/simple/supply/hidden/layer1{dir = 10; icon_state = "pipe11-1"},/obj/machinery/atmospherics/pipe/simple/scrubbers/hidden/layer3{dir = 10; icon_state = "pipe11-3"},/turf/open/floor/plasteel/cafeteria,/area/crew_quarters/kitchen)
"qTE" = (/obj/machinery/atmospherics/pipe/simple/scrubbers/hidden/layer3,/obj/machinery/atmospherics/pipe/manifold/supply/hidden/layer1{dir = 8; icon_state = "manifold-1"},/obj/structure/disposalpipe/segment,/turf/open/floor/plasteel/showroomfloor,/area/crew_quarters/kitchen)
"rRq" = (/obj/structure/chair/stool,/turf/open/floor/wood,/area/crew_quarters/bar)
"rUn" = (/obj/structure/table/wood/fancy,/obj/item/reagent_containers/food/snacks/cracker,/turf/open/floor/wood,/area/crew_quarters/bar)
"sar" = (/obj/machinery/firealarm{dir = 2; pixel_y = 26},/obj/structure/disposalpipe/trunk{dir = 8},/obj/machinery/disposal/bin,/turf/open/floor/wood,/area/crew_quarters/bar)
"snY" = (/obj/machinery/atmospherics/pipe/simple/supply/hidden/layer1{dir = 8; icon_state = "pipe11-1"},/turf/open/floor/wood,/area/crew_quarters/bar)
"sBh" = (/obj/structure/disposalpipe/segment{dir = 9},/turf/open/floor/plasteel/cafeteria,/area/crew_quarters/kitchen)
"sOQ" = (/obj/structure/table/wood,/turf/open/floor/wood,/area/crew_quarters/bar)
"sYn" = (/obj/structure/chair/stool/bar,/turf/open/floor/wood,/area/crew_quarters/bar)
"tes" = (/obj/structure/disposalpipe/segment{dir = 4},/turf/open/floor/plasteel/cafeteria,/area/crew_quarters/kitchen)
"thO" = (/turf/open/floor/wood{icon_state = "wood-broken5"},/area/crew_quarters/bar)
"top" = (/mob/living/carbon/monkey/punpun,/turf/open/floor/wood,/area/crew_quarters/bar)
"trH" = (/obj/machinery/atmospherics/pipe/simple/supply/hidden/layer1,/obj/machinery/atmospherics/pipe/manifold/scrubbers/hidden/layer3{dir = 8; icon_state = "manifold-3"},/obj/structure/disposalpipe/segment,/turf/open/floor/plasteel/showroomfloor,/area/crew_quarters/kitchen)
"tyG" = (/obj/machinery/atmospherics/pipe/simple/scrubbers/hidden/layer3{dir = 4; icon_state = "pipe11-3"},/turf/open/floor/carpet/red,/area/crew_quarters/bar)
"tBu" = (/turf/open/floor/plasteel/showroomfloor,/area/crew_quarters/kitchen)
"tOa" = (/obj/machinery/atmospherics/components/unary/vent_scrubber/on/layer3{dir = 4; icon_state = "scrub_map_on-3"},/turf/open/floor/carpet/red,/area/crew_quarters/bar)
"ueg" = (/obj/effect/turf_decal/loading_area{dir = 8},/obj/machinery/camera{c_tag = "Kitchen Cold Room"},/turf/open/floor/plasteel/showroomfloor,/area/crew_quarters/kitchen)
"uoW" = (/obj/machinery/computer/security/telescreen/entertainment{pixel_x = 32},/turf/open/floor/wood,/area/crew_quarters/bar)
"upI" = (/turf/open/floor/wood,/area/crew_quarters/bar)
"uzM" = (/obj/machinery/atmospherics/pipe/simple/scrubbers/hidden/layer3{dir = 10; icon_state = "pipe11-3"},/obj/machinery/atmospherics/pipe/simple/supply/hidden/layer1{dir = 10; icon_state = "pipe11-1"},/turf/open/floor/wood,/area/crew_quarters/bar)
"uAv" = (/obj/machinery/door/airlock{name = "Kitchen cold room"; req_access_txt = "28"},/obj/machinery/atmospherics/pipe/simple/scrubbers/hidden/layer3,/obj/machinery/atmospherics/pipe/simple/supply/hidden/layer1,/obj/structure/disposalpipe/segment,/obj/machinery/door/firedoor/border_only,/obj/machinery/door/firedoor/border_only{dir = 1},/turf/open/floor/plasteel/showroomfloor,/area/crew_quarters/kitchen)
"uBq" = (/obj/machinery/navbeacon{codes_txt = "delivery;dir=2"; freq = 1400; location = "Kitchen"},/obj/structure/plasticflaps{opacity = 1},/obj/effect/turf_decal/bot{dir = 2},/turf/open/floor/plasteel{dir = 2},/area/crew_quarters/kitchen)
"uHF" = (/obj/machinery/camera{c_tag = "Bar South"; dir = 1},/obj/machinery/firealarm{dir = 1; pixel_y = -26},/turf/open/floor/wood,/area/crew_quarters/bar)
"uHS" = (/obj/structure/table,/obj/machinery/microwave{pixel_x = -3; pixel_y = 6},/obj/item/storage/box/donkpockets{pixel_x = 3; pixel_y = 3},/obj/machinery/light,/turf/open/floor/plasteel/cafeteria,/area/crew_quarters/kitchen)
"uKE" = (/obj/structure/disposalpipe/segment{dir = 5},/turf/open/floor/wood,/area/crew_quarters/bar)
"uRw" = (/obj/structure/table,/obj/machinery/chem_dispenser/drinks{dir = 8},/turf/open/floor/wood,/area/crew_quarters/bar)
"uTX" = (/obj/machinery/atmospherics/pipe/simple/scrubbers/hidden/layer3,/obj/machinery/atmospherics/pipe/simple/supply/hidden/layer1,/obj/structure/disposalpipe/segment,/turf/open/floor/plasteel/showroomfloor,/area/crew_quarters/kitchen)
"uUz" = (/obj/structure/table/reinforced,/obj/machinery/door/firedoor,/obj/machinery/door/poddoor/shutters/preopen{id = "kitchen"; name = "kitchen shutters"},/turf/open/floor/plasteel/cafeteria,/area/crew_quarters/kitchen)
"uZe" = (/obj/structure/closet/secure_closet/freezer/kitchen,/obj/machinery/light{dir = 1},/obj/machinery/airalarm{pixel_y = 24},/turf/open/floor/plasteel/cafeteria,/area/crew_quarters/kitchen)
"vlz" = (/obj/structure/disposalpipe/segment,/obj/structure/table,/turf/open/floor/plasteel/cafeteria,/area/crew_quarters/kitchen)
"vmD" = (/obj/machinery/atmospherics/pipe/simple/supply/hidden/layer1,/obj/machinery/atmospherics/pipe/simple/scrubbers/hidden/layer3{dir = 5; icon_state = "pipe11-3"},/turf/open/floor/plasteel/cafeteria,/area/crew_quarters/kitchen)
"vqs" = (/obj/machinery/vending/boozeomat,/obj/machinery/light{dir = 4},/turf/open/floor/wood,/area/crew_quarters/bar)
"vsG" = (/obj/structure/table/wood/fancy,/obj/item/reagent_containers/food/snacks/cheesewedge/blue,/obj/item/reagent_containers/food/snacks/cheesewedge/blue{pixel_x = -2; pixel_y = 4},/turf/open/floor/wood,/area/crew_quarters/bar)
"vMf" = (/obj/structure/table,/obj/machinery/microwave{pixel_x = -3; pixel_y = 6},/turf/open/floor/plasteel/cafeteria,/area/crew_quarters/kitchen)
"vMk" = (/obj/machinery/atmospherics/components/unary/vent_scrubber/on/layer3{dir = 8; icon_state = "scrub_map_on-3"},/turf/open/floor/wood,/area/crew_quarters/bar)
"vRw" = (/obj/machinery/light/small{dir = 8},/obj/machinery/airalarm{dir = 4; pixel_x = -22},/obj/machinery/atmospherics/components/unary/vent_scrubber/on/layer3{dir = 1; icon_state = "scrub_map_on-3"},/turf/open/floor/wood,/area/crew_quarters/bar)
"vTa" = (/obj/structure/table/wood/fancy,/obj/item/reagent_containers/food/snacks/cheesewedge/feta,/obj/item/reagent_containers/food/snacks/cheesewedge/feta{pixel_x = -2; pixel_y = 4},/turf/open/floor/wood,/area/crew_quarters/bar)
"vYM" = (/obj/machinery/atmospherics/pipe/simple/supply/hidden/layer1,/obj/effect/landmark/event_spawn,/turf/open/floor/plasteel/cafeteria,/area/crew_quarters/kitchen)
"vZg" = (/obj/machinery/button/door{id = "barShutters"; name = "bar shutters"; pixel_x = 4; pixel_y = 28},/turf/open/floor/wood,/area/crew_quarters/bar)
"weB" = (/obj/structure/closet/secure_closet/freezer/meat{name = "cured meat fridge"},/turf/open/floor/plasteel/cafeteria,/area/crew_quarters/kitchen)
"wzf" = (/obj/machinery/atmospherics/pipe/simple/supply/hidden/layer1{dir = 5; icon_state = "pipe11-1"},/obj/machinery/atmospherics/pipe/simple/scrubbers/hidden/layer3{dir = 5; icon_state = "pipe11-3"},/turf/open/floor/wood,/area/crew_quarters/bar)
"wOD" = (/obj/structure/table/wood/fancy,/obj/item/kitchen/fork,/obj/item/kitchen/fork{pixel_x = -6},/obj/item/kitchen/fork{pixel_x = 6},/turf/open/floor/wood,/area/crew_quarters/bar)
"xiR" = (/obj/machinery/disposal/bin,/obj/structure/disposalpipe/trunk{dir = 4},/turf/open/floor/wood,/area/crew_quarters/bar)
"xoV" = (/obj/structure/table,/obj/item/book/manual/chef_recipes,/obj/item/book/manual/wiki/cooking_to_serve_man{pixel_x = -4; pixel_y = 4},/turf/open/floor/plasteel/cafeteria,/area/crew_quarters/kitchen)
"xpf" = (/obj/machinery/atmospherics/components/unary/vent_pump/on/layer1{dir = 8; icon_state = "vent_map_on-1"},/turf/open/floor/wood,/area/crew_quarters/bar)
"xxu" = (/obj/structure/sign/warning/securearea{desc = "Under the painting a plaque reads: 'While the meat grinder may not have spared you, fear not. Not one part of you has gone to waste... You were delicious.'"; icon_state = "monkey_painting"; name = "Mr. Deempisi portrait"; pixel_x = 4; pixel_y = 28},/turf/open/floor/wood,/area/crew_quarters/bar)
"xyI" = (/obj/machinery/atmospherics/pipe/simple/scrubbers/hidden/layer3{dir = 4; icon_state = "pipe11-3"},/obj/machinery/atmospherics/pipe/simple/supply/hidden/layer1{dir = 8; icon_state = "pipe11-1"},/turf/open/floor/wood,/area/crew_quarters/bar)
"ycz" = (/obj/structure/table/wood/fancy,/obj/item/reagent_containers/food/snacks/cheesewedge/mozzarella,/obj/item/reagent_containers/food/snacks/cheesewedge/mozzarella{pixel_x = -2; pixel_y = 4},/turf/open/floor/wood,/area/crew_quarters/bar)
"yhl" = (/obj/item/twohanded/required/kirbyplants/random,/turf/open/floor/wood,/area/crew_quarters/bar)
"ylc" = (/obj/machinery/atmospherics/components/unary/vent_pump/on/layer1{dir = 8; icon_state = "vent_map_on-1"},/obj/effect/spawner/lootdrop/mob/kitchen_animal,/turf/open/floor/plasteel/showroomfloor,/area/crew_quarters/kitchen)
"ymm" = (/obj/structure/disposalpipe/segment,/turf/open/floor/plasteel/cafeteria,/area/crew_quarters/kitchen)

(1,1,1) = {"
arG
arG
nqd
nqd
isv
isv
nqd
nqd
nqd
isv
isv
nqd
nqd
nqd
"}
(2,1,1) = {"
arG
arG
upI
iGZ
aof
aof
hvz
eoc
mpR
aof
aof
cTb
upI
nqd
"}
(3,1,1) = {"
arG
arG
upI
dIO
aof
aof
dIO
jBq
dIO
aof
cYq
dIO
upI
nqd
"}
(4,1,1) = {"
gLH
pPw
upI
ycz
aof
aof
egm
snY
vsG
aof
aof
vTa
upI
isv
"}
(5,1,1) = {"
qAG
dTQ
wzf
ycz
aof
aof
egm
snY
vsG
aof
aof
vTa
upI
isv
"}
(6,1,1) = {"
gLH
upI
xyI
rUn
cYq
tOa
rUn
snY
rUn
aof
aof
rUn
upI
nqd
"}
(7,1,1) = {"
gLH
bIG
gft
wOD
aof
tyG
fyB
pPz
wOD
aof
aof
fyB
hoZ
nqd
"}
(8,1,1) = {"
nqd
pRy
xyI
upI
upI
nQF
upI
snY
upI
upI
upI
thO
qEk
nqd
"}
(9,1,1) = {"
nqd
upI
uzM
lLz
dTQ
aKu
gzq
gRs
upI
upI
upI
upI
upI
eBE
"}
(10,1,1) = {"
kxZ
uKE
upI
lLG
sYn
kVa
cAr
ivu
sYn
upI
upI
upI
upI
nqd
"}
(11,1,1) = {"
nqd
sar
hUw
sYn
sOQ
hsC
msT
cXm
sOQ
sYn
upI
upI
uHF
nqd
"}
(12,1,1) = {"
nqd
nqd
nqd
qSv
sOQ
upI
snY
nQF
sOQ
sYn
upI
lLG
upI
gNN
"}
(13,1,1) = {"
xiR
peA
nqd
nqd
nqd
xxu
iPE
vMk
ima
sYn
upI
upI
upI
gNN
"}
(14,1,1) = {"
dFr
qCw
vRw
jCc
nqd
vZg
snY
upI
cql
sYn
upI
upI
pcm
nqd
"}
(15,1,1) = {"
anr
snY
upI
upI
fxS
upI
xpf
top
ivJ
upI
upI
upI
jgE
nqd
"}
(16,1,1) = {"
nqd
hBM
rRq
rRq
nqd
upI
upI
eMz
coa
uoW
upI
yhl
nqd
nqd
"}
(17,1,1) = {"
hET
dzJ
hSu
oOd
nqd
cqC
vqs
uRw
jIb
jIb
oUQ
jIb
jIb
arG
"}
(18,1,1) = {"
jIb
jIb
jIb
jIb
jIb
jIb
jIb
jIb
jIb
pfG
ego
neo
jIb
arG
"}
(19,1,1) = {"
jIb
hCV
gPf
oxt
lBK
jIb
kXE
ego
xoV
hIC
ego
tes
ohC
arG
"}
(20,1,1) = {"
gdi
uTX
trH
qTE
uTX
uAv
dBJ
orC
fXa
vlz
ymm
sBh
uUz
arG
"}
(21,1,1) = {"
jIb
ueg
fQJ
ylc
tBu
jIb
fHE
idp
ego
ego
jzN
ego
uUz
arG
"}
(22,1,1) = {"
uBq
hZU
hwJ
tBu
tBu
jIb
oVF
qSU
vmD
vYM
nIc
ego
uUz
arG
"}
(23,1,1) = {"
jIb
jIb
jIb
kwh
mTA
jIb
uZe
ego
hGz
oZD
ego
uHS
jIb
arG
"}
(24,1,1) = {"
arG
arG
jIb
jIb
jIb
jIb
weB
ego
ego
pSo
bAq
vMf
jIb
arG
"}
