//MAP CONVERTED BY dmm2tgm.py THIS HEADER COMMENT PREVENTS RECONVERSION, DO NOT REMOVE
"aa" = (
/turf/template_noop,
/area/template_noop)
"ab" = (
/obj/machinery/door/airlock{
	name = "Theatre Backstage";
	req_access_txt = "46"
	},
/obj/machinery/atmospherics/pipe/simple/supply/hidden/layer1,
/obj/machinery/atmospherics/pipe/simple/scrubbers/hidden/layer3,
/turf/open/floor/alien,
/area/crew_quarters/theatre)
"ac" = (
/turf/closed/wall/mineral/xeno,
/area/crew_quarters/theatre)
"ad" = (
/obj/machinery/door/airlock/maintenance{
	name = "Bar Maintenance";
	req_access_txt = "12"
	},
/obj/structure/disposalpipe/segment,
/obj/machinery/atmospherics/pipe/simple/supply/hidden/layer1,
/obj/machinery/atmospherics/pipe/simple/scrubbers/hidden/layer3,
/turf/open/floor/plating,
/area/crew_quarters/bar)
"ae" = (
/obj/structure/disposalpipe/segment,
/obj/machinery/atmospherics/pipe/simple/scrubbers/hidden/layer3,
/obj/machinery/atmospherics/pipe/simple/supply/hidden/layer1,
/turf/open/floor/wood,
/area/crew_quarters/bar)
"af" = (
/obj/structure/sink/kitchen{
	pixel_y = 28
	},
/turf/open/floor/wood,
/area/crew_quarters/bar)
"ag" = (
/turf/closed/wall,
/area/crew_quarters/bar)
"ah" = (
/obj/item/reagent_containers/food/drinks/shaker,
/obj/item/gun/ballistic/revolver/doublebarrel,
/obj/structure/table/wood,
/obj/item/stack/spacecash/c10,
/obj/item/stack/spacecash/c100,
/turf/open/floor/wood,
/area/crew_quarters/bar)
"ai" = (
/obj/machinery/door/airlock/maintenance{
	name = "Kitchen Maintenance";
	req_access_txt = "28"
	},
/obj/structure/disposalpipe/segment,
/obj/machinery/atmospherics/pipe/simple/supply/hidden/layer1,
/obj/machinery/atmospherics/pipe/simple/scrubbers/hidden/layer3,
/turf/open/floor/plating,
/area/crew_quarters/kitchen)
"ak" = (
/obj/machinery/door/window/southleft{
	base_state = "left";
	dir = 2;
	icon_state = "left";
	name = "Bar Delivery";
	req_access_txt = "25"
	},
/obj/effect/turf_decal/delivery,
/turf/open/floor/plasteel,
/area/crew_quarters/bar)
"al" = (
/turf/closed/wall,
/area/crew_quarters/kitchen)
"am" = (
/turf/closed/wall/mineral/xeno,
/area/crew_quarters/bar)
"an" = (
/obj/structure/disposalpipe/segment,
/obj/machinery/atmospherics/pipe/simple/supply/hidden/layer1,
/obj/machinery/atmospherics/pipe/simple/scrubbers/hidden/layer3,
/turf/open/floor/plasteel/showroomfloor,
/area/crew_quarters/kitchen)
"ao" = (
/obj/machinery/navbeacon{
	codes_txt = "delivery;dir=2";
	freq = 1400;
	location = "Kitchen"
	},
/obj/structure/plasticflaps{
	opacity = 1
	},
/obj/effect/turf_decal/bot{
	dir = 2
	},
/turf/open/floor/plasteel{
	dir = 2
	},
/area/crew_quarters/kitchen)
"ap" = (
/obj/machinery/camera{
	c_tag = "Kitchen Cold Room"
	},
/obj/structure/reagent_dispensers/cooking_oil,
/turf/open/floor/plasteel/showroomfloor,
/area/crew_quarters/kitchen)
"aq" = (
/obj/machinery/light_switch{
	pixel_y = 28
	},
/obj/machinery/light{
	dir = 1
	},
/turf/open/floor/alien,
/area/crew_quarters/theatre)
"ar" = (
/obj/machinery/atmospherics/pipe/simple/supply/hidden/layer1,
/obj/machinery/atmospherics/pipe/simple/scrubbers/hidden/layer3,
/turf/open/floor/alien,
/area/crew_quarters/theatre)
"as" = (
/obj/machinery/airalarm{
	dir = 2;
	pixel_y = 24
	},
/obj/effect/decal/cleanable/xenoblood/xgibs/body,
/turf/open/floor/alien,
/area/crew_quarters/theatre)
"at" = (
/obj/item/radio/intercom{
	pixel_y = 25
	},
/obj/machinery/camera{
	c_tag = "Theatre Stage";
	dir = 2
	},
/turf/open/floor/alien,
/area/crew_quarters/theatre)
"au" = (
/obj/effect/decal/remains/human,
/turf/open/floor/alien,
/area/crew_quarters/theatre)
"av" = (
/obj/structure/alien/egg/burst,
/turf/open/floor/alien,
/area/crew_quarters/bar)
"aw" = (
/obj/structure/disposalpipe/segment{
	dir = 5
	},
/obj/machinery/atmospherics/pipe/simple/supply/hidden/layer1,
/obj/machinery/atmospherics/pipe/simple/scrubbers/hidden/layer3,
/turf/open/floor/alien,
/area/crew_quarters/bar)
"ax" = (
/obj/machinery/disposal/bin,
/obj/structure/disposalpipe/trunk{
	dir = 8
	},
/obj/machinery/firealarm{
	dir = 2;
	pixel_y = 24
	},
/turf/open/floor/alien,
/area/crew_quarters/bar)
"ay" = (
/obj/machinery/reagentgrinder,
/obj/structure/table/wood,
/turf/open/floor/wood,
/area/crew_quarters/bar)
"az" = (
/obj/structure/piano{
	icon_state = "piano"
	},
/turf/open/floor/alien,
/area/crew_quarters/theatre)
"aA" = (
/obj/machinery/camera{
	c_tag = "Bar Storage"
	},
/turf/open/floor/wood,
/area/crew_quarters/bar)
"aB" = (
/turf/open/floor/wood,
/area/crew_quarters/bar)
"aC" = (
/obj/structure/closet/secure_closet/freezer/meat,
/turf/open/floor/plasteel/showroomfloor,
/area/crew_quarters/kitchen)
"aD" = (
/obj/structure/chair/stool{
	pixel_y = 8
	},
/turf/open/floor/alien,
/area/crew_quarters/theatre)
"aE" = (
/obj/machinery/airalarm{
	dir = 4;
	pixel_x = -22
	},
/obj/machinery/light/small{
	dir = 8
	},
/obj/structure/reagent_dispensers/beerkeg,
/obj/machinery/atmospherics/components/unary/vent_scrubber/on/layer3{
	icon_state = "scrub_map_on-3";
	dir = 4
	},
/turf/open/floor/wood,
/area/crew_quarters/bar)
"aF" = (
/obj/machinery/door/window/southleft{
	base_state = "left";
	dir = 2;
	icon_state = "left";
	name = "Kitchen Delivery";
	req_access_txt = "28"
	},
/obj/effect/turf_decal/delivery,
/obj/structure/window/reinforced{
	dir = 8
	},
/turf/open/floor/plasteel,
/area/crew_quarters/kitchen)
"aG" = (
/obj/structure/disposalpipe/segment,
/obj/effect/landmark/xeno_spawn,
/obj/machinery/atmospherics/pipe/simple/scrubbers/hidden/layer3{
	icon_state = "pipe11-3";
	dir = 9
	},
/obj/machinery/atmospherics/pipe/simple/supply/hidden/layer1{
	icon_state = "pipe11-1";
	dir = 5
	},
/turf/open/floor/wood,
/area/crew_quarters/bar)
"aH" = (
/obj/machinery/atmospherics/components/unary/vent_scrubber/on/layer3{
	icon_state = "scrub_map_on-3";
	dir = 4
	},
/turf/open/floor/alien,
/area/crew_quarters/theatre)
"aI" = (
/obj/machinery/atmospherics/pipe/simple/supply/hidden/layer1{
	icon_state = "pipe11-1";
	dir = 5
	},
/obj/machinery/atmospherics/pipe/simple/scrubbers/hidden/layer3{
	icon_state = "pipe11-3";
	dir = 9
	},
/turf/open/floor/alien,
/area/crew_quarters/theatre)
"aJ" = (
/obj/machinery/atmospherics/components/unary/vent_pump/on/layer1{
	icon_state = "vent_map_on-1";
	dir = 8
	},
/turf/open/floor/wood,
/area/crew_quarters/bar)
"aK" = (
/obj/machinery/vending/wardrobe/bar_wardrobe,
/turf/open/floor/wood,
/area/crew_quarters/bar)
"aL" = (
/obj/machinery/chem_master/condimaster{
	name = "CondiMaster Neo"
	},
/turf/open/floor/plasteel/showroomfloor,
/area/crew_quarters/kitchen)
"aM" = (
/obj/machinery/atmospherics/components/unary/vent_pump/on/layer1{
	icon_state = "vent_map_on-1";
	dir = 8
	},
/turf/open/floor/alien,
/area/crew_quarters/theatre)
"aN" = (
/turf/open/floor/alien,
/area/crew_quarters/theatre)
"aO" = (
/obj/structure/alien/weeds/node,
/obj/item/clothing/mask/facehugger/toy,
/turf/open/floor/aliennode,
/area/crew_quarters/bar)
"aP" = (
/obj/structure/chair/stool,
/obj/machinery/atmospherics/pipe/simple/supply/hidden/layer1,
/obj/machinery/atmospherics/pipe/simple/scrubbers/hidden/layer3,
/obj/structure/bed/nest,
/turf/open/floor/alien,
/area/crew_quarters/bar)
"aQ" = (
/obj/machinery/computer/slot_machine,
/turf/open/floor/alien,
/area/crew_quarters/bar)
"aR" = (
/obj/machinery/vending/coffee,
/turf/open/floor/wood,
/area/crew_quarters/bar)
"aS" = (
/obj/machinery/icecream_vat,
/turf/open/floor/plasteel/showroomfloor,
/area/crew_quarters/kitchen)
"aT" = (
/obj/structure/disposalpipe/segment,
/turf/open/floor/wood,
/area/crew_quarters/bar)
"aU" = (
/obj/effect/turf_decal/loading_area,
/turf/open/floor/plasteel/showroomfloor,
/area/crew_quarters/kitchen)
"aV" = (
/obj/structure/table/wood,
/obj/item/instrument/guitar{
	pixel_x = -7
	},
/obj/item/instrument/eguitar{
	pixel_x = 5
	},
/turf/open/floor/alien,
/area/crew_quarters/theatre)
"aW" = (
/obj/structure/disposalpipe/segment,
/obj/machinery/atmospherics/pipe/simple/supply/hidden/layer1,
/obj/machinery/atmospherics/pipe/manifold/scrubbers/hidden/layer3{
	icon_state = "manifold-3";
	dir = 8
	},
/turf/open/floor/plasteel/showroomfloor,
/area/crew_quarters/kitchen)
"aX" = (
/obj/machinery/atmospherics/components/unary/vent_scrubber/on/layer3{
	icon_state = "scrub_map_on-3";
	dir = 8
	},
/mob/living/simple_animal/hostile/retaliate/goat{
	name = "Pete"
	},
/turf/open/floor/plasteel/showroomfloor,
/area/crew_quarters/kitchen)
"aY" = (
/obj/machinery/light/small{
	dir = 4
	},
/obj/machinery/airalarm{
	dir = 8;
	pixel_x = 24
	},
/obj/machinery/vending/wardrobe/chef_wardrobe,
/turf/open/floor/plasteel/showroomfloor,
/area/crew_quarters/kitchen)
"aZ" = (
/obj/structure/disposalpipe/segment,
/obj/machinery/atmospherics/pipe/simple/scrubbers/hidden/layer3,
/obj/machinery/atmospherics/pipe/manifold/supply/hidden/layer1{
	icon_state = "manifold-1";
	dir = 8
	},
/turf/open/floor/plasteel/showroomfloor,
/area/crew_quarters/kitchen)
"ba" = (
/obj/machinery/atmospherics/components/unary/vent_pump/on/layer1{
	icon_state = "vent_map_on-1";
	dir = 8
	},
/turf/open/floor/plasteel/showroomfloor,
/area/crew_quarters/kitchen)
"bb" = (
/obj/effect/spawner/xeno_egg_delivery,
/mob/living/simple_animal/bot/honkbot,
/turf/open/floor/alien,
/area/crew_quarters/theatre)
"bc" = (
/obj/machinery/door/airlock{
	name = "Kitchen cold room";
	req_access_txt = "28"
	},
/obj/structure/disposalpipe/segment,
/obj/machinery/atmospherics/pipe/simple/supply/hidden/layer1,
/obj/machinery/atmospherics/pipe/simple/scrubbers/hidden/layer3,
/turf/open/floor/alien,
/area/crew_quarters/kitchen)
"bd" = (
/obj/structure/closet/secure_closet/bar{
	req_access_txt = "25"
	},
/turf/open/floor/wood,
/area/crew_quarters/bar)
"be" = (
/obj/effect/landmark/event_spawn,
/turf/open/floor/alien,
/area/crew_quarters/theatre)
"bf" = (
/obj/structure/closet/gmcloset,
/obj/item/stack/sheet/metal/fifty,
/obj/item/stack/sheet/glass/fifty,
/obj/item/stack/cable_coil,
/obj/item/flashlight/lamp,
/obj/item/flashlight/lamp/green,
/turf/open/floor/wood,
/area/crew_quarters/bar)
"bg" = (
/obj/structure/kitchenspike,
/obj/machinery/light/small{
	dir = 8
	},
/turf/open/floor/plasteel/showroomfloor,
/area/crew_quarters/kitchen)
"bh" = (
/turf/open/floor/alien,
/area/crew_quarters/bar)
"bi" = (
/obj/machinery/computer/slot_machine,
/obj/machinery/light/small{
	dir = 4
	},
/obj/machinery/status_display/evac{
	pixel_x = 32
	},
/turf/open/floor/alien,
/area/crew_quarters/bar)
"bj" = (
/obj/structure/table/wood,
/obj/item/instrument/violin,
/obj/item/instrument/piano_synth,
/turf/open/floor/alien,
/area/crew_quarters/theatre)
"bk" = (
/obj/structure/bed/nest,
/turf/open/floor/alien,
/area/crew_quarters/theatre)
"bl" = (
/obj/effect/decal/cleanable/blood/splatter,
/turf/open/floor/alien,
/area/crew_quarters/theatre)
"bm" = (
/obj/structure/table,
/obj/machinery/computer/security/telescreen/entertainment{
	pixel_x = -31
	},
/obj/item/clothing/head/hardhat/cakehat,
/turf/open/floor/alien,
/area/crew_quarters/bar)
"bn" = (
/obj/structure/alien/weeds/node,
/turf/open/floor/aliennode,
/area/crew_quarters/bar)
"bo" = (
/obj/machinery/door/airlock{
	name = "Bar Storage";
	req_access_txt = "25"
	},
/obj/structure/disposalpipe/segment,
/turf/open/floor/alien,
/area/crew_quarters/bar)
"bp" = (
/obj/effect/landmark/blobstart,
/obj/item/toy/beach_ball/holoball,
/turf/open/floor/plating,
/area/crew_quarters/bar)
"bq" = (
/obj/structure/kitchenspike,
/turf/open/floor/plasteel/showroomfloor,
/area/crew_quarters/kitchen)
"br" = (
/obj/item/clothing/mask/facehugger/toy,
/turf/open/floor/alien,
/area/crew_quarters/bar)
"bs" = (
/obj/machinery/atmospherics/pipe/simple/supply/hidden/layer1,
/obj/machinery/atmospherics/pipe/simple/scrubbers/hidden/layer3,
/turf/open/floor/alien,
/area/crew_quarters/bar)
"bt" = (
/turf/open/floor/plasteel/showroomfloor,
/area/crew_quarters/kitchen)
"bu" = (
/obj/machinery/gibber,
/turf/open/floor/plasteel/showroomfloor,
/area/crew_quarters/kitchen)
"bv" = (
/obj/effect/spawner/structure/window,
/turf/open/floor/alien,
/area/crew_quarters/bar)
"bw" = (
/obj/machinery/disposal/bin,
/obj/structure/sign/warning/securearea{
	desc = "Under the painting a plaque reads: 'While the meat grinder may not have spared you, fear not. Not one part of you has gone to waste... You were delicious.'";
	icon_state = "monkey_painting";
	name = "Mr. Deempisi portrait";
	pixel_x = -28;
	pixel_y = -4
	},
/obj/structure/disposalpipe/trunk{
	dir = 4
	},
/obj/machinery/button/door{
	id = "barShutters";
	name = "bar shutters";
	pixel_x = 4;
	pixel_y = 28
	},
/turf/open/floor/alien,
/area/crew_quarters/bar)
"bx" = (
/obj/structure/disposalpipe/segment{
	dir = 9
	},
/turf/open/floor/alien,
/area/crew_quarters/bar)
"by" = (
/obj/machinery/firealarm{
	dir = 4;
	pixel_x = 24
	},
/obj/structure/table,
/obj/machinery/chem_dispenser/drinks/beer{
	dir = 8
	},
/obj/item/radio/intercom{
	pixel_y = 25
	},
/turf/open/floor/alien,
/area/crew_quarters/bar)
"bz" = (
/turf/closed/wall/mineral/xeno,
/area/crew_quarters/kitchen)
"bA" = (
/obj/effect/landmark/event_spawn,
/turf/closed/wall/mineral/xeno,
/area/crew_quarters/bar)
"bB" = (
/obj/machinery/light{
	dir = 8
	},
/turf/open/floor/alien,
/area/crew_quarters/bar)
"bC" = (
/obj/effect/landmark/start/assistant,
/obj/structure/bed/nest,
/turf/open/floor/alien,
/area/crew_quarters/bar)
"bD" = (
/obj/structure/chair/stool,
/obj/structure/bed/nest,
/turf/open/floor/alien,
/area/crew_quarters/bar)
"bE" = (
/obj/structure/chair/stool/bar,
/obj/structure/bed/nest,
/turf/open/floor/alien,
/area/crew_quarters/bar)
"bF" = (
/obj/structure/table/reinforced,
/obj/item/lighter,
/turf/open/floor/alien,
/area/crew_quarters/bar)
"bG" = (
/obj/machinery/light{
	dir = 4
	},
/turf/open/floor/alien,
/area/crew_quarters/bar)
"bH" = (
/obj/machinery/vending/boozeomat,
/turf/open/floor/alien,
/area/crew_quarters/bar)
"bI" = (
/obj/machinery/vending/dinnerware,
/turf/open/floor/alien,
/area/crew_quarters/kitchen)
"bJ" = (
/obj/structure/sink/kitchen{
	pixel_y = 28
	},
/obj/machinery/food_cart,
/turf/open/floor/alien,
/area/crew_quarters/kitchen)
"bK" = (
/obj/structure/extinguisher_cabinet{
	pixel_x = -5;
	pixel_y = 30
	},
/turf/open/floor/alien,
/area/crew_quarters/kitchen)
"bL" = (
/obj/structure/disposalpipe/segment,
/obj/machinery/atmospherics/pipe/simple/supply/hidden/layer1,
/obj/machinery/atmospherics/pipe/simple/scrubbers/hidden/layer3,
/turf/open/floor/alien,
/area/crew_quarters/kitchen)
"bM" = (
/obj/item/radio/intercom{
	pixel_y = 25
	},
/obj/machinery/camera{
	c_tag = "Kitchen";
	dir = 2
	},
/obj/structure/closet/secure_closet/freezer/fridge,
/turf/open/floor/alien,
/area/crew_quarters/kitchen)
"bN" = (
/obj/structure/table,
/obj/machinery/microwave{
	pixel_x = -3;
	pixel_y = 6
	},
/obj/machinery/airalarm{
	pixel_y = 24
	},
/obj/machinery/light{
	dir = 1
	},
/turf/open/floor/alien,
/area/crew_quarters/kitchen)
"bO" = (
/obj/structure/table,
/obj/machinery/microwave{
	pixel_x = -3;
	pixel_y = 6
	},
/turf/open/floor/alien,
/area/crew_quarters/kitchen)
"bP" = (
/obj/structure/closet/secure_closet/freezer/kitchen,
/turf/open/floor/alien,
/area/crew_quarters/kitchen)
"bQ" = (
/obj/machinery/door/poddoor/preopen{
	id = "barShutters";
	name = "privacy shutters"
	},
/obj/structure/alien/resin/membrane,
/turf/open/floor/plating,
/area/crew_quarters/bar)
"bR" = (
/obj/effect/decal/remains/xeno,
/turf/open/floor/alien,
/area/crew_quarters/bar)
"bS" = (
/obj/structure/bed/nest,
/turf/open/floor/alien,
/area/crew_quarters/bar)
"bT" = (
/obj/structure/table,
/obj/item/kitchen/fork,
/turf/open/floor/alien,
/area/crew_quarters/bar)
"bU" = (
/obj/structure/table/wood/poker,
/obj/item/toy/cards/deck,
/turf/open/floor/plasteel,
/area/crew_quarters/bar)
"bV" = (
/obj/structure/chair/stool,
/obj/structure/alien/weeds/node,
/obj/structure/bed/nest,
/turf/open/floor/alien,
/area/crew_quarters/bar)
"bW" = (
/obj/structure/table/reinforced,
/obj/item/reagent_containers/food/snacks/burger/xeno,
/turf/open/floor/alien,
/area/crew_quarters/bar)
"bX" = (
/mob/living/carbon/monkey/punpun,
/turf/open/floor/alien,
/area/crew_quarters/bar)
"bY" = (
/obj/machinery/door/airlock/public/glass{
	name = "Kitchen";
	req_access_txt = "28"
	},
/turf/open/floor/alien,
/area/crew_quarters/kitchen)
"bZ" = (
/turf/open/floor/alien,
/area/crew_quarters/kitchen)
"ca" = (
/obj/effect/landmark/start/cook,
/obj/machinery/atmospherics/components/unary/vent_scrubber/on/layer3{
	icon_state = "scrub_map_on-3";
	dir = 4
	},
/turf/open/floor/alien,
/area/crew_quarters/kitchen)
"cb" = (
/obj/structure/disposalpipe/segment{
	dir = 5
	},
/obj/machinery/atmospherics/pipe/simple/supply/hidden/layer1{
	icon_state = "pipe11-1";
	dir = 5
	},
/obj/machinery/atmospherics/pipe/simple/scrubbers/hidden/layer3{
	icon_state = "pipe11-3";
	dir = 9
	},
/turf/open/floor/alien,
/area/crew_quarters/kitchen)
"cc" = (
/obj/structure/disposalpipe/segment{
	dir = 4
	},
/obj/machinery/atmospherics/components/unary/vent_pump/on/layer1{
	icon_state = "vent_map_on-1";
	dir = 8
	},
/turf/open/floor/alien,
/area/crew_quarters/kitchen)
"cd" = (
/obj/structure/disposalpipe/segment{
	dir = 4
	},
/turf/open/floor/alien,
/area/crew_quarters/kitchen)
"ce" = (
/obj/structure/disposalpipe/segment{
	dir = 10
	},
/turf/open/floor/alien,
/area/crew_quarters/kitchen)
"cf" = (
/obj/structure/alien/weeds/node,
/turf/open/floor/aliennode,
/area/crew_quarters/kitchen)
"cg" = (
/obj/machinery/airalarm{
	dir = 4;
	pixel_x = -22
	},
/obj/machinery/camera{
	c_tag = "Bar West";
	dir = 4
	},
/obj/effect/decal/cleanable/xenoblood/xgibs/larva,
/turf/open/floor/alien,
/area/crew_quarters/bar)
"ch" = (
/obj/effect/landmark/event_spawn,
/obj/effect/spawner/xmastree,
/turf/open/floor/alien,
/area/crew_quarters/bar)
"ci" = (
/obj/machinery/atmospherics/components/unary/vent_scrubber/on/layer3,
/turf/open/floor/alien,
/area/crew_quarters/bar)
"cj" = (
/obj/structure/table/reinforced,
/obj/item/clothing/head/that{
	throwforce = 1
	},
/turf/open/floor/alien,
/area/crew_quarters/bar)
"ck" = (
/obj/effect/landmark/start/bartender,
/turf/open/floor/alien,
/area/crew_quarters/bar)
"cl" = (
/obj/machinery/requests_console{
	department = "Bar";
	departmentType = 2;
	pixel_x = 30;
	receive_ore_updates = 1
	},
/obj/machinery/camera{
	c_tag = "Bar";
	dir = 8
	},
/obj/structure/table,
/obj/machinery/chem_dispenser/drinks{
	dir = 8
	},
/turf/open/floor/alien,
/area/crew_quarters/bar)
"cm" = (
/obj/structure/table,
/obj/item/reagent_containers/food/snacks/mint,
/obj/item/reagent_containers/food/snacks/meat/slab/xeno,
/obj/item/reagent_containers/food/snacks/meat/slab/xeno,
/obj/item/reagent_containers/food/snacks/meat/slab/xeno,
/turf/open/floor/alien,
/area/crew_quarters/kitchen)
"cn" = (
/obj/structure/table,
/obj/item/reagent_containers/food/condiment/saltshaker{
	pixel_x = -3
	},
/obj/item/reagent_containers/food/condiment/peppermill{
	pixel_x = 3
	},
/turf/open/floor/alien,
/area/crew_quarters/kitchen)
"co" = (
/obj/structure/table,
/obj/item/kitchen/rollingpin,
/turf/open/floor/alien,
/area/crew_quarters/kitchen)
"cp" = (
/obj/structure/table,
/obj/item/book/manual/chef_recipes,
/obj/item/book/manual/wiki/cooking_to_serve_man{
	pixel_x = -4;
	pixel_y = 4
	},
/turf/open/floor/alien,
/area/crew_quarters/kitchen)
"cq" = (
/obj/structure/disposalpipe/segment,
/turf/open/floor/alien,
/area/crew_quarters/kitchen)
"cr" = (
/obj/machinery/holopad,
/turf/open/floor/alien,
/area/crew_quarters/bar)
"cs" = (
/obj/machinery/atmospherics/pipe/simple/supply/hidden/layer1{
	icon_state = "pipe11-1";
	dir = 6
	},
/obj/machinery/atmospherics/pipe/simple/scrubbers/hidden/layer3{
	icon_state = "pipe11-3";
	dir = 5
	},
/turf/open/floor/aliennode,
/area/crew_quarters/bar)
"ct" = (
/obj/machinery/atmospherics/pipe/simple/supply/hidden/layer1{
	icon_state = "pipe11-1";
	dir = 8
	},
/obj/machinery/atmospherics/pipe/simple/scrubbers/hidden/layer3{
	icon_state = "pipe11-3";
	dir = 4
	},
/obj/structure/bed/nest,
/turf/open/floor/alien,
/area/crew_quarters/bar)
"cu" = (
/obj/machinery/atmospherics/pipe/simple/supply/hidden/layer1{
	icon_state = "pipe11-1";
	dir = 8
	},
/obj/machinery/atmospherics/pipe/simple/scrubbers/hidden/layer3{
	icon_state = "pipe11-3";
	dir = 4
	},
/turf/open/floor/alien,
/area/crew_quarters/bar)
"cv" = (
/obj/machinery/atmospherics/pipe/simple/supply/hidden/layer1{
	icon_state = "pipe11-1";
	dir = 9
	},
/obj/machinery/atmospherics/pipe/simple/scrubbers/hidden/layer3{
	icon_state = "pipe11-3";
	dir = 9
	},
/obj/effect/decal/cleanable/xenoblood/xgibs/down,
/turf/open/floor/alien,
/area/crew_quarters/bar)
"cw" = (
/obj/structure/table/reinforced,
/obj/item/clothing/suit/xenos,
/obj/item/clothing/suit/xenos,
/obj/item/clothing/suit/xenos,
/obj/item/clothing/suit/xenos,
/obj/item/clothing/suit/xenos,
/turf/open/floor/alien,
/area/crew_quarters/bar)
"cx" = (
/obj/structure/table,
/obj/item/reagent_containers/food/condiment/enzyme{
	layer = 5
	},
/obj/item/stack/packageWrap,
/turf/open/floor/alien,
/area/crew_quarters/kitchen)
"cy" = (
/obj/structure/table/reinforced,
/obj/machinery/door/firedoor,
/obj/item/reagent_containers/food/snacks/pie/cream,
/turf/open/floor/plasteel/cafeteria,
/area/crew_quarters/kitchen)
"cz" = (
/obj/structure/table,
/obj/item/storage/box/donkpockets{
	pixel_x = 3;
	pixel_y = 3
	},
/obj/item/reagent_containers/glass/beaker{
	pixel_x = 5
	},
/turf/open/floor/alien,
/area/crew_quarters/kitchen)
"cA" = (
/obj/machinery/deepfryer,
/turf/open/floor/alien,
/area/crew_quarters/kitchen)
"cB" = (
/obj/machinery/processor,
/obj/machinery/firealarm{
	dir = 4;
	pixel_x = 24
	},
/turf/open/floor/alien,
/area/crew_quarters/kitchen)
"cC" = (
/obj/machinery/light{
	dir = 8
	},
/obj/machinery/computer/security/telescreen/entertainment{
	pixel_x = -31
	},
/obj/item/clothing/mask/facehugger/toy,
/turf/open/floor/alien,
/area/crew_quarters/bar)
"cD" = (
/obj/structure/table/wood/poker,
/obj/item/clothing/mask/cigarette/cigar,
/obj/item/toy/cards/deck,
/turf/open/floor/alien,
/area/crew_quarters/bar)
"cE" = (
/obj/effect/decal/cleanable/blood/tracks{
	icon_state = "tracks";
	dir = 5
	},
/turf/open/floor/alien,
/area/crew_quarters/bar)
"cF" = (
/obj/machinery/atmospherics/components/unary/vent_pump/on/layer1{
	icon_state = "vent_map_on-1";
	dir = 1
	},
/obj/structure/bed/nest,
/turf/open/floor/alien,
/area/crew_quarters/bar)
"cG" = (
/obj/structure/table,
/obj/item/reagent_containers/food/condiment/peppermill{
	pixel_x = 5;
	pixel_y = -2
	},
/obj/item/reagent_containers/food/condiment/saltshaker{
	pixel_x = -2;
	pixel_y = 2
	},
/turf/open/floor/alien,
/area/crew_quarters/bar)
"cH" = (
/obj/structure/table/reinforced,
/obj/item/clothing/head/xenos,
/obj/item/clothing/head/xenos,
/obj/item/clothing/head/xenos,
/obj/item/clothing/head/xenos,
/obj/item/clothing/head/xenos,
/turf/open/floor/alien,
/area/crew_quarters/bar)
"cI" = (
/obj/structure/table/reinforced,
/obj/item/organ/tongue/alien,
/obj/item/organ/tongue/alien,
/obj/item/organ/tongue/alien,
/obj/item/organ/tongue/alien,
/obj/item/organ/tongue/alien,
/turf/open/floor/alien,
/area/crew_quarters/bar)
"cJ" = (
/obj/machinery/door/window/southright{
	name = "Bar Door";
	req_one_access_txt = "25;28"
	},
/turf/open/floor/alien,
/area/crew_quarters/bar)
"cK" = (
/obj/structure/table/reinforced,
/obj/machinery/computer/security/telescreen/entertainment{
	pixel_x = 32
	},
/obj/item/book/manual/wiki/barman_recipes,
/obj/item/reagent_containers/glass/rag,
/turf/open/floor/alien,
/area/crew_quarters/bar)
"cL" = (
/obj/effect/landmark/start/cook,
/turf/open/floor/alien,
/area/crew_quarters/kitchen)
"cM" = (
/obj/structure/table,
/obj/machinery/reagentgrinder,
/obj/machinery/requests_console{
	department = "Kitchen";
	departmentType = 2;
	pixel_x = 30
	},
/turf/open/floor/alien,
/area/crew_quarters/kitchen)
"cN" = (
/obj/effect/decal/cleanable/blood/splatter,
/turf/open/floor/alien,
/area/crew_quarters/bar)
"cO" = (
/obj/effect/decal/cleanable/blood/tracks,
/turf/open/floor/alien,
/area/crew_quarters/bar)
"cP" = (
/obj/structure/chair/stool/bar,
/obj/effect/landmark/start/assistant,
/obj/structure/bed/nest,
/turf/open/floor/alien,
/area/crew_quarters/bar)
"cQ" = (
/obj/machinery/light,
/turf/open/floor/alien,
/area/crew_quarters/kitchen)
"cR" = (
/obj/effect/landmark/event_spawn,
/turf/open/floor/alien,
/area/crew_quarters/kitchen)
"cS" = (
/obj/structure/chair/stool/bar,
/obj/effect/landmark/event_spawn,
/obj/structure/bed/nest,
/turf/open/floor/alien,
/area/crew_quarters/bar)
"cT" = (
/obj/effect/decal/cleanable/xenoblood/xgibs/core,
/turf/open/floor/alien,
/area/crew_quarters/bar)
"cU" = (
/obj/machinery/door/firedoor,
/obj/machinery/door/airlock{
	name = "Kitchen";
	req_access_txt = "28"
	},
/turf/open/floor/alien,
/area/crew_quarters/kitchen)
"cV" = (
/obj/machinery/light_switch{
	pixel_y = -25
	},
/turf/open/floor/alien,
/area/crew_quarters/kitchen)
"cW" = (
/obj/structure/disposalpipe/segment{
	dir = 5
	},
/obj/machinery/button/door{
	id = "kitchen";
	name = "Kitchen Shutters Control";
	pixel_x = -1;
	pixel_y = -24;
	req_access_txt = "28"
	},
/turf/open/floor/alien,
/area/crew_quarters/kitchen)
"cX" = (
/obj/machinery/disposal/bin,
/obj/structure/disposalpipe/trunk{
	dir = 8
	},
/turf/open/floor/alien,
/area/crew_quarters/kitchen)
"cY" = (
/obj/machinery/computer/arcade,
/turf/open/floor/alien,
/area/crew_quarters/bar)
"cZ" = (
/obj/machinery/vending/cigarette,
/turf/open/floor/alien,
/area/crew_quarters/bar)
"da" = (
/obj/machinery/newscaster{
	pixel_y = -28
	},
/turf/open/floor/alien,
/area/crew_quarters/bar)
"db" = (
/obj/machinery/light,
/turf/open/floor/alien,
/area/crew_quarters/bar)
"dc" = (
/obj/machinery/camera{
	c_tag = "Bar South";
	dir = 1
	},
/turf/open/floor/alien,
/area/crew_quarters/bar)
"dd" = (
/obj/machinery/light/small,
/obj/item/clothing/mask/facehugger/toy,
/turf/open/floor/alien,
/area/crew_quarters/bar)
"de" = (
/obj/structure/table/reinforced,
/obj/item/storage/fancy/donut_box,
/obj/machinery/door/firedoor,
/obj/machinery/door/poddoor/shutters/preopen{
	id = "kitchen";
	name = "kitchen shutters"
	},
/turf/open/floor/plasteel/cafeteria,
/area/crew_quarters/kitchen)
"df" = (
/obj/structure/table/reinforced,
/obj/machinery/door/firedoor,
/obj/machinery/door/poddoor/shutters/preopen{
	id = "kitchen";
	name = "kitchen shutters"
	},
/obj/item/reagent_containers/food/snacks/burger/xeno,
/turf/open/floor/plasteel/cafeteria,
/area/crew_quarters/kitchen)
"dg" = (
/obj/structure/table/reinforced,
/obj/machinery/door/firedoor,
/obj/machinery/door/poddoor/shutters/preopen{
	id = "kitchen";
	name = "kitchen shutters"
	},
/obj/item/reagent_containers/food/snacks/meat/steak/xeno,
/turf/open/floor/plasteel/cafeteria,
/area/crew_quarters/kitchen)
"dh" = (
/obj/structure/table/reinforced,
/obj/machinery/door/firedoor,
/obj/machinery/door/poddoor/shutters/preopen{
	id = "kitchen";
	name = "kitchen shutters"
	},
/obj/item/reagent_containers/food/snacks/store/bread/xenomeat,
/turf/open/floor/plasteel/cafeteria,
/area/crew_quarters/kitchen)
"di" = (
/obj/machinery/door/firedoor,
/obj/machinery/door/airlock/abductor{
	assemblytype = /obj/structure/door_assembly;
	name = "Space Diner"
	},
/turf/open/floor/alien,
/area/crew_quarters/bar)
"dj" = (
/obj/structure/sign/barsign,
/turf/closed/wall/mineral/xeno,
/area/crew_quarters/bar)
"Mi" = (
/mob/living/simple_animal/hostile/alien/maid/barmaid,
/turf/open/floor/alien,
/area/crew_quarters/bar)

(1,1,1) = {"
aa
ac
ac
ac
ac
am
bA
bQ
am
bQ
am
bQ
am
am
"}
(2,1,1) = {"
aa
ac
az
aV
bj
bm
bB
bR
cg
bh
cC
av
cY
am
"}
(3,1,1) = {"
ac
ac
aD
aN
bk
bh
bh
bS
bh
bh
bV
cN
cZ
am
"}
(4,1,1) = {"
ac
aq
aH
aN
aN
bh
bC
bT
bS
bh
cD
bD
da
am
"}
(5,1,1) = {"
ab
ar
aI
bb
aN
bn
bh
bS
bh
bh
bD
bh
bh
am
"}
(6,1,1) = {"
ac
as
aM
be
aN
br
av
bh
ch
cr
cE
cO
cO
di
"}
(7,1,1) = {"
ac
at
aN
aN
aN
bh
bh
bD
ci
cs
cF
bh
bh
bQ
"}
(8,1,1) = {"
ac
au
aN
aN
bl
bh
bD
bU
bh
ct
cG
bC
bh
di
"}
(9,1,1) = {"
am
av
aO
bh
bh
bh
bh
bV
bh
cu
bS
bh
db
dj
"}
(10,1,1) = {"
ad
aw
aP
aP
aP
bs
bs
bs
bs
cv
bh
bh
dc
am
"}
(11,1,1) = {"
am
ax
aQ
bi
aQ
bv
bE
bE
bE
bE
bE
bh
bn
am
"}
(12,1,1) = {"
am
am
am
am
am
am
bF
bW
cj
cw
cH
cP
bh
am
"}
(13,1,1) = {"
ah
ay
aE
bd
am
bw
Mi
bn
ck
bh
cI
cS
bh
am
"}
(14,1,1) = {"
ae
ae
aG
aT
bo
bx
bG
bX
bh
bh
cJ
bh
dd
am
"}
(15,1,1) = {"
af
aB
aJ
bf
am
by
bH
bh
cl
bh
cK
cT
av
am
"}
(16,1,1) = {"
ag
aA
aK
ag
am
bz
bz
bY
bz
cy
bz
cU
bz
bz
"}
(17,1,1) = {"
ak
aB
aR
ag
bp
bz
bI
bZ
bZ
bZ
bZ
cV
bz
aa
"}
(18,1,1) = {"
al
al
al
al
al
bz
bJ
bZ
cf
bZ
bZ
cQ
bz
aa
"}
(19,1,1) = {"
al
aC
aS
bg
bq
bz
bK
ca
cm
cx
bZ
bZ
de
aa
"}
(20,1,1) = {"
ai
an
an
aW
aZ
bc
bL
cb
cn
cz
cL
bZ
df
aa
"}
(21,1,1) = {"
al
ap
aL
aX
ba
bz
bM
cc
co
cA
bZ
cR
dg
aa
"}
(22,1,1) = {"
ao
aF
aU
bt
bt
bz
bN
cd
cp
cA
bZ
cf
dh
aa
"}
(23,1,1) = {"
al
al
al
aY
bu
bz
bO
ce
cq
cq
cq
cW
bz
aa
"}
(24,1,1) = {"
aa
aa
al
al
al
bz
bP
cf
bZ
cB
cM
cX
bz
aa
"}
