"aa" = (/turf/template_noop,/area/template_noop)
"ab" = (/obj/machinery/door/airlock{name = "Theatre Backstage"; req_access_txt = "46"},/obj/machinery/atmospherics/pipe/simple/supply/hidden/layer1,/obj/machinery/atmospherics/pipe/simple/scrubbers/hidden/layer3,/obj/machinery/door/firedoor/border_only{dir = 1},/obj/machinery/door/firedoor/border_only,/turf/open/floor/plasteel,/area/crew_quarters/theatre)
"ad" = (/obj/machinery/door/airlock/maintenance{name = "Bar Maintenance"; req_access_txt = "12"},/obj/structure/disposalpipe/segment,/obj/machinery/door/firedoor/border_only,/obj/machinery/door/firedoor/border_only{dir = 1},/turf/open/floor/plating,/area/maintenance/starboard/fore)
"ae" = (/obj/structure/piano,/obj/machinery/light{dir = 8},/turf/open/floor/clockwork/reebe,/area/crew_quarters/theatre)
"af" = (/obj/structure/chair/brass{dir = 8},/turf/open/floor/clockwork/reebe,/area/crew_quarters/theatre)
"ag" = (/obj/machinery/atmospherics/components/unary/vent_scrubber/on/layer3{dir = 4; icon_state = "scrub_map_on-3"},/turf/open/floor/clockwork/reebe,/area/crew_quarters/theatre)
"ai" = (/obj/machinery/door/airlock/maintenance{name = "Kitchen Maintenance"; req_access_txt = "28"},/obj/structure/disposalpipe/segment,/obj/machinery/atmospherics/pipe/simple/supply/hidden/layer1,/obj/machinery/atmospherics/pipe/simple/scrubbers/hidden/layer3,/obj/machinery/door/firedoor/border_only{dir = 1},/obj/machinery/door/firedoor/border_only,/turf/open/floor/plating,/area/maintenance/starboard/fore)
"aj" = (/obj/machinery/atmospherics/components/unary/vent_pump/on/layer1{dir = 8; icon_state = "vent_map_on-1"},/turf/open/floor/clockwork/reebe,/area/crew_quarters/theatre)
"ak" = (/obj/machinery/door/window/southleft{base_state = "left"; dir = 2; icon_state = "left"; name = "Bar Delivery"; req_access_txt = "25"},/obj/effect/turf_decal/delivery,/turf/open/floor/plasteel,/area/crew_quarters/bar)
"al" = (/turf/closed/wall,/area/crew_quarters/kitchen)
"an" = (/obj/structure/disposalpipe/segment,/obj/machinery/atmospherics/pipe/simple/supply/hidden/layer1,/obj/machinery/atmospherics/pipe/simple/scrubbers/hidden/layer3,/turf/open/floor/plasteel/showroomfloor,/area/crew_quarters/kitchen)
"ao" = (/obj/machinery/navbeacon{codes_txt = "delivery;dir=2"; freq = 1400; location = "Kitchen"},/obj/structure/plasticflaps{opacity = 1},/obj/effect/turf_decal/bot{dir = 2},/turf/open/floor/plasteel{dir = 2},/area/crew_quarters/kitchen)
"ap" = (/obj/machinery/camera{c_tag = "Kitchen Cold Room"},/obj/structure/reagent_dispensers/cooking_oil,/turf/open/floor/plasteel/showroomfloor,/area/crew_quarters/kitchen)
"aq" = (/obj/structure/table/reinforced/brass,/obj/item/clothing/head/bronze,/obj/item/clothing/shoes/bronze,/obj/item/clothing/suit/bronze,/obj/item/toy/clockwork_watch,/turf/open/floor/clockwork/reebe,/area/crew_quarters/bar)
"ar" = (/obj/structure/table/reinforced/brass,/obj/item/instrument/trumpet,/obj/item/instrument/trombone,/turf/open/floor/clockwork/reebe,/area/crew_quarters/theatre)
"as" = (/turf/open/floor/clockwork/reebe,/area/crew_quarters/theatre)
"aw" = (/obj/machinery/atmospherics/pipe/simple/supply/hidden/layer1{dir = 4},/obj/machinery/atmospherics/pipe/simple/scrubbers/hidden/layer3{dir = 4},/turf/open/floor/bronze,/area/crew_quarters/bar)
"ax" = (/obj/machinery/atmospherics/pipe/simple/supply/hidden/layer1{dir = 10},/obj/machinery/atmospherics/pipe/simple/scrubbers/hidden/layer3{dir = 10},/turf/open/floor/bronze,/area/crew_quarters/bar)
"ay" = (/obj/structure/table/reinforced/brass,/obj/machinery/light{dir = 4},/obj/item/clothing/head/bronze,/obj/item/clothing/shoes/bronze,/obj/item/clothing/suit/bronze,/obj/item/toy/clockwork_watch,/turf/open/floor/clockwork/reebe,/area/crew_quarters/bar)
"az" = (/obj/machinery/door/firedoor/border_only,/obj/structure/window/reinforced/clockwork/unanchored{anchored = 1},/obj/structure/table/reinforced/brass,/obj/item/instrument/saxophone,/turf/open/floor/clockwork/reebe,/area/crew_quarters/theatre)
"aA" = (/obj/machinery/door/firedoor/border_only,/obj/structure/window/reinforced/clockwork/unanchored{anchored = 1},/turf/open/floor/clockwork/reebe,/area/crew_quarters/theatre)
"aC" = (/obj/structure/closet/secure_closet/freezer/meat,/turf/open/floor/plasteel/showroomfloor,/area/crew_quarters/kitchen)
"aF" = (/obj/machinery/door/window/southleft{base_state = "left"; dir = 2; icon_state = "left"; name = "Kitchen Delivery"; req_access_txt = "28"},/obj/effect/turf_decal/delivery,/obj/structure/window/reinforced{dir = 8},/turf/open/floor/plasteel,/area/crew_quarters/kitchen)
"aJ" = (/obj/item/clockwork/alloy_shards/clockgolem_remains,/turf/open/floor/clockwork/reebe,/area/crew_quarters/bar)
"aL" = (/obj/machinery/chem_master/condimaster{name = "CondiMaster Neo"},/turf/open/floor/plasteel/showroomfloor,/area/crew_quarters/kitchen)
"aS" = (/obj/machinery/icecream_vat,/turf/open/floor/plasteel/showroomfloor,/area/crew_quarters/kitchen)
"aU" = (/obj/effect/turf_decal/loading_area,/turf/open/floor/plasteel/showroomfloor,/area/crew_quarters/kitchen)
"aW" = (/obj/structure/disposalpipe/segment,/obj/machinery/atmospherics/pipe/simple/supply/hidden/layer1,/obj/machinery/atmospherics/pipe/manifold/scrubbers/hidden/layer3{dir = 8},/turf/open/floor/plasteel/showroomfloor,/area/crew_quarters/kitchen)
"aX" = (/obj/machinery/atmospherics/components/unary/vent_scrubber/on/layer3{dir = 8; icon_state = "scrub_map_on-3"},/obj/effect/spawner/lootdrop/mob/kitchen_animal,/turf/open/floor/plasteel/showroomfloor,/area/crew_quarters/kitchen)
"aY" = (/obj/machinery/light/small{dir = 4},/obj/machinery/airalarm{dir = 8; pixel_x = 24},/obj/machinery/vending/wardrobe/chef_wardrobe,/turf/open/floor/plasteel/showroomfloor,/area/crew_quarters/kitchen)
"aZ" = (/obj/structure/disposalpipe/segment,/obj/machinery/atmospherics/pipe/simple/scrubbers/hidden/layer3,/obj/machinery/atmospherics/pipe/manifold/supply/hidden/layer1{dir = 8},/turf/open/floor/plasteel/showroomfloor,/area/crew_quarters/kitchen)
"ba" = (/obj/machinery/atmospherics/components/unary/vent_pump/on/layer1{dir = 8; icon_state = "vent_map_on-1"},/turf/open/floor/plasteel/showroomfloor,/area/crew_quarters/kitchen)
"bg" = (/obj/structure/kitchenspike,/obj/machinery/light/small{dir = 8},/turf/open/floor/plasteel/showroomfloor,/area/crew_quarters/kitchen)
"bn" = (/obj/machinery/atmospherics/pipe/simple/supply/hidden/layer1{dir = 5},/obj/machinery/atmospherics/pipe/simple/scrubbers/hidden/layer3{dir = 5},/turf/open/floor/bronze,/area/crew_quarters/theatre)
"bq" = (/obj/structure/kitchenspike,/turf/open/floor/plasteel/showroomfloor,/area/crew_quarters/kitchen)
"bt" = (/turf/open/floor/plasteel/showroomfloor,/area/crew_quarters/kitchen)
"bu" = (/obj/machinery/gibber,/turf/open/floor/plasteel/showroomfloor,/area/crew_quarters/kitchen)
"bU" = (/obj/item/clockwork/alloy_shards/small,/turf/open/floor/clockwork/reebe,/area/crew_quarters/bar)
"cK" = (/obj/effect/landmark/blobstart,/obj/item/toy/plush/narplush,/obj/structure/window/reinforced/clockwork/unanchored{anchored = 1; dir = 8},/obj/structure/window/reinforced/clockwork/unanchored{anchored = 1; dir = 4},/obj/structure/window/reinforced/clockwork/unanchored{anchored = 1; dir = 1},/obj/structure/window/reinforced/clockwork/unanchored{anchored = 1},/turf/open/floor/plating,/area/crew_quarters/bar)
"cU" = (/obj/structure/disposalpipe/segment,/turf/open/floor/bronze,/area/crew_quarters/bar)
"dd" = (/obj/structure/closet/secure_closet/bar{req_access_txt = "25"},/turf/open/floor/clockwork/reebe,/area/crew_quarters/bar)
"di" = (/obj/machinery/computer/arcade,/turf/open/floor/bronze,/area/crew_quarters/bar)
"dv" = (/obj/effect/landmark/event_spawn,/obj/structure/chair/bronze{dir = 1},/turf/open/floor/clockwork/reebe,/area/crew_quarters/bar)
"dC" = (/obj/item/storage/box/donkpockets{pixel_x = 3; pixel_y = 3},/obj/item/reagent_containers/glass/beaker{pixel_x = 5},/obj/structure/table/reinforced/brass,/turf/open/floor/bronze,/area/crew_quarters/kitchen)
"dG" = (/turf/closed/wall/clockwork,/area/crew_quarters/theatre)
"eu" = (/turf/open/floor/bronze,/area/crew_quarters/kitchen)
"eP" = (/obj/machinery/deepfryer,/turf/open/floor/bronze,/area/crew_quarters/kitchen)
"eZ" = (/obj/structure/table/reinforced/brass,/obj/item/clothing/head/that,/turf/open/floor/clockwork/reebe,/area/crew_quarters/bar)
"fm" = (/obj/machinery/door/firedoor/border_only{dir = 4},/obj/machinery/door/firedoor/border_only{dir = 8},/obj/structure/table/reinforced/brass,/obj/machinery/door/window/westright{color = "#b5924d"},/turf/open/floor/clockwork/reebe,/area/crew_quarters/kitchen)
"fT" = (/obj/structure/disposalpipe/segment{dir = 10},/turf/open/floor/bronze,/area/crew_quarters/kitchen)
"hs" = (/obj/machinery/requests_console{department = "Bar"; departmentType = 2; pixel_x = 30; receive_ore_updates = 1},/obj/machinery/camera{c_tag = "Bar"; dir = 8},/obj/machinery/chem_dispenser/drinks{dir = 8},/obj/structure/table/reinforced/brass,/obj/machinery/light{dir = 4},/turf/open/floor/clockwork/reebe,/area/crew_quarters/bar)
"hG" = (/obj/machinery/disposal/bin,/obj/structure/disposalpipe/trunk{dir = 8},/turf/open/floor/bronze,/area/crew_quarters/kitchen)
"hH" = (/obj/structure/table/reinforced/brass,/turf/open/floor/clockwork/reebe,/area/crew_quarters/bar)
"iz" = (/obj/structure/window/reinforced/clockwork/fulltile,/obj/structure/grille/ratvar,/obj/machinery/door/poddoor/preopen{id = "barShutters"; name = "privacy shutters"},/turf/open/floor/plating,/area/crew_quarters/theatre)
"iR" = (/obj/item/storage/box/fancy/donut_box,/obj/machinery/door/firedoor,/obj/machinery/door/poddoor/shutters/preopen{id = "kitchen"; name = "kitchen shutters"},/obj/structure/table/reinforced/brass,/turf/open/floor/clockwork/reebe,/area/crew_quarters/kitchen)
"ji" = (/obj/machinery/camera{c_tag = "Bar Storage"},/turf/open/floor/clockwork/reebe,/area/crew_quarters/bar)
"jN" = (/obj/machinery/door/poddoor/preopen{id = "barShutters"; name = "privacy shutters"},/obj/structure/window/reinforced/clockwork/fulltile,/obj/structure/grille/ratvar,/turf/open/floor/plating,/area/crew_quarters/bar)
"kd" = (/obj/machinery/atmospherics/pipe/simple/supply/hidden/layer1{dir = 4},/obj/machinery/atmospherics/pipe/simple/scrubbers/hidden/layer3{dir = 4},/turf/open/floor/bronze,/area/crew_quarters/theatre)
"ki" = (/obj/machinery/processor,/obj/machinery/firealarm{dir = 8; pixel_x = 26; pixel_y = 0},/turf/open/floor/clockwork/reebe,/area/crew_quarters/kitchen)
"kl" = (/obj/structure/table/reinforced/brass,/obj/item/reagent_containers/food/condiment/peppermill{pixel_x = 5; pixel_y = -2},/obj/item/reagent_containers/food/condiment/saltshaker{pixel_x = -2; pixel_y = 2},/turf/open/floor/clockwork/reebe,/area/crew_quarters/bar)
"kB" = (/obj/machinery/atmospherics/components/unary/vent_pump/on/layer1{dir = 1; icon_state = "vent_map_on-1"},/turf/open/floor/bronze,/area/crew_quarters/bar)
"kN" = (/obj/machinery/microwave{pixel_x = -3; pixel_y = 6},/obj/machinery/airalarm{pixel_y = 24},/obj/machinery/light{dir = 1},/obj/structure/table/reinforced/brass,/turf/open/floor/clockwork/reebe,/area/crew_quarters/kitchen)
"lk" = (/obj/machinery/light_switch{pixel_y = 28},/obj/machinery/light{dir = 1},/turf/open/floor/clockwork/reebe,/area/crew_quarters/theatre)
"lw" = (/obj/machinery/atmospherics/pipe/simple/scrubbers/hidden/layer3{dir = 9},/obj/machinery/atmospherics/pipe/simple/supply/hidden/layer1{dir = 9},/turf/open/floor/bronze,/area/crew_quarters/bar)
"lI" = (/obj/effect/landmark/start/assistant,/obj/structure/chair/bronze{dir = 1},/turf/open/floor/clockwork/reebe,/area/crew_quarters/bar)
"mI" = (/obj/machinery/vending/wardrobe/bar_wardrobe,/turf/open/floor/clockwork/reebe,/area/crew_quarters/bar)
"np" = (/obj/machinery/light/small{dir = 4},/turf/open/floor/clockwork/reebe,/area/crew_quarters/bar)
"ob" = (/obj/machinery/airalarm{dir = 4; pixel_x = -24},/obj/machinery/light/small{dir = 8},/obj/structure/reagent_dispensers/beerkeg,/obj/machinery/atmospherics/components/unary/vent_scrubber/on/layer3{dir = 4; icon_state = "scrub_map_on-3"},/turf/open/floor/clockwork/reebe,/area/crew_quarters/bar)
"oi" = (/obj/machinery/reagentgrinder,/obj/structure/table/reinforced/brass,/turf/open/floor/clockwork/reebe,/area/crew_quarters/bar)
"os" = (/obj/item/stack/sheet/metal/fifty,/obj/item/stack/sheet/glass/fifty,/obj/item/stack/cable_coil,/obj/item/flashlight/lamp,/obj/item/flashlight/lamp/green,/obj/structure/closet/secure_closet/bartender,/turf/open/floor/clockwork/reebe,/area/crew_quarters/bar)
"oC" = (/obj/machinery/light,/turf/open/floor/clockwork/reebe,/area/crew_quarters/kitchen)
"oE" = (/obj/item/lighter,/obj/structure/table/reinforced/brass,/turf/open/floor/clockwork/reebe,/area/crew_quarters/bar)
"oL" = (/obj/structure/window/reinforced/clockwork/unanchored{anchored = 1; dir = 4},/obj/machinery/door/firedoor/border_only{dir = 4},/obj/structure/window/reinforced/clockwork/unanchored{anchored = 1},/obj/machinery/door/firedoor/border_only,/obj/item/clockwork/alloy_shards/medium,/turf/open/floor/clockwork/reebe,/area/crew_quarters/theatre)
"oV" = (/obj/machinery/door/firedoor,/obj/machinery/door/poddoor/shutters/preopen{id = "kitchen"; name = "kitchen shutters"},/obj/structure/table/reinforced/brass,/turf/open/floor/clockwork/reebe,/area/crew_quarters/kitchen)
"pA" = (/obj/structure/disposalpipe/segment{dir = 4},/obj/machinery/atmospherics/components/unary/vent_pump/on/layer1{dir = 8; icon_state = "vent_map_on-1"},/turf/open/floor/bronze,/area/crew_quarters/kitchen)
"pZ" = (/obj/item/radio/intercom{pixel_y = 25},/obj/machinery/camera{c_tag = "Kitchen"; dir = 2},/obj/structure/closet/secure_closet/freezer/fridge,/turf/open/floor/clockwork/reebe,/area/crew_quarters/kitchen)
"qD" = (/obj/item/book/manual/chef_recipes,/obj/item/book/manual/wiki/cooking_to_serve_man{pixel_x = -4; pixel_y = 4},/obj/structure/table/reinforced/brass,/turf/open/floor/bronze,/area/crew_quarters/kitchen)
"qZ" = (/turf/closed/wall/clockwork,/area/crew_quarters/bar)
"rp" = (/obj/structure/table/reinforced/brass,/obj/item/toy/plush/plushvar,/turf/open/floor/clockwork/reebe,/area/crew_quarters/bar)
"rw" = (/obj/structure/chair/bronze{dir = 1},/turf/open/floor/clockwork/reebe,/area/crew_quarters/bar)
"rE" = (/obj/machinery/door/firedoor/border_only,/obj/structure/window/reinforced/clockwork/unanchored{anchored = 1},/obj/structure/window/reinforced/clockwork/unanchored{anchored = 1},/turf/open/floor/clockwork/reebe,/area/crew_quarters/theatre)
"rR" = (/obj/machinery/light,/turf/open/floor/bronze,/area/crew_quarters/bar)
"sv" = (/obj/machinery/atmospherics/components/unary/vent_pump/on/layer1{dir = 8; icon_state = "vent_map_on-1"},/turf/open/floor/clockwork/reebe,/area/crew_quarters/bar)
"tF" = (/obj/structure/disposalpipe/segment{dir = 4},/turf/open/floor/bronze,/area/crew_quarters/kitchen)
"tQ" = (/obj/structure/disposalpipe/segment{dir = 5},/obj/machinery/button/door{id = "kitchen"; name = "Kitchen Shutters Control"; pixel_x = -1; pixel_y = -24; req_access_txt = "28"},/turf/open/floor/bronze,/area/crew_quarters/kitchen)
"uF" = (/obj/machinery/vending/boozeomat,/turf/open/floor/clockwork/reebe,/area/crew_quarters/bar)
"vd" = (/obj/effect/landmark/event_spawn,/turf/open/floor/clockwork/reebe,/area/crew_quarters/kitchen)
"vq" = (/obj/structure/chair/bronze,/turf/open/floor/bronze,/area/crew_quarters/bar)
"vT" = (/obj/effect/landmark/start/bartender,/turf/open/floor/clockwork/reebe,/area/crew_quarters/bar)
"wF" = (/obj/structure/chair/bronze{dir = 1},/turf/open/floor/bronze,/area/crew_quarters/bar)
"wY" = (/obj/item/reagent_containers/food/condiment/saltshaker{pixel_x = -3},/obj/item/reagent_containers/food/condiment/peppermill{pixel_x = 3},/obj/structure/table/reinforced/brass,/turf/open/floor/bronze,/area/crew_quarters/kitchen)
"xr" = (/obj/machinery/light{dir = 8},/turf/open/floor/bronze,/area/crew_quarters/bar)
"xH" = (/obj/machinery/airalarm{dir = 2; pixel_y = 24},/turf/open/floor/clockwork/reebe,/area/crew_quarters/theatre)
"xI" = (/obj/item/reagent_containers/food/condiment/enzyme{layer = 5},/obj/item/stack/packageWrap,/obj/structure/table/reinforced/brass,/turf/open/floor/bronze,/area/crew_quarters/kitchen)
"xW" = (/obj/structure/chair/bronze{dir = 8},/turf/open/floor/clockwork/reebe,/area/crew_quarters/bar)
"za" = (/obj/machinery/chem_dispenser/drinks/beer{dir = 8},/obj/item/radio/intercom{pixel_y = 25},/obj/machinery/firealarm{dir = 8; pixel_x = 26; pixel_y = 0},/obj/structure/table/reinforced/brass,/turf/open/floor/clockwork/reebe,/area/crew_quarters/bar)
"zE" = (/obj/structure/sink/kitchen{pixel_y = 28},/turf/open/floor/clockwork/reebe,/area/crew_quarters/bar)
"Aq" = (/obj/machinery/reagentgrinder,/obj/machinery/requests_console{department = "Kitchen"; departmentType = 2; pixel_x = 30},/obj/structure/table/reinforced/brass,/turf/open/floor/clockwork/reebe,/area/crew_quarters/kitchen)
"AP" = (/obj/machinery/door/firedoor/border_only{dir = 8},/obj/machinery/door/firedoor/border_only{dir = 4},/obj/machinery/door/airlock{color = "#7f590f"; name = "Kitchen"; req_access_txt = "28"},/turf/open/floor/bronze,/area/crew_quarters/kitchen)
"Be" = (/obj/structure/chair/bronze{dir = 4},/turf/open/floor/clockwork/reebe,/area/crew_quarters/bar)
"Ce" = (/obj/machinery/door/firedoor/border_only,/obj/machinery/door/firedoor/border_only{dir = 1},/obj/machinery/door/airlock/public/glass{color = "#7c4a14"; name = "Diner"},/turf/open/floor/bronze,/area/crew_quarters/bar)
"Ci" = (/obj/structure/sign/barsign,/turf/closed/wall/clockwork,/area/crew_quarters/bar)
"Dn" = (/obj/structure/disposalpipe/segment,/obj/effect/landmark/xeno_spawn,/obj/machinery/atmospherics/pipe/simple/scrubbers/hidden/layer3{dir = 9},/obj/machinery/atmospherics/pipe/simple/supply/hidden/layer1{dir = 5},/turf/open/floor/bronze,/area/crew_quarters/bar)
"Dw" = (/obj/machinery/light{dir = 1},/obj/structure/window/reinforced/clockwork/unanchored{anchored = 1; dir = 4},/obj/machinery/door/firedoor/border_only{dir = 4},/turf/open/floor/clockwork/reebe,/area/crew_quarters/theatre)
"DG" = (/obj/item/reagent_containers/food/drinks/shaker,/obj/item/stack/spacecash/c10,/obj/item/stack/spacecash/c100,/obj/structure/table/reinforced/brass,/obj/item/clothing/head/bronze,/obj/item/clothing/shoes/bronze,/obj/item/clothing/suit/bronze,/obj/item/toy/clockwork_watch,/turf/open/floor/clockwork/reebe,/area/crew_quarters/bar)
"DR" = (/obj/structure/disposalpipe/segment,/turf/open/floor/bronze,/area/crew_quarters/kitchen)
"Ef" = (/obj/machinery/door/firedoor/border_only,/obj/structure/window/reinforced/clockwork/unanchored{anchored = 1},/obj/item/clockwork/alloy_shards/medium,/turf/open/floor/clockwork/reebe,/area/crew_quarters/theatre)
"EY" = (/obj/structure/disposalpipe/segment,/obj/machinery/atmospherics/pipe/simple/supply/hidden/layer1,/obj/machinery/atmospherics/pipe/simple/scrubbers/hidden/layer3,/turf/open/floor/bronze,/area/crew_quarters/kitchen)
"Fs" = (/obj/effect/landmark/start/assistant,/obj/machinery/atmospherics/pipe/simple/scrubbers/hidden/layer3{dir = 5},/obj/machinery/atmospherics/pipe/simple/supply/hidden/layer1{dir = 6},/turf/open/floor/bronze,/area/crew_quarters/bar)
"Gv" = (/turf/closed/wall,/area/crew_quarters/bar)
"GY" = (/obj/structure/disposalpipe/segment,/obj/machinery/atmospherics/pipe/simple/supply/hidden/layer1,/obj/machinery/atmospherics/pipe/simple/scrubbers/hidden/layer3,/obj/machinery/door/firedoor/border_only,/obj/machinery/door/firedoor/border_only{dir = 1},/obj/machinery/door/airlock{name = "Kitchen cold room"; req_access_txt = "28"},/turf/open/floor/plasteel/showroomfloor,/area/crew_quarters/kitchen)
"Hp" = (/obj/machinery/atmospherics/pipe/simple/supply/hidden/layer1,/obj/machinery/atmospherics/pipe/simple/scrubbers/hidden/layer3,/turf/open/floor/bronze,/area/crew_quarters/bar)
"Ig" = (/obj/structure/closet/secure_closet/freezer/kitchen,/turf/open/floor/clockwork/reebe,/area/crew_quarters/kitchen)
"Jv" = (/obj/structure/disposalpipe/segment,/obj/machinery/door/firedoor/border_only,/obj/machinery/door/firedoor/border_only{dir = 1},/obj/machinery/door/airlock{color = "#7f590f"; name = "Bar Storage"; req_access_txt = "25"},/turf/open/floor/bronze,/area/crew_quarters/bar)
"Kk" = (/obj/machinery/vending/coffee,/turf/open/floor/clockwork/reebe,/area/crew_quarters/bar)
"Ku" = (/obj/structure/window/reinforced/clockwork/unanchored{anchored = 1; dir = 4},/obj/machinery/door/firedoor/border_only{dir = 4},/turf/open/floor/clockwork/reebe,/area/crew_quarters/theatre)
"KD" = (/obj/machinery/computer/security/telescreen/entertainment{pixel_x = 32},/obj/item/book/manual/wiki/barman_recipes,/obj/item/reagent_containers/glass/rag,/obj/structure/table/reinforced/brass,/turf/open/floor/clockwork/reebe,/area/crew_quarters/bar)
"KI" = (/obj/machinery/vending/dinnerware,/turf/open/floor/clockwork/reebe,/area/crew_quarters/kitchen)
"Lr" = (/obj/structure/disposalpipe/segment,/obj/machinery/atmospherics/pipe/simple/scrubbers/hidden/layer3,/obj/machinery/atmospherics/pipe/simple/supply/hidden/layer1,/turf/open/floor/bronze,/area/crew_quarters/bar)
"LL" = (/obj/structure/disposalpipe/segment{dir = 9},/turf/open/floor/bronze,/area/crew_quarters/bar)
"LY" = (/obj/machinery/door/window/westright{color = "#b5924d"; dir = 2},/turf/open/floor/clockwork/reebe,/area/crew_quarters/bar)
"Mg" = (/obj/effect/landmark/start/cook,/turf/open/floor/bronze,/area/crew_quarters/kitchen)
"Nc" = (/obj/item/clockwork/component/geis_capacitor/fallen_armor,/turf/open/floor/bronze,/area/crew_quarters/bar)
"Nu" = (/obj/item/reagent_containers/food/snacks/pie/cream,/obj/structure/table/reinforced/brass,/obj/machinery/door/firedoor/border_only{dir = 4},/obj/machinery/door/firedoor/border_only{dir = 8},/obj/machinery/door/window/westright{color = "#b5924d"},/turf/open/floor/clockwork/reebe,/area/crew_quarters/kitchen)
"Ny" = (/turf/closed/wall/clockwork,/area/crew_quarters/kitchen)
"NA" = (/obj/machinery/atmospherics/pipe/manifold/scrubbers/hidden/layer3{dir = 4},/obj/machinery/atmospherics/pipe/manifold/supply/hidden/layer1{dir = 8},/turf/open/floor/bronze,/area/crew_quarters/theatre)
"Om" = (/obj/structure/window/reinforced/clockwork/fulltile,/obj/structure/grille/ratvar,/obj/machinery/door/poddoor/preopen{id = "barShutters"; name = "privacy shutters"},/turf/open/floor/plating,/area/crew_quarters/bar)
"Ou" = (/obj/structure/chair/bronze,/turf/open/floor/clockwork/reebe,/area/crew_quarters/bar)
"OF" = (/turf/closed/wall,/area/crew_quarters/theatre)
"PF" = (/obj/structure/disposalpipe/segment{dir = 5},/turf/open/floor/bronze,/area/crew_quarters/bar)
"PI" = (/obj/effect/landmark/event_spawn,/turf/closed/wall/clockwork,/area/crew_quarters/bar)
"PR" = (/obj/machinery/disposal/bin,/obj/structure/disposalpipe/trunk{dir = 8},/obj/machinery/firealarm{dir = 2; pixel_y = 26},/turf/open/floor/bronze,/area/crew_quarters/bar)
"Qn" = (/obj/structure/sink/kitchen{pixel_y = 28},/obj/machinery/food_cart,/turf/open/floor/clockwork/reebe,/area/crew_quarters/kitchen)
"QD" = (/obj/structure/table/reinforced/brass,/obj/item/kitchen/fork,/turf/open/floor/clockwork/reebe,/area/crew_quarters/bar)
"QO" = (/obj/item/kitchen/rollingpin,/obj/structure/table/reinforced/brass,/turf/open/floor/bronze,/area/crew_quarters/kitchen)
"Re" = (/obj/structure/extinguisher_cabinet{pixel_y = -30},/turf/open/floor/bronze,/area/crew_quarters/bar)
"Rh" = (/obj/machinery/airalarm{dir = 1; pixel_y = -24},/turf/open/floor/bronze,/area/crew_quarters/bar)
"Rk" = (/obj/item/reagent_containers/food/snacks/mint,/obj/structure/table/reinforced/brass,/turf/open/floor/bronze,/area/crew_quarters/kitchen)
"Rt" = (/obj/item/clockwork/alloy_shards/small,/turf/open/floor/bronze,/area/crew_quarters/bar)
"RX" = (/obj/item/clockwork/alloy_shards/clockgolem_remains,/turf/open/floor/clockwork/reebe,/area/crew_quarters/theatre)
"Se" = (/obj/machinery/microwave{pixel_x = -3; pixel_y = 6},/obj/structure/table/reinforced/brass,/turf/open/floor/clockwork/reebe,/area/crew_quarters/kitchen)
"Sz" = (/mob/living/carbon/monkey/punpun,/turf/open/floor/clockwork/reebe,/area/crew_quarters/bar)
"SD" = (/obj/structure/disposalpipe/segment{dir = 5},/obj/machinery/atmospherics/pipe/simple/supply/hidden/layer1{dir = 5},/obj/machinery/atmospherics/pipe/simple/scrubbers/hidden/layer3{dir = 9},/turf/open/floor/bronze,/area/crew_quarters/kitchen)
"SG" = (/turf/open/floor/clockwork/reebe,/area/crew_quarters/kitchen)
"Tq" = (/obj/structure/extinguisher_cabinet{pixel_x = -5; pixel_y = 30},/turf/open/floor/clockwork/reebe,/area/crew_quarters/kitchen)
"Uh" = (/obj/effect/landmark/start/assistant,/obj/structure/chair/bronze,/turf/open/floor/clockwork/reebe,/area/crew_quarters/bar)
"Ul" = (/obj/machinery/atmospherics/pipe/simple/supply/hidden/layer1{dir = 4},/obj/machinery/atmospherics/pipe/simple/scrubbers/hidden/layer3{dir = 4},/obj/structure/chair/bronze,/turf/open/floor/bronze,/area/crew_quarters/bar)
"Un" = (/obj/item/clockwork/alloy_shards,/turf/open/floor/bronze,/area/crew_quarters/bar)
"Uv" = (/obj/effect/landmark/start/cook,/obj/machinery/atmospherics/components/unary/vent_scrubber/on/layer3{dir = 4; icon_state = "scrub_map_on-3"},/turf/open/floor/bronze,/area/crew_quarters/kitchen)
"UP" = (/obj/machinery/light_switch{pixel_y = -25},/turf/open/floor/clockwork/reebe,/area/crew_quarters/kitchen)
"Vk" = (/obj/machinery/vending/cigarette,/turf/open/floor/bronze,/area/crew_quarters/bar)
"Wo" = (/obj/machinery/disposal/bin,/obj/structure/sign/warning/securearea{desc = "Under the painting a plaque reads: 'While the meat grinder may not have spared you, fear not. Not one part of you has gone to waste... You were delicious.'"; icon_state = "monkey_painting"; name = "Mr. Deempisi portrait"; pixel_x = -28; pixel_y = -4},/obj/structure/disposalpipe/trunk{dir = 4},/obj/machinery/button/door{id = "barShutters"; name = "bar shutters"; pixel_x = 4; pixel_y = 28},/obj/machinery/light{dir = 8},/turf/open/floor/bronze,/area/crew_quarters/bar)
"Wx" = (/turf/open/floor/bronze,/area/crew_quarters/bar)
"Xg" = (/obj/machinery/atmospherics/pipe/simple/supply/hidden/layer1,/obj/machinery/atmospherics/pipe/simple/scrubbers/hidden/layer3,/turf/open/floor/bronze,/area/crew_quarters/theatre)
"Yy" = (/obj/item/radio/intercom{pixel_y = 25},/obj/machinery/camera{c_tag = "Theatre Stage"; dir = 2},/turf/open/floor/clockwork/reebe,/area/crew_quarters/theatre)
"YF" = (/obj/machinery/atmospherics/components/unary/vent_scrubber/on/layer3,/turf/open/floor/bronze,/area/crew_quarters/bar)
"YU" = (/obj/machinery/atmospherics/pipe/simple/supply/hidden/layer1{dir = 4},/obj/machinery/atmospherics/pipe/simple/scrubbers/hidden/layer3{dir = 4},/obj/machinery/door/firedoor/border_only{dir = 4},/obj/machinery/door/window/westright{color = "#b5924d"; dir = 4},/turf/open/floor/bronze,/area/crew_quarters/theatre)
"ZN" = (/turf/open/floor/clockwork/reebe,/area/crew_quarters/bar)

(1,1,1) = {"
aaaaaaOFabOFOFOFGvadGvqZDGLrzEGvakalalaialaoalaa
aaaaaalkXgxHYyDwWxPFPRqZoiLrZNjinpalaCanapaFalaa
dGaeafagNAajRXKuRtWxaqqZobDnsvmIKkalaSanaLaUalal
izarasasbnkdkdYUawaxayqZddcUosqZqZalbgaWaXbtaYal
dGazaAEfaAaArEoLWxHpaqqZqZJvqZqZcKalbqaZbabtbual
OmNcWxWxWxWxWxWxWxHpZNqZWoLLzaNyalalalGYalalalal
PIxrZNUhZNWxbUOuZNHpBeoEZNZNuFNyKIQnTqEYpZkNSeIg
jNWxBeQDxWWxBerpxWHpBeeZZNSzZNfmSGeuUvSDpAtFfTSG
qZWxWxwFWxYFWxwFWxHpBehHvTZNhsNySGeuRkwYQOqDDRSG
jNWxWxvqWxFsawUlawlwBehHZNZNZNNuSGeuxIdCePePDRki
qZxrBehHxWkBBeklxWWxBehHhHLYKDNySGeueuMgeueuDRAq
jNWxZNrwZNWxZNrwaJWxZNlIdvZNZNAPUPoCSGSGvdSGtQhG
qZdiVkWxrRWxWxWxrRWxWxReRhrRUnNyNyNyiRoVoVoVNyNy
qZqZqZqZqZCejNCeCiqZqZqZqZqZqZNyaaaaaaaaaaaaaaaa
"}
