//MAP CONVERTED BY dmm2tgm.py THIS HEADER COMMENT PREVENTS RECONVERSION, DO NOT REMOVE
"aa" = (
/turf/template_noop,
/area/template_noop)
"ab" = (
/obj/machinery/door/airlock{
	name = "Theatre Backstage";
	req_access_txt = "46"
	},
/obj/machinery/atmospherics/pipe/simple/supply/hidden/layer1,
/obj/machinery/atmospherics/pipe/simple/scrubbers/hidden/layer3,
/obj/machinery/door/firedoor/border_only{
	dir = 1
	},
/obj/machinery/door/firedoor/border_only,
/turf/open/floor/plasteel,
/area/crew_quarters/theatre)
"ad" = (
/obj/machinery/door/airlock/maintenance{
	name = "Bar Maintenance";
	req_access_txt = "12"
	},
/obj/structure/disposalpipe/segment,
/obj/machinery/door/firedoor/border_only,
/obj/machinery/door/firedoor/border_only{
	dir = 1
	},
/turf/open/floor/plating,
/area/maintenance/starboard/fore)
"ai" = (
/obj/machinery/door/airlock/maintenance{
	name = "Kitchen Maintenance";
	req_access_txt = "28"
	},
/obj/structure/disposalpipe/segment,
/obj/machinery/atmospherics/pipe/simple/supply/hidden/layer1,
/obj/machinery/atmospherics/pipe/simple/scrubbers/hidden/layer3,
/obj/machinery/door/firedoor/border_only{
	dir = 1
	},
/obj/machinery/door/firedoor/border_only,
/turf/open/floor/plating,
/area/maintenance/starboard/fore)
"ak" = (
/obj/machinery/door/window/southleft{
	base_state = "left";
	dir = 2;
	icon_state = "left";
	name = "Bar Delivery";
	req_access_txt = "25"
	},
/obj/effect/turf_decal/delivery,
/turf/open/floor/plasteel,
/area/crew_quarters/bar)
"al" = (
/turf/closed/wall,
/area/crew_quarters/kitchen)
"an" = (
/obj/structure/disposalpipe/segment,
/obj/machinery/atmospherics/pipe/simple/supply/hidden/layer1,
/obj/machinery/atmospherics/pipe/simple/scrubbers/hidden/layer3,
/turf/open/floor/plasteel/showroomfloor,
/area/crew_quarters/kitchen)
"ao" = (
/obj/machinery/navbeacon{
	codes_txt = "delivery;dir=2";
	freq = 1400;
	location = "Kitchen"
	},
/obj/structure/plasticflaps{
	opacity = 1
	},
/obj/effect/turf_decal/bot{
	dir = 2
	},
/turf/open/floor/plasteel{
	dir = 2
	},
/area/crew_quarters/kitchen)
"ap" = (
/obj/machinery/camera{
	c_tag = "Kitchen Cold Room"
	},
/obj/structure/reagent_dispensers/cooking_oil,
/turf/open/floor/plasteel/showroomfloor,
/area/crew_quarters/kitchen)
"as" = (
/obj/machinery/door/firedoor/border_only,
/obj/structure/window/reinforced/clockwork/unanchored{
	anchored = 1
	},
/turf/open/floor/bronze/reebe,
/area/crew_quarters/theatre)
"aw" = (
/obj/machinery/atmospherics/pipe/simple/supply/hidden/layer1{
	dir = 4
	},
/obj/machinery/atmospherics/pipe/simple/scrubbers/hidden/layer3{
	dir = 4
	},
/turf/open/floor/bronze,
/area/crew_quarters/bar)
"ax" = (
/obj/machinery/atmospherics/pipe/simple/supply/hidden/layer1{
	dir = 10
	},
/obj/machinery/atmospherics/pipe/simple/scrubbers/hidden/layer3{
	dir = 10
	},
/turf/open/floor/bronze,
/area/crew_quarters/bar)
"aC" = (
/obj/structure/closet/secure_closet/freezer/meat,
/turf/open/floor/plasteel/showroomfloor,
/area/crew_quarters/kitchen)
"aD" = (
/obj/machinery/processor,
/obj/machinery/firealarm{
	dir = 8;
	pixel_x = 26;
	pixel_y = 0
	},
/turf/open/floor/bronze/reebe,
/area/crew_quarters/kitchen)
"aE" = (
/obj/item/clockwork/alloy_shards/small,
/turf/open/floor/bronze/reebe,
/area/crew_quarters/bar)
"aF" = (
/obj/machinery/door/window/southleft{
	base_state = "left";
	dir = 2;
	icon_state = "left";
	name = "Kitchen Delivery";
	req_access_txt = "28"
	},
/obj/effect/turf_decal/delivery,
/obj/structure/window/reinforced{
	dir = 8
	},
/turf/open/floor/plasteel,
/area/crew_quarters/kitchen)
"aI" = (
/obj/machinery/light_switch{
	pixel_y = 28
	},
/obj/machinery/light{
	dir = 1
	},
/turf/open/floor/bronze/reebe,
/area/crew_quarters/theatre)
"aL" = (
/obj/machinery/chem_master/condimaster{
	name = "CondiMaster Neo"
	},
/turf/open/floor/plasteel/showroomfloor,
/area/crew_quarters/kitchen)
"aS" = (
/obj/machinery/icecream_vat,
/turf/open/floor/plasteel/showroomfloor,
/area/crew_quarters/kitchen)
"aU" = (
/obj/effect/turf_decal/loading_area,
/turf/open/floor/plasteel/showroomfloor,
/area/crew_quarters/kitchen)
"aW" = (
/obj/structure/disposalpipe/segment,
/obj/machinery/atmospherics/pipe/simple/supply/hidden/layer1,
/obj/machinery/atmospherics/pipe/manifold/scrubbers/hidden/layer3{
	dir = 8
	},
/turf/open/floor/plasteel/showroomfloor,
/area/crew_quarters/kitchen)
"aX" = (
/obj/machinery/atmospherics/components/unary/vent_scrubber/on/layer3{
	dir = 8;
	icon_state = "scrub_map_on-3"
	},
/obj/effect/spawner/lootdrop/mob/kitchen_animal,
/turf/open/floor/plasteel/showroomfloor,
/area/crew_quarters/kitchen)
"aY" = (
/obj/machinery/light/small{
	dir = 4
	},
/obj/machinery/airalarm{
	dir = 8;
	pixel_x = 24
	},
/obj/machinery/vending/wardrobe/chef_wardrobe,
/turf/open/floor/plasteel/showroomfloor,
/area/crew_quarters/kitchen)
"aZ" = (
/obj/structure/disposalpipe/segment,
/obj/machinery/atmospherics/pipe/simple/scrubbers/hidden/layer3,
/obj/machinery/atmospherics/pipe/manifold/supply/hidden/layer1{
	dir = 8
	},
/turf/open/floor/plasteel/showroomfloor,
/area/crew_quarters/kitchen)
"ba" = (
/obj/machinery/atmospherics/components/unary/vent_pump/on/layer1{
	dir = 8;
	icon_state = "vent_map_on-1"
	},
/turf/open/floor/plasteel/showroomfloor,
/area/crew_quarters/kitchen)
"bd" = (
/obj/machinery/light,
/turf/open/floor/bronze/reebe,
/area/crew_quarters/kitchen)
"bg" = (
/obj/structure/kitchenspike,
/obj/machinery/light/small{
	dir = 8
	},
/turf/open/floor/plasteel/showroomfloor,
/area/crew_quarters/kitchen)
"bq" = (
/obj/structure/kitchenspike,
/turf/open/floor/plasteel/showroomfloor,
/area/crew_quarters/kitchen)
"bt" = (
/turf/open/floor/plasteel/showroomfloor,
/area/crew_quarters/kitchen)
"bu" = (
/obj/machinery/gibber,
/turf/open/floor/plasteel/showroomfloor,
/area/crew_quarters/kitchen)
"ca" = (
/obj/machinery/vending/wardrobe/bar_wardrobe,
/turf/open/floor/bronze/reebe,
/area/crew_quarters/bar)
"cy" = (
/obj/item/storage/box/fancy/donut_box,
/obj/machinery/door/firedoor,
/obj/machinery/door/poddoor/shutters/preopen{
	id = "kitchen";
	name = "kitchen shutters"
	},
/obj/structure/table/reinforced/brass,
/turf/open/floor/bronze/reebe,
/area/crew_quarters/kitchen)
"cZ" = (
/obj/machinery/microwave{
	pixel_x = -3;
	pixel_y = 6
	},
/obj/machinery/airalarm{
	pixel_y = 24
	},
/obj/machinery/light{
	dir = 1
	},
/obj/structure/table/reinforced/brass,
/turf/open/floor/bronze/reebe,
/area/crew_quarters/kitchen)
"di" = (
/obj/machinery/computer/arcade,
/turf/open/floor/bronze,
/area/crew_quarters/bar)
"dp" = (
/obj/structure/chair/bronze{
	dir = 8
	},
/turf/open/floor/bronze/reebe,
/area/crew_quarters/bar)
"dw" = (
/obj/structure/chair/bronze,
/turf/open/floor/bronze,
/area/crew_quarters/bar)
"dC" = (
/obj/item/storage/box/donkpockets{
	pixel_x = 3;
	pixel_y = 3
	},
/obj/item/reagent_containers/glass/beaker{
	pixel_x = 5
	},
/obj/structure/table/reinforced/brass,
/turf/open/floor/bronze,
/area/crew_quarters/kitchen)
"dG" = (
/turf/closed/wall/clockwork,
/area/crew_quarters/theatre)
"dU" = (
/obj/structure/extinguisher_cabinet{
	pixel_x = -5;
	pixel_y = 30
	},
/turf/open/floor/bronze/reebe,
/area/crew_quarters/kitchen)
"eu" = (
/turf/open/floor/bronze,
/area/crew_quarters/kitchen)
"eK" = (
/obj/machinery/light{
	dir = 1
	},
/obj/structure/window/reinforced/clockwork/unanchored{
	anchored = 1;
	dir = 4
	},
/obj/machinery/door/firedoor/border_only{
	dir = 4
	},
/turf/open/floor/bronze/reebe,
/area/crew_quarters/theatre)
"eP" = (
/obj/machinery/deepfryer,
/turf/open/floor/bronze,
/area/crew_quarters/kitchen)
"fh" = (
/obj/item/clockwork/alloy_shards/clockgolem_remains,
/turf/open/floor/bronze/reebe,
/area/crew_quarters/theatre)
"fM" = (
/obj/structure/table/reinforced/brass,
/obj/item/kitchen/fork,
/turf/open/floor/bronze/reebe,
/area/crew_quarters/bar)
"fT" = (
/obj/structure/disposalpipe/segment{
	dir = 10
	},
/turf/open/floor/bronze,
/area/crew_quarters/kitchen)
"gC" = (
/obj/structure/disposalpipe/segment,
/obj/machinery/door/firedoor/border_only,
/obj/machinery/door/firedoor/border_only{
	dir = 1
	},
/obj/machinery/door/airlock{
	icon = 'icons/obj/doors/airlocks/clockwork/pinion_airlock.dmi';
	name = "Bar Storage";
	req_access_txt = "25"
	},
/turf/open/floor/bronze,
/area/crew_quarters/bar)
"hl" = (
/obj/machinery/light/small{
	dir = 4
	},
/turf/open/floor/bronze/reebe,
/area/crew_quarters/bar)
"hA" = (
/obj/machinery/door/window/southright{
	color = "#b5924d";
	name = "Bar Door";
	req_one_access_txt = "25;28"
	},
/turf/open/floor/bronze/reebe,
/area/crew_quarters/bar)
"ih" = (
/obj/machinery/reagentgrinder,
/obj/structure/table/reinforced/brass,
/turf/open/floor/bronze/reebe,
/area/crew_quarters/bar)
"iz" = (
/obj/structure/window/reinforced/clockwork/fulltile,
/obj/structure/grille/ratvar,
/obj/machinery/door/poddoor/preopen{
	id = "barShutters";
	name = "privacy shutters"
	},
/turf/open/floor/plating,
/area/crew_quarters/theatre)
"iI" = (
/obj/machinery/chem_dispenser/drinks/beer{
	dir = 8
	},
/obj/item/radio/intercom{
	pixel_y = 25
	},
/obj/machinery/firealarm{
	dir = 8;
	pixel_x = 26;
	pixel_y = 0
	},
/obj/structure/table/reinforced/brass,
/turf/open/floor/bronze/reebe,
/area/crew_quarters/bar)
"jy" = (
/obj/structure/chair/bronze{
	dir = 1
	},
/turf/open/floor/bronze,
/area/crew_quarters/bar)
"jN" = (
/obj/machinery/door/poddoor/preopen{
	id = "barShutters";
	name = "privacy shutters"
	},
/obj/structure/window/reinforced/clockwork/fulltile,
/obj/structure/grille/ratvar,
/turf/open/floor/plating,
/area/crew_quarters/bar)
"kN" = (
/obj/machinery/reagentgrinder,
/obj/machinery/requests_console{
	department = "Kitchen";
	departmentType = 2;
	pixel_x = 30
	},
/obj/structure/table/reinforced/brass,
/turf/open/floor/bronze/reebe,
/area/crew_quarters/kitchen)
"lw" = (
/obj/machinery/atmospherics/pipe/simple/scrubbers/hidden/layer3{
	dir = 9
	},
/obj/machinery/atmospherics/pipe/simple/supply/hidden/layer1{
	dir = 9
	},
/turf/open/floor/bronze,
/area/crew_quarters/bar)
"mr" = (
/obj/machinery/door/firedoor/border_only{
	dir = 4
	},
/obj/machinery/door/firedoor/border_only{
	dir = 8
	},
/obj/structure/table/reinforced/brass,
/obj/machinery/door/window/eastleft{
	color = "#b5924d";
	dir = 8
	},
/turf/open/floor/bronze/reebe,
/area/crew_quarters/kitchen)
"nh" = (
/obj/structure/table/reinforced/brass,
/obj/item/reagent_containers/food/condiment/peppermill{
	pixel_x = 5;
	pixel_y = -2
	},
/obj/item/reagent_containers/food/condiment/saltshaker{
	pixel_x = -2;
	pixel_y = 2
	},
/turf/open/floor/bronze/reebe,
/area/crew_quarters/bar)
"ni" = (
/obj/structure/table/reinforced/brass,
/obj/machinery/light{
	dir = 4
	},
/obj/item/clothing/head/bronze,
/obj/item/clothing/shoes/bronze,
/obj/item/clothing/suit/bronze,
/obj/item/toy/clockwork_watch,
/turf/open/floor/bronze/reebe,
/area/crew_quarters/bar)
"nu" = (
/obj/item/clockwork/alloy_shards,
/turf/open/floor/bronze,
/area/crew_quarters/bar)
"nC" = (
/obj/machinery/atmospherics/pipe/simple/supply/hidden/layer1{
	dir = 4
	},
/obj/machinery/atmospherics/pipe/simple/scrubbers/hidden/layer3{
	dir = 4
	},
/obj/machinery/door/firedoor/border_only{
	dir = 4
	},
/obj/machinery/door/window/eastleft{
	color = "#b5924d"
	},
/turf/open/floor/bronze,
/area/crew_quarters/theatre)
"nF" = (
/turf/closed/wall,
/area/crew_quarters/theatre)
"op" = (
/obj/structure/table/reinforced/brass,
/turf/open/floor/bronze/reebe,
/area/crew_quarters/bar)
"pA" = (
/obj/structure/disposalpipe/segment{
	dir = 4
	},
/obj/machinery/atmospherics/components/unary/vent_pump/on/layer1{
	dir = 8;
	icon_state = "vent_map_on-1"
	},
/turf/open/floor/bronze,
/area/crew_quarters/kitchen)
"qf" = (
/turf/open/floor/bronze/reebe,
/area/crew_quarters/kitchen)
"qD" = (
/obj/item/book/manual/chef_recipes,
/obj/item/book/manual/wiki/cooking_to_serve_man{
	pixel_x = -4;
	pixel_y = 4
	},
/obj/structure/table/reinforced/brass,
/turf/open/floor/bronze,
/area/crew_quarters/kitchen)
"qV" = (
/obj/item/radio/intercom{
	pixel_y = 25
	},
/obj/machinery/camera{
	c_tag = "Theatre Stage";
	dir = 2
	},
/turf/open/floor/bronze/reebe,
/area/crew_quarters/theatre)
"qZ" = (
/turf/closed/wall/clockwork,
/area/crew_quarters/bar)
"rl" = (
/obj/machinery/atmospherics/components/unary/vent_pump/on/layer1{
	dir = 8;
	icon_state = "vent_map_on-1"
	},
/turf/open/floor/bronze/reebe,
/area/crew_quarters/bar)
"rB" = (
/obj/machinery/atmospherics/pipe/manifold/scrubbers/hidden/layer3{
	dir = 4
	},
/obj/machinery/atmospherics/pipe/manifold/supply/hidden/layer1{
	dir = 8
	},
/turf/open/floor/bronze,
/area/crew_quarters/theatre)
"rR" = (
/obj/machinery/light,
/turf/open/floor/bronze,
/area/crew_quarters/bar)
"rY" = (
/obj/machinery/airalarm{
	dir = 2;
	pixel_y = 24
	},
/turf/open/floor/bronze/reebe,
/area/crew_quarters/theatre)
"se" = (
/obj/machinery/requests_console{
	department = "Bar";
	departmentType = 2;
	pixel_x = 30;
	receive_ore_updates = 1
	},
/obj/machinery/camera{
	c_tag = "Bar";
	dir = 8
	},
/obj/machinery/chem_dispenser/drinks{
	dir = 8
	},
/obj/structure/table/reinforced/brass,
/obj/machinery/light{
	dir = 4
	},
/turf/open/floor/bronze/reebe,
/area/crew_quarters/bar)
"sn" = (
/obj/structure/sink/kitchen{
	pixel_y = 28
	},
/obj/machinery/food_cart,
/turf/open/floor/bronze/reebe,
/area/crew_quarters/kitchen)
"sv" = (
/obj/machinery/airalarm{
	dir = 4;
	pixel_x = -24
	},
/obj/machinery/light/small{
	dir = 8
	},
/obj/structure/reagent_dispensers/beerkeg,
/obj/machinery/atmospherics/components/unary/vent_scrubber/on/layer3{
	dir = 4;
	icon_state = "scrub_map_on-3"
	},
/turf/open/floor/bronze/reebe,
/area/crew_quarters/bar)
"sG" = (
/obj/item/lighter,
/obj/structure/table/reinforced/brass,
/turf/open/floor/bronze/reebe,
/area/crew_quarters/bar)
"tz" = (
/obj/effect/landmark/start/assistant,
/obj/structure/chair/bronze,
/turf/open/floor/bronze/reebe,
/area/crew_quarters/bar)
"tF" = (
/obj/structure/disposalpipe/segment{
	dir = 4
	},
/turf/open/floor/bronze,
/area/crew_quarters/kitchen)
"ud" = (
/obj/machinery/door/firedoor/border_only,
/obj/structure/window/reinforced/clockwork/unanchored{
	anchored = 1
	},
/obj/structure/window/reinforced/clockwork/unanchored{
	anchored = 1
	},
/turf/open/floor/bronze/reebe,
/area/crew_quarters/theatre)
"uS" = (
/obj/machinery/door/firedoor,
/obj/machinery/door/poddoor/shutters/preopen{
	id = "kitchen";
	name = "kitchen shutters"
	},
/obj/structure/table/reinforced/brass,
/turf/open/floor/bronze/reebe,
/area/crew_quarters/kitchen)
"uX" = (
/obj/machinery/camera{
	c_tag = "Bar Storage"
	},
/turf/open/floor/bronze/reebe,
/area/crew_quarters/bar)
"wa" = (
/obj/machinery/atmospherics/pipe/simple/supply/hidden/layer1,
/obj/machinery/atmospherics/pipe/simple/scrubbers/hidden/layer3,
/turf/open/floor/bronze,
/area/crew_quarters/theatre)
"wb" = (
/obj/item/reagent_containers/food/snacks/pie/cream,
/obj/structure/table/reinforced/brass,
/obj/machinery/door/firedoor/border_only{
	dir = 4
	},
/obj/machinery/door/firedoor/border_only{
	dir = 8
	},
/obj/machinery/door/window/eastleft{
	color = "#b5924d";
	dir = 8
	},
/turf/open/floor/bronze/reebe,
/area/crew_quarters/kitchen)
"wY" = (
/obj/item/reagent_containers/food/condiment/saltshaker{
	pixel_x = -3
	},
/obj/item/reagent_containers/food/condiment/peppermill{
	pixel_x = 3
	},
/obj/structure/table/reinforced/brass,
/turf/open/floor/bronze,
/area/crew_quarters/kitchen)
"xh" = (
/obj/structure/piano,
/obj/machinery/light{
	dir = 8
	},
/turf/open/floor/bronze/reebe,
/area/crew_quarters/theatre)
"xr" = (
/obj/machinery/light{
	dir = 8
	},
/turf/open/floor/bronze,
/area/crew_quarters/bar)
"xE" = (
/obj/effect/landmark/start/assistant,
/obj/structure/chair/bronze{
	dir = 1
	},
/turf/open/floor/bronze/reebe,
/area/crew_quarters/bar)
"xF" = (
/obj/item/clockwork/alloy_shards/clockgolem_remains,
/turf/open/floor/bronze/reebe,
/area/crew_quarters/bar)
"xI" = (
/obj/item/reagent_containers/food/condiment/enzyme{
	layer = 5
	},
/obj/item/stack/packageWrap,
/obj/structure/table/reinforced/brass,
/turf/open/floor/bronze,
/area/crew_quarters/kitchen)
"yl" = (
/obj/structure/disposalpipe/segment,
/obj/machinery/atmospherics/pipe/simple/supply/hidden/layer1,
/obj/machinery/atmospherics/pipe/simple/scrubbers/hidden/layer3,
/obj/machinery/door/firedoor/border_only,
/obj/machinery/door/firedoor/border_only{
	dir = 1
	},
/obj/machinery/door/airlock{
	name = "Kitchen cold room";
	req_access_txt = "28"
	},
/turf/open/floor/plasteel/showroomfloor,
/area/crew_quarters/kitchen)
"zn" = (
/obj/effect/landmark/event_spawn,
/turf/open/floor/bronze/reebe,
/area/crew_quarters/kitchen)
"zA" = (
/obj/machinery/atmospherics/components/unary/vent_pump/on/layer1{
	dir = 8;
	icon_state = "vent_map_on-1"
	},
/turf/open/floor/bronze/reebe,
/area/crew_quarters/theatre)
"AS" = (
/obj/structure/disposalpipe/segment,
/turf/open/floor/bronze,
/area/crew_quarters/bar)
"Bl" = (
/obj/structure/disposalpipe/segment,
/obj/machinery/atmospherics/pipe/simple/supply/hidden/layer1,
/obj/machinery/atmospherics/pipe/simple/scrubbers/hidden/layer3,
/turf/open/floor/bronze,
/area/crew_quarters/kitchen)
"BC" = (
/obj/machinery/door/firedoor/border_only{
	dir = 8
	},
/obj/machinery/door/firedoor/border_only{
	dir = 4
	},
/obj/machinery/door/airlock{
	icon = 'icons/obj/doors/airlocks/clockwork/pinion_airlock.dmi';
	name = "Kitchen";
	req_access_txt = "28"
	},
/turf/open/floor/bronze,
/area/crew_quarters/kitchen)
"Ci" = (
/obj/structure/sign/barsign,
/turf/closed/wall/clockwork,
/area/crew_quarters/bar)
"CD" = (
/obj/machinery/vending/dinnerware,
/turf/open/floor/bronze/reebe,
/area/crew_quarters/kitchen)
"CO" = (
/obj/machinery/atmospherics/pipe/simple/supply/hidden/layer1{
	dir = 4
	},
/obj/machinery/atmospherics/pipe/simple/scrubbers/hidden/layer3{
	dir = 4
	},
/turf/open/floor/bronze,
/area/crew_quarters/theatre)
"DQ" = (
/obj/item/stack/sheet/metal/fifty,
/obj/item/stack/sheet/glass/fifty,
/obj/item/stack/cable_coil,
/obj/item/flashlight/lamp,
/obj/item/flashlight/lamp/green,
/obj/structure/closet/secure_closet/bartender,
/turf/open/floor/bronze/reebe,
/area/crew_quarters/bar)
"DR" = (
/obj/structure/disposalpipe/segment,
/turf/open/floor/bronze,
/area/crew_quarters/kitchen)
"Eb" = (
/obj/structure/table/reinforced/brass,
/obj/item/instrument/trumpet,
/obj/item/instrument/trombone,
/turf/open/floor/bronze/reebe,
/area/crew_quarters/theatre)
"Ej" = (
/turf/closed/wall,
/area/crew_quarters/bar)
"Er" = (
/obj/structure/sink/kitchen{
	pixel_y = 28
	},
/turf/open/floor/bronze/reebe,
/area/crew_quarters/bar)
"Fj" = (
/turf/open/floor/bronze/reebe,
/area/crew_quarters/bar)
"FU" = (
/obj/structure/disposalpipe/segment{
	dir = 5
	},
/obj/machinery/button/door{
	id = "kitchen";
	name = "Kitchen Shutters Control";
	pixel_x = -1;
	pixel_y = -24;
	req_access_txt = "28"
	},
/turf/open/floor/bronze,
/area/crew_quarters/kitchen)
"GG" = (
/obj/machinery/vending/boozeomat,
/turf/open/floor/bronze/reebe,
/area/crew_quarters/bar)
"GL" = (
/obj/item/clockwork/alloy_shards/small,
/turf/open/floor/bronze,
/area/crew_quarters/bar)
"GN" = (
/obj/structure/disposalpipe/segment{
	dir = 9
	},
/turf/open/floor/bronze,
/area/crew_quarters/bar)
"Hp" = (
/obj/machinery/atmospherics/pipe/simple/supply/hidden/layer1,
/obj/machinery/atmospherics/pipe/simple/scrubbers/hidden/layer3,
/turf/open/floor/bronze,
/area/crew_quarters/bar)
"Hw" = (
/obj/structure/disposalpipe/segment,
/obj/machinery/atmospherics/pipe/simple/scrubbers/hidden/layer3,
/obj/machinery/atmospherics/pipe/simple/supply/hidden/layer1,
/turf/open/floor/bronze,
/area/crew_quarters/bar)
"HX" = (
/obj/machinery/atmospherics/components/unary/vent_scrubber/on/layer3,
/turf/open/floor/bronze,
/area/crew_quarters/bar)
"Ia" = (
/obj/machinery/atmospherics/pipe/simple/supply/hidden/layer1{
	dir = 5
	},
/obj/machinery/atmospherics/pipe/simple/scrubbers/hidden/layer3{
	dir = 5
	},
/turf/open/floor/bronze,
/area/crew_quarters/theatre)
"Iq" = (
/obj/machinery/disposal/bin,
/obj/structure/sign/warning/securearea{
	desc = "Under the painting a plaque reads: 'While the meat grinder may not have spared you, fear not. Not one part of you has gone to waste... You were delicious.'";
	icon_state = "monkey_painting";
	name = "Mr. Deempisi portrait";
	pixel_x = -28;
	pixel_y = -4
	},
/obj/structure/disposalpipe/trunk{
	dir = 4
	},
/obj/machinery/button/door{
	id = "barShutters";
	name = "bar shutters";
	pixel_x = 4;
	pixel_y = 28
	},
/obj/machinery/light{
	dir = 8
	},
/turf/open/floor/bronze,
/area/crew_quarters/bar)
"IM" = (
/obj/structure/table/reinforced/brass,
/obj/item/clothing/head/bronze,
/obj/item/clothing/shoes/bronze,
/obj/item/clothing/suit/bronze,
/obj/item/toy/clockwork_watch,
/turf/open/floor/bronze/reebe,
/area/crew_quarters/bar)
"IS" = (
/obj/structure/table/reinforced/brass,
/obj/item/clothing/head/that,
/turf/open/floor/bronze/reebe,
/area/crew_quarters/bar)
"IU" = (
/obj/structure/disposalpipe/segment,
/obj/effect/landmark/xeno_spawn,
/obj/machinery/atmospherics/pipe/simple/scrubbers/hidden/layer3{
	dir = 9
	},
/obj/machinery/atmospherics/pipe/simple/supply/hidden/layer1{
	dir = 5
	},
/turf/open/floor/bronze,
/area/crew_quarters/bar)
"IX" = (
/obj/effect/landmark/event_spawn,
/obj/structure/chair/bronze{
	dir = 1
	},
/turf/open/floor/bronze/reebe,
/area/crew_quarters/bar)
"Ja" = (
/obj/structure/chair/bronze{
	dir = 4
	},
/turf/open/floor/bronze/reebe,
/area/crew_quarters/bar)
"Jl" = (
/obj/structure/chair/bronze,
/turf/open/floor/bronze/reebe,
/area/crew_quarters/bar)
"Kq" = (
/obj/machinery/door/firedoor/border_only,
/obj/structure/window/reinforced/clockwork/unanchored{
	anchored = 1
	},
/obj/structure/table/reinforced/brass,
/obj/item/instrument/saxophone,
/turf/open/floor/bronze/reebe,
/area/crew_quarters/theatre)
"KZ" = (
/obj/structure/closet/secure_closet/bar{
	req_access_txt = "25"
	},
/turf/open/floor/bronze/reebe,
/area/crew_quarters/bar)
"Ly" = (
/obj/structure/window/reinforced/clockwork/unanchored{
	anchored = 1;
	dir = 4
	},
/obj/machinery/door/firedoor/border_only{
	dir = 4
	},
/obj/structure/window/reinforced/clockwork/unanchored{
	anchored = 1
	},
/obj/machinery/door/firedoor/border_only,
/obj/item/clockwork/alloy_shards/medium,
/turf/open/floor/bronze/reebe,
/area/crew_quarters/theatre)
"LL" = (
/obj/machinery/door/firedoor/border_only,
/obj/machinery/door/firedoor/border_only{
	dir = 1
	},
/obj/machinery/door/airlock/public/glass{
	icon = 'icons/obj/doors/airlocks/clockwork/pinion_airlock.dmi';
	name = "Diner"
	},
/turf/open/floor/bronze,
/area/crew_quarters/bar)
"LM" = (
/obj/structure/chair/bronze{
	dir = 1
	},
/turf/open/floor/bronze/reebe,
/area/crew_quarters/bar)
"LO" = (
/obj/machinery/atmospherics/pipe/simple/supply/hidden/layer1{
	dir = 4
	},
/obj/machinery/atmospherics/pipe/simple/scrubbers/hidden/layer3{
	dir = 4
	},
/obj/structure/chair/bronze,
/turf/open/floor/bronze,
/area/crew_quarters/bar)
"Mg" = (
/obj/effect/landmark/start/cook,
/turf/open/floor/bronze,
/area/crew_quarters/kitchen)
"Ml" = (
/obj/machinery/vending/coffee,
/turf/open/floor/bronze/reebe,
/area/crew_quarters/bar)
"MD" = (
/obj/structure/table/reinforced/brass,
/obj/item/toy/plush/plushvar,
/turf/open/floor/bronze/reebe,
/area/crew_quarters/bar)
"Nc" = (
/obj/item/clockwork/component/geis_capacitor/fallen_armor,
/turf/open/floor/bronze,
/area/crew_quarters/bar)
"Nq" = (
/obj/effect/landmark/start/bartender,
/turf/open/floor/bronze/reebe,
/area/crew_quarters/bar)
"Ny" = (
/turf/closed/wall/clockwork,
/area/crew_quarters/kitchen)
"NR" = (
/obj/machinery/microwave{
	pixel_x = -3;
	pixel_y = 6
	},
/obj/structure/table/reinforced/brass,
/turf/open/floor/bronze/reebe,
/area/crew_quarters/kitchen)
"Oj" = (
/obj/item/reagent_containers/food/drinks/shaker,
/obj/item/stack/spacecash/c10,
/obj/item/stack/spacecash/c100,
/obj/structure/table/reinforced/brass,
/obj/item/clothing/head/bronze,
/obj/item/clothing/shoes/bronze,
/obj/item/clothing/suit/bronze,
/obj/item/toy/clockwork_watch,
/turf/open/floor/bronze/reebe,
/area/crew_quarters/bar)
"Om" = (
/obj/structure/window/reinforced/clockwork/fulltile,
/obj/structure/grille/ratvar,
/obj/machinery/door/poddoor/preopen{
	id = "barShutters";
	name = "privacy shutters"
	},
/turf/open/floor/plating,
/area/crew_quarters/bar)
"OI" = (
/obj/machinery/light_switch{
	pixel_y = -25
	},
/turf/open/floor/bronze/reebe,
/area/crew_quarters/kitchen)
"Pf" = (
/mob/living/carbon/monkey/punpun,
/turf/open/floor/bronze/reebe,
/area/crew_quarters/bar)
"PF" = (
/obj/structure/disposalpipe/segment{
	dir = 5
	},
/turf/open/floor/bronze,
/area/crew_quarters/bar)
"PI" = (
/obj/effect/landmark/event_spawn,
/turf/closed/wall/clockwork,
/area/crew_quarters/bar)
"PR" = (
/obj/machinery/disposal/bin,
/obj/structure/disposalpipe/trunk{
	dir = 8
	},
/obj/machinery/firealarm{
	dir = 2;
	pixel_y = 26
	},
/turf/open/floor/bronze,
/area/crew_quarters/bar)
"QO" = (
/obj/item/kitchen/rollingpin,
/obj/structure/table/reinforced/brass,
/turf/open/floor/bronze,
/area/crew_quarters/kitchen)
"Re" = (
/obj/structure/extinguisher_cabinet{
	pixel_y = -30
	},
/turf/open/floor/bronze,
/area/crew_quarters/bar)
"Rh" = (
/obj/machinery/airalarm{
	dir = 1;
	pixel_y = -24
	},
/turf/open/floor/bronze,
/area/crew_quarters/bar)
"Rk" = (
/obj/item/reagent_containers/food/snacks/mint,
/obj/structure/table/reinforced/brass,
/turf/open/floor/bronze,
/area/crew_quarters/kitchen)
"RK" = (
/turf/open/floor/bronze/reebe,
/area/crew_quarters/theatre)
"Sx" = (
/obj/machinery/computer/security/telescreen/entertainment{
	pixel_x = 32
	},
/obj/item/book/manual/wiki/barman_recipes,
/obj/item/reagent_containers/glass/rag,
/obj/structure/table/reinforced/brass,
/turf/open/floor/bronze/reebe,
/area/crew_quarters/bar)
"SD" = (
/obj/structure/disposalpipe/segment{
	dir = 5
	},
/obj/machinery/atmospherics/pipe/simple/supply/hidden/layer1{
	dir = 5
	},
/obj/machinery/atmospherics/pipe/simple/scrubbers/hidden/layer3{
	dir = 9
	},
/turf/open/floor/bronze,
/area/crew_quarters/kitchen)
"SJ" = (
/obj/machinery/disposal/bin,
/obj/structure/disposalpipe/trunk{
	dir = 8
	},
/turf/open/floor/bronze,
/area/crew_quarters/kitchen)
"Un" = (
/obj/item/radio/intercom{
	pixel_y = 25
	},
/obj/machinery/camera{
	c_tag = "Kitchen";
	dir = 2
	},
/obj/structure/closet/secure_closet/freezer/fridge,
/turf/open/floor/bronze/reebe,
/area/crew_quarters/kitchen)
"Uo" = (
/obj/structure/closet/secure_closet/freezer/kitchen,
/turf/open/floor/bronze/reebe,
/area/crew_quarters/kitchen)
"Uv" = (
/obj/effect/landmark/start/cook,
/obj/machinery/atmospherics/components/unary/vent_scrubber/on/layer3{
	dir = 4;
	icon_state = "scrub_map_on-3"
	},
/turf/open/floor/bronze,
/area/crew_quarters/kitchen)
"Vk" = (
/obj/machinery/vending/cigarette,
/turf/open/floor/bronze,
/area/crew_quarters/bar)
"Vl" = (
/obj/machinery/atmospherics/components/unary/vent_pump/on/layer1{
	dir = 1;
	icon_state = "vent_map_on-1"
	},
/turf/open/floor/bronze,
/area/crew_quarters/bar)
"Vt" = (
/obj/effect/landmark/start/assistant,
/obj/machinery/atmospherics/pipe/simple/scrubbers/hidden/layer3{
	dir = 5
	},
/obj/machinery/atmospherics/pipe/simple/supply/hidden/layer1{
	dir = 6
	},
/turf/open/floor/bronze,
/area/crew_quarters/bar)
"VQ" = (
/obj/machinery/atmospherics/components/unary/vent_scrubber/on/layer3{
	dir = 4;
	icon_state = "scrub_map_on-3"
	},
/turf/open/floor/bronze/reebe,
/area/crew_quarters/theatre)
"Wx" = (
/turf/open/floor/bronze,
/area/crew_quarters/bar)
"XL" = (
/obj/structure/chair/brass{
	dir = 8
	},
/turf/open/floor/bronze/reebe,
/area/crew_quarters/theatre)
"XS" = (
/obj/structure/window/reinforced/clockwork/unanchored{
	anchored = 1;
	dir = 4
	},
/obj/machinery/door/firedoor/border_only{
	dir = 4
	},
/turf/open/floor/bronze/reebe,
/area/crew_quarters/theatre)
"YY" = (
/obj/machinery/door/firedoor/border_only,
/obj/structure/window/reinforced/clockwork/unanchored{
	anchored = 1
	},
/obj/item/clockwork/alloy_shards/medium,
/turf/open/floor/bronze/reebe,
/area/crew_quarters/theatre)
"Zx" = (
/obj/effect/landmark/blobstart,
/obj/item/toy/plush/narplush,
/obj/structure/window/reinforced/clockwork/unanchored{
	anchored = 1;
	dir = 8
	},
/obj/structure/window/reinforced/clockwork/unanchored{
	anchored = 1;
	dir = 4
	},
/obj/structure/window/reinforced/clockwork/unanchored{
	anchored = 1;
	dir = 1
	},
/obj/structure/window/reinforced/clockwork/unanchored{
	anchored = 1
	},
/turf/open/floor/plating,
/area/crew_quarters/bar)

(1,1,1) = {"
aa
aa
dG
iz
dG
Om
PI
jN
qZ
jN
qZ
jN
qZ
qZ
"}
(2,1,1) = {"
aa
aa
xh
Eb
Kq
Nc
xr
Wx
Wx
Wx
xr
Wx
di
qZ
"}
(3,1,1) = {"
aa
aa
XL
RK
as
Wx
Fj
Ja
Wx
Wx
Ja
Fj
Vk
qZ
"}
(4,1,1) = {"
nF
aI
VQ
RK
YY
Wx
tz
fM
jy
dw
op
LM
Wx
qZ
"}
(5,1,1) = {"
ab
wa
rB
Ia
as
Wx
Fj
dp
Wx
Wx
dp
Fj
rR
qZ
"}
(6,1,1) = {"
nF
rY
zA
CO
as
Wx
Wx
Wx
HX
Vt
Vl
Wx
Wx
LL
"}
(7,1,1) = {"
nF
qV
fh
CO
ud
Wx
aE
Ja
Wx
aw
Ja
Fj
Wx
jN
"}
(8,1,1) = {"
nF
eK
XS
nC
Ly
Wx
Jl
MD
jy
LO
nh
LM
Wx
LL
"}
(9,1,1) = {"
Ej
Wx
GL
aw
Wx
Wx
Fj
dp
Wx
aw
dp
xF
rR
Ci
"}
(10,1,1) = {"
ad
PF
Wx
ax
Hp
Hp
Hp
Hp
Hp
lw
Wx
Wx
Wx
qZ
"}
(11,1,1) = {"
Ej
PR
IM
ni
IM
Fj
Ja
Ja
Ja
Ja
Ja
Fj
Wx
qZ
"}
(12,1,1) = {"
qZ
qZ
qZ
qZ
qZ
qZ
sG
IS
op
op
op
xE
Re
qZ
"}
(13,1,1) = {"
Oj
ih
sv
KZ
qZ
Iq
Fj
Fj
Nq
Fj
op
IX
Rh
qZ
"}
(14,1,1) = {"
Hw
Hw
IU
AS
gC
GN
Fj
Pf
Fj
Fj
hA
Fj
rR
qZ
"}
(15,1,1) = {"
Er
Fj
rl
DQ
qZ
iI
GG
Fj
se
Fj
Sx
Fj
nu
qZ
"}
(16,1,1) = {"
Ej
uX
ca
qZ
qZ
Ny
Ny
mr
Ny
wb
Ny
BC
Ny
Ny
"}
(17,1,1) = {"
ak
hl
Ml
qZ
Zx
al
CD
qf
qf
qf
qf
OI
Ny
aa
"}
(18,1,1) = {"
al
al
al
al
al
al
sn
eu
eu
eu
eu
bd
Ny
aa
"}
(19,1,1) = {"
al
aC
aS
bg
bq
al
dU
Uv
Rk
xI
eu
qf
cy
aa
"}
(20,1,1) = {"
ai
an
an
aW
aZ
yl
Bl
SD
wY
dC
Mg
qf
uS
aa
"}
(21,1,1) = {"
al
ap
aL
aX
ba
al
Un
pA
QO
eP
eu
zn
uS
aa
"}
(22,1,1) = {"
ao
aF
aU
bt
bt
al
cZ
tF
qD
eP
eu
qf
uS
aa
"}
(23,1,1) = {"
al
al
al
aY
bu
al
NR
fT
DR
DR
DR
FU
Ny
aa
"}
(24,1,1) = {"
aa
aa
al
al
al
al
Uo
qf
qf
aD
kN
SJ
Ny
aa
"}
