// This map has been converted using maphash
"anr" = (/obj/structure/sink/kitchen{pixel_y = 28},/turf/open/floor/wood,/area/crew_quarters/bar)
"arG" = (/turf/template_noop,/area/template_noop)
"aww" = (/obj/machinery/disposal/bin,/obj/structure/disposalpipe/trunk{dir = 8},/obj/machinery/firealarm{dir = 2; pixel_y = 26},/turf/open/floor/plasteel/vaporwave,/area/crew_quarters/bar)
"aBw" = (/obj/structure/table,/obj/item/reagent_containers/food/snacks/butterdog,/obj/item/reagent_containers/food/snacks/butterdog,/turf/open/floor/plasteel/vaporwave,/area/crew_quarters/kitchen)
"aMF" = (/obj/structure/disposalpipe/segment{dir = 4},/turf/open/floor/plasteel/vaporwave,/area/crew_quarters/bar)
"aMR" = (/obj/machinery/deepfryer,/turf/open/floor/plasteel/vaporwave,/area/crew_quarters/kitchen)
"bna" = (/obj/machinery/requests_console{department = "Bar"; departmentType = 2; pixel_x = 30; pixel_y = 0},/obj/machinery/camera{c_tag = "Bar"; dir = 8; network = list("SS13")},/obj/structure/table,/obj/machinery/chem_dispenser/drinks,/turf/open/floor/plasteel/vaporwave,/area/crew_quarters/bar)
"bnN" = (/obj/structure/chair/stool,/turf/open/floor/plasteel/vaporwave,/area/crew_quarters/bar)
"bpN" = (/obj/machinery/light{dir = 4; light_color = "#e8eaff"},/turf/open/floor/plasteel/vaporwave,/area/crew_quarters/bar)
"bqX" = (/obj/structure/table/reinforced,/obj/item/clothing/mask/cigarette/rollie/cannabis,/obj/item/clothing/mask/cigarette/rollie/cannabis,/obj/item/clothing/mask/cigarette/rollie/cannabis,/obj/item/clothing/mask/cigarette/rollie/cannabis,/obj/item/clothing/mask/cigarette/rollie/cannabis,/obj/item/clothing/mask/cigarette/rollie/cannabis,/obj/item/clothing/mask/cigarette/rollie/cannabis,/obj/item/clothing/mask/cigarette/rollie/cannabis,/obj/item/clothing/mask/cigarette/rollie/cannabis,/obj/item/clothing/mask/cigarette/rollie/cannabis,/turf/open/floor/plasteel/vaporwave,/area/crew_quarters/bar)
"bBr" = (/turf/open/floor/plasteel/vaporwave,/area/crew_quarters/bar)
"bZZ" = (/obj/structure/statue/sandstone/venus,/turf/open/floor/plasteel/vaporwave,/area/crew_quarters/bar)
"cao" = (/obj/machinery/vending/dinnerware,/turf/open/floor/plasteel/vaporwave,/area/crew_quarters/kitchen)
"csX" = (/obj/structure/chair/americandiner{dir = 1; icon_state = "americhair"},/turf/open/floor/plasteel/vaporwave,/area/crew_quarters/bar)
"cwr" = (/obj/structure/closet/secure_closet/freezer/kitchen,/turf/open/floor/plasteel/vaporwave,/area/crew_quarters/kitchen)
"cMk" = (/obj/structure/window/reinforced{dir = 8},/obj/structure/window/reinforced,/turf/open/floor/plating/beach/sand,/area/crew_quarters/bar)
"cNO" = (/obj/machinery/door/airlock{name = "Kitchen"; req_access_txt = "28"},/obj/machinery/door/firedoor/border_only{dir = 4},/obj/machinery/door/firedoor/border_only{dir = 8},/turf/open/floor/plasteel/vaporwave,/area/crew_quarters/kitchen)
"dfD" = (/obj/structure/table,/obj/item/stack/packageWrap,/obj/item/reagent_containers/food/condiment/enzyme,/turf/open/floor/plasteel/vaporwave,/area/crew_quarters/kitchen)
"dkx" = (/obj/structure/window/reinforced{dir = 1},/obj/structure/window/reinforced{dir = 8},/obj/structure/flora/ausbushes/ywflowers,/turf/open/floor/plating/beach/sand,/area/crew_quarters/bar)
"dyv" = (/obj/effect/landmark/blobstart,/turf/open/floor/plating,/area/crew_quarters/bar)
"dVT" = (/obj/effect/landmark/event_spawn,/obj/structure/chair/stool,/turf/open/floor/plasteel/vaporwave,/area/crew_quarters/bar)
"eeM" = (/obj/structure/disposalpipe/segment{dir = 9},/turf/open/floor/plasteel/vaporwave,/area/crew_quarters/bar)
"eha" = (/obj/structure/closet/secure_closet/bar{req_access_txt = "25"},/obj/item/gun/ballistic/revolver/russian,/turf/open/floor/wood,/area/crew_quarters/bar)
"esY" = (/obj/structure/closet/secure_closet/freezer/meat,/turf/open/floor/plasteel{icon_state = "showroomfloor"},/area/crew_quarters/kitchen)
"eBE" = (/obj/structure/sign/barsign,/turf/closed/wall,/area/crew_quarters/bar)
"fjU" = (/obj/structure/chair/americandiner,/turf/open/floor/plasteel/vaporwave,/area/crew_quarters/bar)
"fqK" = (/obj/structure/disposalpipe/segment,/obj/machinery/atmospherics/pipe/manifold/scrubbers/hidden/layer3{dir = 8; icon_state = "manifold-3"},/obj/machinery/atmospherics/pipe/simple/supply/hidden/layer1,/turf/open/floor/plasteel{icon_state = "showroomfloor"},/area/crew_quarters/kitchen)
"fyD" = (/turf/open/floor/plating/beach/sand,/area/crew_quarters/bar)
"fDb" = (/obj/machinery/computer/security/telescreen/entertainment{pixel_x = -31},/obj/machinery/light{dir = 8},/turf/open/floor/plasteel/vaporwave,/area/crew_quarters/bar)
"fTl" = (/obj/structure/disposalpipe/segment{dir = 10},/turf/open/floor/plasteel/vaporwave,/area/crew_quarters/kitchen)
"fXk" = (/obj/structure/window/reinforced{dir = 4},/turf/open/floor/plating/beach/sand,/area/crew_quarters/bar)
"gkM" = (/obj/structure/extinguisher_cabinet{pixel_x = -5; pixel_y = 30},/obj/machinery/food_cart,/turf/open/floor/plasteel/vaporwave,/area/crew_quarters/kitchen)
"gmP" = (/obj/machinery/camera{c_tag = "Bar South"; dir = 1},/obj/structure/noticeboard{dir = 1; pixel_y = -27},/turf/open/floor/plasteel/vaporwave,/area/crew_quarters/bar)
"got" = (/obj/structure/table/reinforced,/obj/structure/plasticflaps,/obj/structure/window/reinforced{dir = 1},/obj/machinery/conveyor{dir = 8; id = "conveyorbar"},/turf/open/floor/plasteel/vaporwave,/area/crew_quarters/bar)
"gtO" = (/obj/structure/window/reinforced{dir = 8},/obj/structure/flora/ausbushes,/mob/living/simple_animal/hostile/lizard,/turf/open/floor/plating/beach/sand,/area/crew_quarters/bar)
"gzF" = (/obj/structure/table,/obj/machinery/chem_dispenser/drinks/beer,/obj/machinery/firealarm{dir = 8; pixel_x = 26; pixel_y = 0},/turf/open/floor/plasteel/vaporwave,/area/crew_quarters/bar)
"gGa" = (/obj/structure/sink/kitchen{pixel_y = 28},/turf/open/floor/plasteel/vaporwave,/area/crew_quarters/kitchen)
"gLP" = (/obj/structure/disposalpipe/segment,/obj/machinery/atmospherics/pipe/simple/scrubbers/hidden/layer3{dir = 9; icon_state = "pipe11-3"},/obj/effect/landmark/xeno_spawn,/obj/machinery/atmospherics/pipe/simple/supply/hidden/layer1{dir = 5; icon_state = "pipe11-1"},/turf/open/floor/wood,/area/crew_quarters/bar)
"hkX" = (/obj/machinery/door/airlock{name = "Theatre Backstage"; req_access_txt = "46"},/obj/machinery/atmospherics/pipe/simple/scrubbers/hidden/layer3,/obj/machinery/atmospherics/pipe/simple/supply/hidden,/obj/machinery/atmospherics/pipe/simple/supply/hidden/layer1,/obj/machinery/door/firedoor/border_only{dir = 1},/obj/machinery/door/firedoor/border_only,/turf/open/floor/plasteel,/area/crew_quarters/theatre)
"hlB" = (/obj/machinery/reagentgrinder,/obj/structure/table/wood,/turf/open/floor/wood,/area/crew_quarters/bar)
"hxa" = (/obj/machinery/atmospherics/components/unary/vent_pump/on/layer1{dir = 8; icon_state = "vent_map_on-1"},/turf/open/floor/plasteel/vaporwave,/area/crew_quarters/bar)
"hxx" = (/obj/structure/table,/obj/item/taperecorder,/turf/open/floor/plasteel/vaporwave,/area/crew_quarters/bar)
"hEx" = (/obj/structure/piano,/turf/open/floor/plasteel/vaporwave,/area/crew_quarters/bar)
"hET" = (/obj/machinery/door/window/southleft{base_state = "left"; dir = 2; icon_state = "left"; name = "Bar Delivery"; req_access_txt = "25"},/obj/effect/turf_decal/delivery,/turf/open/floor/plasteel,/area/crew_quarters/bar)
"hFA" = (/obj/structure/table,/obj/machinery/microwave{pixel_x = -3; pixel_y = 6},/obj/machinery/airalarm{pixel_y = 24},/obj/machinery/light{dir = 1},/turf/open/floor/plasteel/vaporwave,/area/crew_quarters/kitchen)
"hHX" = (/obj/structure/disposalpipe/segment{dir = 4},/obj/machinery/atmospherics/components/unary/vent_pump/on/layer1{dir = 8; icon_state = "vent_map_on-1"},/turf/open/floor/plasteel/vaporwave,/area/crew_quarters/kitchen)
"ikO" = (/obj/structure/window/reinforced{dir = 4},/obj/structure/flora/ausbushes/sparsegrass,/turf/open/floor/plating/beach/sand,/area/crew_quarters/bar)
"ivg" = (/obj/structure/chair/stool,/obj/effect/landmark/start/assistant,/turf/open/floor/plasteel/vaporwave,/area/crew_quarters/bar)
"iwa" = (/obj/item/storage/secure/safe,/turf/closed/wall,/area/crew_quarters/bar)
"ixK" = (/obj/structure/window/reinforced{dir = 4},/obj/structure/flora/ausbushes/leafybush,/mob/living/simple_animal/hostile/lizard,/turf/open/floor/plating/beach/sand,/area/crew_quarters/bar)
"iLv" = (/obj/machinery/light,/turf/open/floor/plasteel/vaporwave,/area/crew_quarters/kitchen)
"iTv" = (/obj/structure/disposalpipe/segment,/obj/machinery/atmospherics/pipe/simple/scrubbers/hidden/layer3,/obj/machinery/atmospherics/pipe/simple/supply/hidden/layer1,/turf/open/floor/wood,/area/crew_quarters/bar)
"iUs" = (/obj/effect/landmark/start/cook,/turf/open/floor/plasteel/vaporwave,/area/crew_quarters/kitchen)
"jee" = (/obj/structure/table/reinforced,/obj/machinery/door/firedoor/border_only,/obj/machinery/door/poddoor/shutters/preopen{id = "kitchen"; name = "kitchen shutters"},/turf/open/floor/plasteel/vaporwave,/area/crew_quarters/kitchen)
"jlx" = (/obj/machinery/door/window/southright{name = "Bar Door"; req_access_txt = "25"; req_one_access_txt = null},/turf/open/floor/plasteel/vaporwave,/area/crew_quarters/bar)
"jtC" = (/obj/machinery/vending/coffee,/turf/open/floor/wood,/area/crew_quarters/bar)
"jug" = (/obj/machinery/navbeacon{codes_txt = "delivery;dir=2"; freq = 1400; location = "Kitchen"},/obj/structure/plasticflaps{opacity = 1},/turf/open/floor/plasteel,/area/crew_quarters/kitchen)
"jDH" = (/obj/machinery/atmospherics/pipe/simple/scrubbers/hidden/layer3{dir = 9; icon_state = "pipe11-3"},/obj/machinery/atmospherics/pipe/simple/supply/hidden/layer1{dir = 5; icon_state = "pipe11-1"},/turf/open/floor/plasteel/vaporwave,/area/crew_quarters/bar)
"jIb" = (/turf/closed/wall,/area/crew_quarters/kitchen)
"jMI" = (/obj/structure/window/reinforced{dir = 8},/obj/structure/table/reinforced,/obj/item/storage/bag/tray,/obj/item/storage/bag/tray,/obj/item/storage/bag/tray,/obj/item/storage/bag/tray,/obj/item/storage/bag/tray,/obj/item/reagent_containers/food/snacks/dolphinmeat,/obj/item/reagent_containers/food/snacks/dolphinmeat,/obj/item/reagent_containers/food/snacks/dolphinmeat,/turf/open/floor/plasteel/vaporwave,/area/crew_quarters/bar)
"jWK" = (/obj/structure/table,/obj/item/clothing/head/hardhat/cakehat,/obj/machinery/light{dir = 1},/turf/open/floor/plasteel/vaporwave,/area/crew_quarters/bar)
"kgd" = (/obj/machinery/conveyor{dir = 8; id = "conveyorbar"},/turf/open/floor/plasteel/vaporwave,/area/crew_quarters/bar)
"koq" = (/obj/effect/landmark/event_spawn,/obj/machinery/atmospherics/components/unary/vent_pump/on/layer1{dir = 8; icon_state = "vent_map_on-1"},/turf/open/floor/plasteel{icon_state = "showroomfloor"},/area/crew_quarters/kitchen)
"kDQ" = (/obj/machinery/door/airlock{name = "Kitchen cold room"; req_access_txt = "28"},/obj/structure/disposalpipe/segment,/obj/machinery/atmospherics/pipe/simple/scrubbers/hidden/layer3,/obj/machinery/atmospherics/pipe/simple/supply/hidden/layer1,/obj/machinery/door/firedoor/border_only,/obj/machinery/door/firedoor/border_only{dir = 1},/turf/open/floor/plasteel{icon_state = "showroomfloor"},/area/crew_quarters/kitchen)
"kOZ" = (/obj/machinery/conveyor{dir = 6; icon_state = "conveyor0"; id = "conveyorbar"; tag = ""},/obj/item/reagent_containers/food/drinks/drinkingglass/shotglass,/turf/open/floor/plasteel/vaporwave,/area/crew_quarters/bar)
"kQj" = (/obj/machinery/camera{c_tag = "Bar Storage"},/turf/open/floor/wood,/area/crew_quarters/bar)
"kVa" = (/obj/effect/landmark/start/bartender,/turf/open/floor/plasteel/vaporwave,/area/crew_quarters/bar)
"lbG" = (/obj/machinery/atmospherics/components/unary/vent_scrubber/on/layer3{dir = 8; icon_state = "scrub_map_on-3"},/obj/effect/spawner/lootdrop/mob/kitchen_animal,/turf/open/floor/plasteel{icon_state = "showroomfloor"},/area/crew_quarters/kitchen)
"liS" = (/obj/machinery/conveyor{dir = 2; id = "conveyorbar"},/turf/open/floor/plasteel/vaporwave,/area/crew_quarters/bar)
"lzO" = (/obj/machinery/door/airlock/maintenance{name = "Bar Maintenance"; req_access_txt = "12"},/obj/structure/disposalpipe/segment,/obj/machinery/door/firedoor/border_only{dir = 1},/obj/machinery/door/firedoor/border_only,/turf/open/floor/plating,/area/maintenance/starboard/fore)
"lHI" = (/obj/machinery/disposal/bin,/obj/structure/disposalpipe/trunk{dir = 4},/obj/structure/window/reinforced{dir = 8},/turf/open/floor/plasteel/vaporwave,/area/crew_quarters/bar)
"lNv" = (/obj/structure/window/reinforced{dir = 8},/turf/open/floor/plating/beach/sand,/area/crew_quarters/bar)
"lTD" = (/obj/machinery/door/airlock/public/glass{name = "Bar"},/obj/machinery/door/firedoor/border_only{dir = 1},/obj/machinery/door/firedoor/border_only,/turf/open/floor/plasteel/vaporwave,/area/crew_quarters/bar)
"mij" = (/obj/structure/sign/plaques/deempisi,/turf/closed/wall,/area/crew_quarters/bar)
"mlE" = (/obj/structure/disposalpipe/segment,/obj/machinery/atmospherics/pipe/simple/scrubbers/hidden/layer3,/obj/machinery/atmospherics/pipe/simple/supply/hidden/layer1,/turf/open/floor/plasteel{icon_state = "showroomfloor"},/area/crew_quarters/kitchen)
"mpm" = (/obj/machinery/button/door{id = "kitchen"; name = "Kitchen Shutters Control"; pixel_x = -1; pixel_y = -24; req_access_txt = "28"},/obj/structure/disposalpipe/segment{dir = 5},/turf/open/floor/plasteel/vaporwave,/area/crew_quarters/kitchen)
"mqh" = (/obj/structure/window/reinforced{dir = 1},/obj/structure/flora/ausbushes/sparsegrass,/turf/open/floor/plating/beach/sand,/area/crew_quarters/bar)
"mtH" = (/obj/item/radio/intercom,/turf/closed/wall,/area/crew_quarters/bar)
"muL" = (/obj/machinery/light/small{dir = 4},/obj/machinery/airalarm{dir = 8; icon_state = "alarm0"; pixel_x = 24},/obj/machinery/vending/wardrobe/chef_wardrobe,/turf/open/floor/plasteel{icon_state = "showroomfloor"},/area/crew_quarters/kitchen)
"mwu" = (/obj/effect/turf_decal/loading_area,/turf/open/floor/plasteel{icon_state = "showroomfloor"},/area/crew_quarters/kitchen)
"mCL" = (/obj/machinery/newscaster{pixel_y = -28},/turf/open/floor/plasteel/vaporwave,/area/crew_quarters/bar)
"mHl" = (/obj/machinery/door/airlock{name = "Bar Storage"; req_access_txt = "25"},/obj/structure/disposalpipe/segment,/obj/machinery/door/firedoor/border_only,/obj/machinery/door/firedoor/border_only{dir = 1},/turf/open/floor/wood,/area/crew_quarters/bar)
"mVc" = (/obj/structure/sign/poster/contraband/have_a_puff,/turf/closed/wall,/area/crew_quarters/bar)
"mWM" = (/obj/effect/spawner/structure/window/plasma,/turf/open/floor/plating,/area/crew_quarters/bar)
"noA" = (/obj/structure/disposalpipe/segment,/obj/machinery/atmospherics/pipe/simple/scrubbers/hidden/layer3,/obj/machinery/atmospherics/pipe/manifold/supply/hidden/layer1{dir = 8; icon_state = "manifold-1"},/turf/open/floor/plasteel{icon_state = "showroomfloor"},/area/crew_quarters/kitchen)
"nqd" = (/turf/closed/wall,/area/crew_quarters/bar)
"nKI" = (/obj/structure/window/reinforced{dir = 1},/obj/structure/window/reinforced{dir = 4},/obj/structure/flora/ausbushes/ywflowers,/turf/open/floor/plating/beach/sand,/area/crew_quarters/bar)
"nLt" = (/obj/machinery/chem_master/condimaster{name = "CondiMaster Neo"},/obj/machinery/camera{c_tag = "Kitchen Cold Room"},/turf/open/floor/plasteel{icon_state = "showroomfloor"},/area/crew_quarters/kitchen)
"nPj" = (/obj/machinery/computer/slot_machine,/turf/open/floor/plasteel/vaporwave,/area/crew_quarters/bar)
"nQj" = (/obj/machinery/atmospherics/components/unary/vent_scrubber/on/layer3{dir = 4; icon_state = "scrub_map_on-3"},/turf/open/floor/plasteel/vaporwave,/area/crew_quarters/bar)
"nUF" = (/obj/machinery/airalarm{dir = 4; icon_state = "alarm0"; pixel_x = -22},/obj/machinery/light/small{dir = 8},/obj/structure/reagent_dispensers/beerkeg,/obj/machinery/atmospherics/components/unary/vent_scrubber/on/layer3{dir = 4; icon_state = "scrub_map_on-3"},/turf/open/floor/wood,/area/crew_quarters/bar)
"ogj" = (/obj/structure/sink/puddle,/turf/open/floor/plating/beach/sand,/area/crew_quarters/bar)
"oKH" = (/obj/machinery/computer/security/telescreen/entertainment{pixel_x = -31},/turf/open/floor/plasteel/vaporwave,/area/crew_quarters/bar)
"oLG" = (/obj/machinery/conveyor_switch{id = "conveyorbar"},/turf/open/floor/plasteel/vaporwave,/area/crew_quarters/bar)
"oLR" = (/obj/machinery/disposal/bin,/obj/structure/disposalpipe/trunk{dir = 8},/turf/open/floor/plasteel/vaporwave,/area/crew_quarters/kitchen)
"oWN" = (/obj/machinery/processor,/obj/machinery/firealarm{dir = 8; pixel_x = 26; pixel_y = 0},/turf/open/floor/plasteel/vaporwave,/area/crew_quarters/kitchen)
"peA" = (/obj/machinery/vending/wardrobe/bar_wardrobe,/turf/open/floor/wood,/area/crew_quarters/bar)
"pjf" = (/obj/machinery/gibber,/turf/open/floor/plasteel{icon_state = "showroomfloor"},/area/crew_quarters/kitchen)
"pkE" = (/obj/structure/disposalpipe/segment,/obj/machinery/atmospherics/pipe/simple/scrubbers/hidden/layer3,/obj/machinery/atmospherics/pipe/simple/supply/hidden/layer1,/turf/open/floor/plasteel/vaporwave,/area/crew_quarters/kitchen)
"ppZ" = (/obj/machinery/camera{c_tag = "Kitchen"; dir = 2; network = list("SS13")},/obj/structure/closet/secure_closet/freezer/fridge,/turf/open/floor/plasteel/vaporwave,/area/crew_quarters/kitchen)
"pDe" = (/obj/structure/table,/obj/machinery/reagentgrinder,/obj/machinery/requests_console{department = "Kitchen"; departmentType = 2; pixel_x = 30; pixel_y = 0},/turf/open/floor/plasteel/vaporwave,/area/crew_quarters/kitchen)
"qgp" = (/obj/structure/table/reinforced,/obj/item/book/manual/wiki/barman_recipes,/obj/item/reagent_containers/glass/rag,/turf/open/floor/plasteel/vaporwave,/area/crew_quarters/bar)
"qkX" = (/obj/structure/kitchenspike,/turf/open/floor/plasteel{icon_state = "showroomfloor"},/area/crew_quarters/kitchen)
"qrI" = (/obj/structure/kitchenspike,/obj/machinery/light/small{dir = 8},/turf/open/floor/plasteel{icon_state = "showroomfloor"},/area/crew_quarters/kitchen)
"qrO" = (/obj/structure/chair/americandiner{dir = 8; icon_state = "americhair"},/turf/open/floor/plasteel/vaporwave,/area/crew_quarters/bar)
"qEb" = (/obj/machinery/atmospherics/pipe/simple/scrubbers/hidden/layer3,/obj/machinery/atmospherics/pipe/simple/supply/hidden/layer1,/turf/open/floor/plasteel/vaporwave,/area/crew_quarters/bar)
"qMO" = (/obj/machinery/conveyor{dir = 8; id = "conveyorbar"},/obj/machinery/door/window/westleft{name = "Conveyor Door"; req_access_txt = "25"},/obj/machinery/door/firedoor,/turf/open/floor/plasteel/vaporwave,/area/crew_quarters/kitchen)
"qTU" = (/turf/open/floor/plasteel{icon_state = "showroomfloor"},/area/crew_quarters/kitchen)
"rMv" = (/obj/machinery/smartfridge/drinks,/turf/open/floor/plasteel/vaporwave,/area/crew_quarters/bar)
"rVR" = (/obj/machinery/light{dir = 8},/turf/open/floor/plasteel/vaporwave,/area/crew_quarters/bar)
"sla" = (/obj/structure/extinguisher_cabinet{pixel_y = -30},/obj/structure/statue/sandstone/venus{dir = 1; icon_state = "venus"},/turf/open/floor/plasteel/vaporwave,/area/crew_quarters/bar)
"syX" = (/obj/machinery/atmospherics/components/unary/vent_scrubber/on/layer3{dir = 4; icon_state = "scrub_map_on-3"},/turf/open/floor/plasteel/vaporwave,/area/crew_quarters/kitchen)
"szx" = (/obj/structure/window/reinforced,/turf/open/floor/plating/beach/sand,/area/crew_quarters/bar)
"sEd" = (/obj/structure/window/reinforced{dir = 8},/mob/living/simple_animal/hostile/lizard{name = "Honky"},/turf/open/floor/plating/beach/sand,/area/crew_quarters/bar)
"sGT" = (/obj/machinery/conveyor{dir = 10; icon_state = "conveyor0"; id = "conveyorbar"},/turf/open/floor/plasteel/vaporwave,/area/crew_quarters/bar)
"sJV" = (/obj/structure/table/reinforced,/obj/machinery/door/firedoor/border_only,/obj/machinery/door/poddoor/shutters/preopen{id = "kitchen"; name = "kitchen shutters"},/obj/item/reagent_containers/food/snacks/mint,/turf/open/floor/plasteel/vaporwave,/area/crew_quarters/kitchen)
"sLt" = (/obj/item/twohanded/required/kirbyplants{icon_state = "plant-26"},/turf/open/floor/plasteel/vaporwave,/area/crew_quarters/bar)
"sPu" = (/obj/effect/landmark/event_spawn,/turf/open/floor/plasteel/vaporwave,/area/crew_quarters/kitchen)
"sYJ" = (/obj/structure/table/reinforced,/obj/machinery/door/firedoor/border_only,/obj/machinery/door/poddoor/shutters/preopen{id = "kitchen"; name = "kitchen shutters"},/obj/item/storage/fancy/donut_box,/turf/open/floor/plasteel/vaporwave,/area/crew_quarters/kitchen)
"sYW" = (/obj/machinery/conveyor{dir = 4; id = "conveyorbar"},/turf/open/floor/plasteel/vaporwave,/area/crew_quarters/bar)
"taS" = (/obj/machinery/airalarm{dir = 2; pixel_y = 24},/turf/open/floor/plasteel/vaporwave,/area/crew_quarters/bar)
"thQ" = (/obj/structure/disposalpipe/segment,/turf/open/floor/plasteel/vaporwave,/area/crew_quarters/kitchen)
"tpt" = (/obj/machinery/conveyor{dir = 1; id = "conveyorbar"},/turf/open/floor/plasteel/vaporwave,/area/crew_quarters/bar)
"tqW" = (/obj/structure/table,/obj/item/book/manual/chef_recipes,/obj/item/book/manual/wiki/cooking_to_serve_man{pixel_x = -4; pixel_y = 4},/turf/open/floor/plasteel/vaporwave,/area/crew_quarters/kitchen)
"tso" = (/obj/item/twohanded/required/kirbyplants{icon_state = "plant-03"},/turf/open/floor/plasteel/vaporwave,/area/crew_quarters/bar)
"tNf" = (/obj/machinery/light,/turf/open/floor/plasteel/vaporwave,/area/crew_quarters/bar)
"tNl" = (/obj/structure/table,/obj/item/clothing/glasses/sunglasses/big,/turf/open/floor/plasteel/vaporwave,/area/crew_quarters/bar)
"tNo" = (/obj/item/stack/sheet/metal/fifty,/obj/item/stack/sheet/glass/fifty,/obj/item/stack/cable_coil,/obj/item/flashlight/lamp,/obj/item/flashlight/lamp/green,/obj/structure/closet/secure_closet/bartender,/turf/open/floor/wood,/area/crew_quarters/bar)
"tRi" = (/turf/open/floor/plasteel/vaporwave,/area/crew_quarters/kitchen)
"tXr" = (/obj/machinery/conveyor{dir = 5; icon_state = "conveyor0"; id = "conveyorbar"; tag = ""},/turf/open/floor/plasteel/vaporwave,/area/crew_quarters/bar)
"upI" = (/turf/open/floor/wood,/area/crew_quarters/bar)
"urD" = (/obj/machinery/icecream_vat,/turf/open/floor/plasteel{icon_state = "showroomfloor"},/area/crew_quarters/kitchen)
"uwX" = (/obj/machinery/door/window/southleft{base_state = "left"; dir = 2; icon_state = "left"; name = "Kitchen Delivery"; req_access_txt = "28"},/obj/effect/turf_decal/delivery,/turf/open/floor/plasteel,/area/crew_quarters/kitchen)
"uJE" = (/obj/machinery/light_switch{pixel_y = -25},/turf/open/floor/plasteel/vaporwave,/area/crew_quarters/kitchen)
"uUu" = (/obj/structure/table/reinforced,/turf/open/floor/plasteel/vaporwave,/area/crew_quarters/bar)
"uYj" = (/obj/item/reagent_containers/food/drinks/shaker,/obj/structure/table/wood,/obj/item/stack/sheet/metal{amount = 50},/obj/item/stack/sheet/glass{amount = 50},/obj/item/stack/cable_coil,/turf/open/floor/wood,/area/crew_quarters/bar)
"vbt" = (/obj/machinery/camera{c_tag = "Theatre Stage"; dir = 2},/obj/structure/chair/americandiner{dir = 4; icon_state = "americhair"},/turf/open/floor/plasteel/vaporwave,/area/crew_quarters/bar)
"vmc" = (/obj/effect/spawner/structure/window/plasma,/turf/open/floor/plating,/area/crew_quarters/kitchen)
"vrM" = (/obj/structure/table,/obj/machinery/microwave{pixel_x = -3; pixel_y = 6},/obj/item/storage/box/donkpockets,/turf/open/floor/plasteel/vaporwave,/area/crew_quarters/kitchen)
"vNN" = (/obj/structure/disposalpipe/segment,/turf/open/floor/wood,/area/crew_quarters/bar)
"vZI" = (/obj/machinery/atmospherics/pipe/simple/scrubbers/hidden/layer3{dir = 9; icon_state = "pipe11-3"},/obj/machinery/atmospherics/pipe/simple/supply/hidden/layer1{dir = 5; icon_state = "pipe11-1"},/obj/structure/disposalpipe/segment{dir = 5},/turf/open/floor/plasteel/vaporwave,/area/crew_quarters/kitchen)
"wjS" = (/obj/item/statuebust,/turf/open/floor/plating/beach/sand,/area/crew_quarters/bar)
"wwy" = (/obj/machinery/airalarm{dir = 4; icon_state = "alarm0"; pixel_x = -22},/obj/machinery/camera{c_tag = "Bar West"; dir = 4; network = list("SS13")},/turf/open/floor/plasteel/vaporwave,/area/crew_quarters/bar)
"wNO" = (/mob/living/carbon/monkey{name = "Pun Pun"},/turf/open/floor/plasteel/vaporwave,/area/crew_quarters/bar)
"wVf" = (/obj/machinery/light,/obj/machinery/airalarm{dir = 1; icon_state = "alarm0"; pixel_y = -22},/turf/open/floor/plasteel/vaporwave,/area/crew_quarters/bar)
"xkF" = (/obj/machinery/light,/obj/machinery/firealarm{dir = 1; pixel_y = -26},/turf/open/floor/plasteel/vaporwave,/area/crew_quarters/bar)
"xpf" = (/obj/machinery/atmospherics/components/unary/vent_pump/on/layer1{dir = 8; icon_state = "vent_map_on-1"},/turf/open/floor/wood,/area/crew_quarters/bar)
"xsL" = (/obj/structure/window/reinforced{dir = 4},/obj/structure/window/reinforced,/turf/open/floor/plating/beach/sand,/area/crew_quarters/bar)
"xCW" = (/obj/structure/disposalpipe/segment{dir = 5},/turf/open/floor/plasteel/vaporwave,/area/crew_quarters/bar)
"xJq" = (/obj/machinery/conveyor{dir = 4; id = "conveyorbar"},/obj/item/reagent_containers/food/drinks/drinkingglass/shotglass,/turf/open/floor/plasteel/vaporwave,/area/crew_quarters/bar)
"xRT" = (/obj/structure/disposalpipe/segment{dir = 4},/turf/open/floor/plasteel/vaporwave,/area/crew_quarters/kitchen)
"xTI" = (/obj/machinery/vending/boozeomat,/turf/open/floor/plasteel/vaporwave,/area/crew_quarters/bar)
"yie" = (/obj/structure/window/reinforced{dir = 1},/obj/machinery/conveyor{dir = 8; id = "conveyorbar"},/turf/open/floor/plasteel/vaporwave,/area/crew_quarters/bar)
"yiv" = (/obj/machinery/light/small{dir = 4; light_color = "#fff4bc"},/turf/open/floor/wood,/area/crew_quarters/bar)
"ylG" = (/obj/machinery/conveyor{dir = 9; icon_state = "conveyor0"; id = "conveyorbar"; tag = ""},/turf/open/floor/plasteel/vaporwave,/area/crew_quarters/bar)
"ylL" = (/obj/machinery/door/airlock/maintenance{name = "Kitchen Maintenance"; req_access_txt = "28"},/obj/structure/disposalpipe/segment,/obj/machinery/atmospherics/pipe/simple/scrubbers/hidden/layer3,/obj/machinery/atmospherics/pipe/simple/supply/hidden/layer1,/obj/machinery/door/firedoor/border_only{dir = 1},/obj/machinery/door/firedoor/border_only,/turf/open/floor/plating,/area/maintenance/starboard/fore)

(1,1,1) = {"
arG
nqd
nqd
nqd
nqd
mWM
nqd
mWM
nqd
mWM
nqd
nqd
nqd
nqd
"}
(2,1,1) = {"
arG
nqd
hEx
bBr
oKH
bBr
rVR
bBr
wwy
bBr
fDb
bBr
bZZ
nqd
"}
(3,1,1) = {"
nqd
nqd
qrO
bnN
bnN
bnN
bnN
bnN
bnN
bnN
bnN
bnN
tso
nqd
"}
(4,1,1) = {"
mVc
sLt
nQj
bnN
tXr
tpt
tpt
tpt
tpt
tpt
ylG
bnN
mCL
nqd
"}
(5,1,1) = {"
hkX
qEb
jDH
bnN
sYW
dkx
gtO
lNv
sEd
cMk
kgd
ivg
xkF
nqd
"}
(6,1,1) = {"
nqd
taS
hxa
bnN
xJq
mqh
ogj
wjS
fyD
szx
kgd
ivg
bBr
lTD
"}
(7,1,1) = {"
mtH
vbt
bBr
bnN
sYW
nKI
ikO
fXk
ixK
xsL
kgd
ivg
bBr
mWM
"}
(8,1,1) = {"
nqd
jWK
bBr
bnN
kOZ
liS
liS
liS
liS
liS
sGT
bnN
bBr
lTD
"}
(9,1,1) = {"
nqd
nPj
bBr
bBr
bBr
bBr
bBr
got
uUu
uUu
uUu
bnN
tNf
nqd
"}
(10,1,1) = {"
lzO
xCW
bBr
bBr
bBr
bBr
bBr
yie
bBr
bBr
bqX
bnN
bBr
mWM
"}
(11,1,1) = {"
nqd
aww
fjU
tNl
hxx
csX
bBr
yie
kVa
bBr
uUu
bnN
gmP
nqd
"}
(12,1,1) = {"
nqd
nqd
nqd
nqd
mij
lHI
jMI
kgd
oLG
bBr
uUu
bnN
bBr
eBE
"}
(13,1,1) = {"
uYj
hlB
nUF
eha
iwa
aMF
bBr
kgd
bBr
bBr
qgp
dVT
bBr
nqd
"}
(14,1,1) = {"
iTv
iTv
gLP
vNN
mHl
eeM
bpN
kgd
wNO
bBr
jlx
bBr
wVf
nqd
"}
(15,1,1) = {"
anr
upI
xpf
tNo
nqd
gzF
xTI
kgd
bna
bBr
rMv
bBr
sla
nqd
"}
(16,1,1) = {"
nqd
kQj
peA
nqd
nqd
jIb
jIb
qMO
jIb
vmc
jIb
cNO
jIb
jIb
"}
(17,1,1) = {"
hET
yiv
jtC
nqd
dyv
jIb
cao
tRi
tRi
tRi
tRi
uJE
jIb
arG
"}
(18,1,1) = {"
jIb
jIb
jIb
jIb
jIb
jIb
gkM
tRi
tRi
tRi
tRi
iLv
jIb
arG
"}
(19,1,1) = {"
jIb
esY
urD
qrI
qkX
jIb
gGa
syX
aMR
iUs
tRi
tRi
sYJ
arG
"}
(20,1,1) = {"
ylL
mlE
mlE
fqK
noA
kDQ
pkE
vZI
dfD
iUs
tRi
tRi
sJV
arG
"}
(21,1,1) = {"
jIb
jIb
nLt
lbG
koq
jIb
ppZ
hHX
tqW
iUs
tRi
sPu
jee
arG
"}
(22,1,1) = {"
jug
uwX
mwu
qTU
qTU
jIb
hFA
xRT
aBw
iUs
tRi
tRi
jee
arG
"}
(23,1,1) = {"
jIb
jIb
jIb
muL
pjf
jIb
vrM
fTl
thQ
thQ
thQ
mpm
jIb
arG
"}
(24,1,1) = {"
arG
arG
jIb
jIb
jIb
jIb
cwr
tRi
tRi
oWN
pDe
oLR
jIb
arG
"}
