//MAP CONVERTED BY dmm2tgm.py THIS HEADER COMMENT PREVENTS RECONVERSION, DO NOT REMOVE
"h" = (
/obj/structure/closet/secure_closet/personal,
/obj/machinery/atmospherics/pipe/simple/scrubbers/hidden/layer3{
	dir = 10
	},
/obj/machinery/atmospherics/pipe/simple/supply/hidden/layer1{
	dir = 6
	},
/turf/open/floor/carpet/royalblack,
/area/crew_quarters/dorms)
"w" = (
/obj/structure/chair/stool{
	pixel_y = 8
	},
/turf/open/floor/carpet/royalblack,
/area/crew_quarters/dorms)
"E" = (
/turf/closed/wall,
/area/crew_quarters/dorms)
"H" = (
/obj/effect/landmark/xeno_spawn,
/obj/machinery/atmospherics/pipe/simple/scrubbers/hidden/layer3{
	dir = 5
	},
/obj/machinery/atmospherics/pipe/simple/supply/hidden/layer1{
	dir = 5
	},
/turf/open/floor/carpet/royalblack,
/area/crew_quarters/dorms)
"O" = (
/obj/machinery/atmospherics/pipe/simple/scrubbers/hidden/layer3{
	dir = 4
	},
/obj/machinery/atmospherics/pipe/simple/supply/hidden/layer1{
	dir = 8
	},
/turf/open/floor/carpet/royalblack,
/area/crew_quarters/dorms)
"R" = (
/obj/structure/bed,
/obj/machinery/airalarm{
	pixel_y = 24
	},
/obj/machinery/atmospherics/components/unary/vent_pump/on/layer1{
	dir = 8
	},
/obj/item/bedsheet/black,
/turf/open/floor/carpet/royalblack,
/area/crew_quarters/dorms)
"X" = (
/obj/machinery/atmospherics/pipe/simple/scrubbers/hidden/layer3{
	dir = 4
	},
/obj/machinery/atmospherics/pipe/simple/supply/hidden/layer1{
	dir = 8
	},
/turf/open/floor/plasteel,
/area/crew_quarters/dorms)
"Z" = (
/obj/machinery/light/small{
	dir = 8
	},
/obj/machinery/atmospherics/components/unary/vent_scrubber/on/layer3{
	dir = 4
	},
/obj/structure/table,
/turf/open/floor/carpet/royalblack,
/area/crew_quarters/dorms)

(1,1,1) = {"
E
E
E
E
"}
(2,1,1) = {"
E
Z
w
E
"}
(3,1,1) = {"
E
h
H
E
"}
(4,1,1) = {"
E
R
O
E
"}
(5,1,1) = {"
E
E
X
E
"}
