// This map has been converted using maphash
"aav" = (/obj/structure/cable{icon_state = "1-2"},/turf/closed/wall/r_wall,/area/engine/engineering)
"aaW" = (/obj/machinery/atmospherics/components/unary/portables_connector/visible{dir = 4},/turf/open/floor/plasteel,/area/engine/engineering)
"ady" = (/obj/machinery/atmospherics/pipe/simple/supply/hidden/layer1{dir = 8; icon_state = "pipe11-1"},/obj/structure/cable/yellow{icon_state = "4-8"},/obj/structure/cable/yellow{icon_state = "2-8"},/obj/machinery/atmospherics/pipe/manifold/scrubbers/hidden/layer3{dir = 1; icon_state = "manifold-3"},/turf/open/floor/plasteel,/area/engine/engineering)
"alq" = (/obj/machinery/atmospherics/pipe/simple/supply/hidden/layer1{dir = 8; icon_state = "pipe11-1"},/obj/machinery/atmospherics/pipe/simple/scrubbers/hidden/layer3{dir = 4; icon_state = "pipe11-3"},/turf/open/floor/plasteel,/area/engine/engineering)
"amJ" = (/obj/machinery/power/grounding_rod,/turf/open/floor/plating/airless,/area/engine/engineering)
"arG" = (/turf/template_noop,/area/template_noop)
"aQp" = (/obj/structure/reagent_dispensers/watertank,/obj/effect/turf_decal/stripes/line{dir = 6},/turf/open/floor/plasteel,/area/engine/engineering)
"aSe" = (/obj/effect/spawner/structure/window/reinforced,/obj/machinery/door/firedoor/window,/turf/open/floor/plating,/area/engine/engineering)
"aZI" = (/obj/item/tank/internals/emergency_oxygen/engi{pixel_x = 5},/obj/item/clothing/gloves/color/black,/obj/item/clothing/glasses/meson/engine,/obj/structure/table,/turf/open/floor/plasteel,/area/engine/engineering)
"baW" = (/obj/structure/lattice/catwalk,/obj/structure/cable/yellow{icon_state = "1-2"},/obj/structure/cable/yellow{icon_state = "1-8"},/turf/open/space/basic,/area/space)
"bbY" = (/obj/effect/turf_decal/stripes/line{dir = 9},/turf/open/floor/engine,/area/engine/engineering)
"bvq" = (/obj/structure/lattice/catwalk,/obj/structure/cable/yellow{icon_state = "1-2"},/obj/structure/cable/yellow{icon_state = "1-4"},/turf/open/space/basic,/area/space)
"bGq" = (/obj/structure/cable{icon_state = "1-8"},/turf/open/floor/plating/airless,/area/engine/engineering)
"bQK" = (/obj/structure/table,/obj/item/clothing/gloves/color/yellow,/obj/item/storage/toolbox/electrical{pixel_y = 5},/turf/open/floor/plasteel,/area/engine/engineering)
"bRc" = (/obj/machinery/camera/emp_proof{c_tag = "Engineering Singularity Southwest"; dir = 1; network = list("ss13","engine")},/turf/open/floor/plating/airless,/area/engine/engineering)
"bUt" = (/obj/structure/sign/warning/securearea,/turf/closed/wall/r_wall,/area/engine/engineering)
"cdb" = (/obj/structure/cable{icon_state = "1-2"},/obj/structure/cable{icon_state = "1-4"},/obj/structure/grille,/turf/open/floor/plating/airless,/area/engine/engineering)
"cfu" = (/obj/effect/turf_decal/stripes/corner{dir = 8; icon_state = "warninglinecorner"},/turf/open/floor/plasteel,/area/engine/engineering)
"cje" = (/obj/structure/closet/emcloset/anchored,/obj/machinery/light/small{dir = 4},/turf/open/floor/plating,/area/engine/engineering)
"cyI" = (/obj/effect/turf_decal/stripes/line,/turf/open/floor/plasteel,/area/engine/engineering)
"cyR" = (/obj/structure/chair/stool,/turf/open/floor/plasteel,/area/engine/engineering)
"czB" = (/obj/structure/lattice/catwalk,/obj/structure/cable/yellow{icon_state = "1-4"},/turf/open/space/basic,/area/space)
"cBE" = (/turf/open/floor/engine,/area/engine/engineering)
"cEN" = (/turf/open/floor/plating/airless,/area/space)
"cHL" = (/obj/machinery/camera/emp_proof{c_tag = "Engineering Singularity Southeast"; dir = 1; network = list("ss13","engine")},/turf/open/floor/plating/airless,/area/engine/engineering)
"cJd" = (/turf/open/floor/plating/airless,/area/engine/engineering)
"dfV" = (/obj/machinery/atmospherics/pipe/simple/scrubbers/hidden/layer3{dir = 4; icon_state = "pipe11-3"},/obj/structure/cable/yellow{icon_state = "4-8"},/obj/machinery/atmospherics/pipe/manifold/supply/hidden/layer1{dir = 1; icon_state = "manifold-1"},/turf/open/floor/plasteel,/area/engine/engineering)
"dqx" = (/obj/machinery/atmospherics/pipe/simple/supply/hidden/layer1{dir = 8; icon_state = "pipe11-1"},/obj/machinery/atmospherics/pipe/simple/scrubbers/hidden/layer3{dir = 4; icon_state = "pipe11-3"},/obj/effect/turf_decal/stripes/line{dir = 4},/obj/structure/cable/yellow{icon_state = "4-8"},/turf/open/floor/engine,/area/engine/engineering)
"edh" = (/obj/item/storage/toolbox/mechanical,/obj/item/flashlight,/obj/item/pipe_dispenser,/obj/structure/cable/yellow{icon_state = "2-8"},/obj/structure/table,/turf/open/floor/plasteel,/area/engine/engineering)
"ehu" = (/obj/effect/turf_decal/stripes/line{dir = 1},/turf/open/floor/engine,/area/engine/engineering)
"emq" = (/obj/structure/sign/warning/vacuum/external{pixel_x = 32},/obj/structure/cable{icon_state = "1-2"},/turf/open/floor/plating,/area/engine/engineering)
"evf" = (/obj/effect/turf_decal/stripes/line{dir = 1},/obj/machinery/light{dir = 1; light_color = "#c1caff"},/obj/machinery/camera/emp_proof{c_tag = "Engineering Particle Accelerator"; network = list("ss13","engine")},/turf/open/floor/engine,/area/engine/engineering)
"eOL" = (/obj/machinery/atmospherics/pipe/simple/supply/hidden/layer1{dir = 8; icon_state = "pipe11-1"},/obj/machinery/atmospherics/pipe/simple/scrubbers/hidden/layer3{dir = 4; icon_state = "pipe11-3"},/obj/effect/turf_decal/stripes/line{dir = 8},/obj/structure/cable/yellow{icon_state = "4-8"},/turf/open/floor/engine,/area/engine/engineering)
"fwF" = (/obj/structure/rack,/obj/item/clothing/gloves/color/black,/obj/item/extinguisher,/turf/open/floor/plasteel,/area/engine/engineering)
"fFl" = (/obj/structure/particle_accelerator/fuel_chamber,/turf/open/floor/engine,/area/engine/engineering)
"fVw" = (/obj/effect/turf_decal/stripes/line,/obj/machinery/light,/turf/open/floor/plasteel,/area/engine/engineering)
"gfT" = (/obj/structure/reagent_dispensers/fueltank,/obj/effect/turf_decal/stripes/line{dir = 10},/turf/open/floor/plasteel,/area/engine/engineering)
"gyI" = (/obj/structure/cable/yellow{icon_state = "0-8"},/turf/open/floor/plating/airless,/area/space)
"gJS" = (/turf/open/floor/plasteel,/area/engine/engineering)
"gNp" = (/obj/machinery/atmospherics/pipe/simple/orange/hidden{dir = 9},/turf/closed/wall,/area/engine/engineering)
"haU" = (/obj/structure/cable{icon_state = "1-2"},/obj/machinery/atmospherics/pipe/simple/supply/hidden/layer1,/obj/machinery/atmospherics/pipe/simple/scrubbers/hidden/layer3,/turf/open/floor/plasteel,/area/engine/engineering)
"hfQ" = (/obj/effect/turf_decal/stripes/line{dir = 6},/turf/open/floor/engine,/area/engine/engineering)
"huH" = (/obj/structure/sign/warning/radiation/rad_area,/turf/closed/wall/r_wall,/area/engine/engineering)
"hzR" = (/obj/effect/turf_decal/stripes/corner,/turf/open/floor/plasteel,/area/engine/engineering)
"hBR" = (/obj/structure/cable{icon_state = "1-8"},/obj/structure/grille,/turf/open/floor/plating/airless,/area/engine/engineering)
"hEH" = (/obj/structure/closet/radiation,/turf/open/floor/plasteel,/area/engine/engineering)
"hNv" = (/obj/machinery/door/airlock/engineering{name = "Telecoms Satellite Monitoring"; req_one_access_txt = "10;61"},/obj/structure/cable{icon_state = "4-8"},/obj/machinery/atmospherics/pipe/simple/supply/hidden/layer1{dir = 8; icon_state = "pipe11-1"},/obj/machinery/atmospherics/pipe/simple/scrubbers/hidden/layer3{dir = 4; icon_state = "pipe11-3"},/obj/machinery/door/firedoor/border_only{dir = 8},/obj/machinery/door/firedoor/border_only{dir = 4},/turf/open/floor/plasteel,/area/engine/engineering)
"hSF" = (/obj/machinery/atmospherics/pipe/simple/supply/hidden/layer1{dir = 8; icon_state = "pipe11-1"},/obj/structure/cable/yellow{icon_state = "2-8"},/obj/machinery/atmospherics/pipe/manifold/scrubbers/hidden/layer3{dir = 1; icon_state = "manifold-3"},/turf/open/floor/plasteel,/area/engine/engineering)
"ihJ" = (/obj/structure/cable{icon_state = "4-8"},/obj/machinery/atmospherics/pipe/simple/supply/hidden/layer1{dir = 8; icon_state = "pipe11-1"},/obj/machinery/atmospherics/pipe/simple/scrubbers/hidden/layer3{dir = 4; icon_state = "pipe11-3"},/turf/open/floor/plasteel,/area/engine/engineering)
"ihP" = (/obj/structure/particle_accelerator/power_box,/turf/open/floor/engine,/area/engine/engineering)
"ihQ" = (/obj/structure/table,/obj/item/clothing/suit/radiation,/obj/item/clothing/head/radiation,/obj/item/clothing/glasses/meson,/turf/open/floor/plasteel,/area/engine/engineering)
"ihX" = (/obj/effect/mapping_helpers/airlock/cyclelink_helper,/obj/machinery/door/airlock/external{name = "Engineering External Access"; req_access_txt = "10;13"},/obj/structure/cable{icon_state = "1-2"},/obj/machinery/door/firedoor/border_only{dir = 1},/obj/machinery/door/firedoor/border_only,/turf/open/floor/plating,/area/engine/engineering)
"iiL" = (/obj/item/screwdriver,/turf/open/floor/engine,/area/engine/engineering)
"iCb" = (/obj/item/wrench,/turf/open/space/basic,/area/space)
"iEy" = (/obj/structure/grille,/turf/open/floor/plating/airless,/area/engine/engineering)
"iYc" = (/obj/effect/turf_decal/stripes/line{dir = 10},/turf/open/floor/engine,/area/engine/engineering)
"jkb" = (/obj/structure/cable/yellow{icon_state = "4-8"},/turf/open/floor/plasteel,/area/engine/engineering)
"jpL" = (/obj/machinery/atmospherics/pipe/simple/supply/hidden/layer1{dir = 8; icon_state = "pipe11-1"},/obj/machinery/atmospherics/pipe/simple/scrubbers/hidden/layer3{dir = 4; icon_state = "pipe11-3"},/obj/structure/cable/yellow{icon_state = "4-8"},/turf/open/floor/plasteel,/area/engine/engineering)
"jKI" = (/obj/effect/spawner/structure/window/reinforced,/turf/open/floor/plating,/area/engine/engineering)
"jMJ" = (/obj/effect/turf_decal/stripes/line{dir = 8},/obj/item/stack/cable_coil/red,/obj/item/crowbar,/turf/open/floor/engine,/area/engine/engineering)
"kbN" = (/obj/machinery/door/poddoor/shutters/preopen{id = "engsm"; name = "Radiation Chamber Shutters"},/obj/structure/cable/yellow{icon_state = "4-8"},/obj/machinery/atmospherics/pipe/simple/scrubbers/hidden/layer3{dir = 4; icon_state = "pipe11-3"},/obj/machinery/atmospherics/pipe/simple/supply/hidden/layer1{dir = 8; icon_state = "pipe11-1"},/obj/machinery/door/firedoor/border_only{dir = 4},/obj/machinery/door/firedoor/border_only{dir = 8},/turf/open/floor/plating,/area/engine/supermatter)
"ktN" = (/obj/machinery/camera/emp_proof{c_tag = "Engineering Singularity Northwest"; network = list("ss13","engine")},/turf/open/space/basic,/area/space)
"kFb" = (/obj/structure/lattice/catwalk,/obj/structure/cable/yellow{icon_state = "1-2"},/turf/open/space/basic,/area/space)
"lkn" = (/obj/structure/particle_accelerator/particle_emitter/center,/turf/open/floor/engine,/area/engine/engineering)
"lqG" = (/obj/structure/rack,/obj/item/clothing/gloves/color/yellow,/turf/open/floor/plasteel,/area/engine/engineering)
"lyQ" = (/obj/machinery/atmospherics/pipe/simple/supply/hidden/layer1{dir = 8; icon_state = "pipe11-1"},/obj/machinery/atmospherics/pipe/simple/scrubbers/hidden/layer3{dir = 4; icon_state = "pipe11-3"},/obj/structure/cable/yellow{icon_state = "4-8"},/obj/structure/cable/yellow{icon_state = "2-8"},/turf/open/floor/engine,/area/engine/engineering)
"lRT" = (/obj/effect/mapping_helpers/airlock/cyclelink_helper{dir = 1},/obj/machinery/door/airlock/external{name = "Engineering External Access"; req_access_txt = "10;13"},/obj/structure/cable{icon_state = "1-2"},/turf/open/floor/plating,/area/engine/engineering)
"mnC" = (/obj/item/screwdriver,/turf/open/space/basic,/area/space)
"mvs" = (/obj/effect/turf_decal/stripes/line{dir = 4},/turf/open/floor/engine,/area/engine/engineering)
"mJM" = (/obj/structure/cable/yellow{icon_state = "1-2"},/obj/machinery/atmospherics/components/unary/vent_scrubber/on/layer3{dir = 1},/turf/open/floor/plasteel,/area/engine/engineering)
"mRM" = (/obj/machinery/power/grounding_rod,/obj/machinery/light{dir = 4},/turf/open/floor/plating/airless,/area/engine/engineering)
"ncQ" = (/obj/effect/turf_decal/stripes/line{dir = 8},/turf/open/floor/plasteel,/area/engine/engineering)
"nCW" = (/obj/effect/spawner/structure/window/plasma/reinforced,/obj/machinery/door/poddoor/shutters/preopen{id = "engsm"; name = "Radiation Chamber Shutters"},/obj/structure/cable/yellow{icon_state = "1-2"},/obj/machinery/door/firedoor/window,/turf/open/floor/plating,/area/engine/engineering)
"nDd" = (/obj/structure/lattice/catwalk,/turf/open/space/basic,/area/space)
"nNb" = (/obj/item/weldingtool,/turf/open/space/basic,/area/space)
"nNS" = (/obj/structure/closet/wardrobe/engineering_yellow,/turf/open/floor/plasteel,/area/engine/engineering)
"obj" = (/obj/structure/table,/obj/item/storage/toolbox/mechanical{pixel_y = 5},/obj/item/flashlight{pixel_x = 1; pixel_y = 5},/obj/item/flashlight{pixel_x = 1; pixel_y = 5},/obj/effect/turf_decal/stripes/line,/turf/open/floor/plasteel,/area/engine/engineering)
"ocn" = (/obj/machinery/light/small{dir = 8},/obj/structure/closet/emcloset/anchored,/turf/open/floor/plating,/area/engine/engineering)
"ojb" = (/obj/effect/turf_decal/stripes/line{dir = 4},/turf/open/floor/plasteel,/area/engine/engineering)
"oBe" = (/obj/machinery/atmospherics/pipe/simple/supply/hidden/layer1{dir = 8; icon_state = "pipe11-1"},/obj/machinery/atmospherics/pipe/simple/scrubbers/hidden/layer3{dir = 4; icon_state = "pipe11-3"},/obj/structure/cable/yellow{icon_state = "1-4"},/turf/open/floor/plasteel,/area/engine/engineering)
"oIp" = (/turf/open/floor/plating/airless,/area/space/nearstation)
"oLS" = (/obj/machinery/the_singularitygen/tesla,/turf/open/floor/plating/airless,/area/space/nearstation)
"oVy" = (/obj/effect/turf_decal/stripes/line{dir = 8},/obj/machinery/button/door{dir = 8; id = "engsm"; name = "Radiation Shutters Control"; pixel_x = -24; pixel_y = 0; req_access_txt = "10"},/turf/open/floor/engine,/area/engine/engineering)
"oXT" = (/obj/effect/turf_decal/stripes/line,/obj/structure/cable/yellow{icon_state = "1-2"},/turf/open/floor/plasteel,/area/engine/engineering)
"oYI" = (/obj/structure/cable{icon_state = "1-2"},/obj/structure/cable{icon_state = "1-8"},/obj/structure/grille,/turf/open/floor/plating/airless,/area/engine/engineering)
"pjW" = (/obj/structure/cable{icon_state = "1-2"},/obj/structure/grille,/turf/open/floor/plating/airless,/area/engine/engineering)
"pmi" = (/obj/effect/turf_decal/stripes/line{dir = 5},/turf/open/floor/engine,/area/engine/engineering)
"psw" = (/obj/machinery/door/poddoor/shutters/preopen{id = "engsm"; name = "Radiation Chamber Shutters"},/obj/machinery/door/firedoor/border_only,/obj/machinery/door/firedoor/border_only{dir = 1},/turf/open/floor/plating,/area/engine/engineering)
"pXi" = (/obj/structure/cable{icon_state = "1-4"},/turf/open/floor/plating/airless,/area/engine/engineering)
"qcR" = (/obj/machinery/the_singularitygen,/turf/open/floor/plating/airless,/area/space/nearstation)
"qec" = (/obj/effect/turf_decal/stripes/line,/obj/item/wirecutters,/turf/open/floor/engine,/area/engine/engineering)
"qtV" = (/obj/machinery/atmospherics/pipe/simple/supply/hidden/layer1{dir = 8; icon_state = "pipe11-1"},/obj/machinery/atmospherics/pipe/simple/scrubbers/hidden/layer3{dir = 4; icon_state = "pipe11-3"},/obj/structure/cable/yellow{icon_state = "4-8"},/turf/open/floor/engine,/area/engine/engineering)
"qAH" = (/obj/structure/lattice,/turf/open/space/basic,/area/space/nearstation)
"qFs" = (/obj/structure/cable{icon_state = "1-4"},/obj/machinery/atmospherics/pipe/manifold/supply/hidden/layer1,/obj/machinery/atmospherics/pipe/manifold/scrubbers/hidden/layer3,/obj/structure/cable{icon_state = "1-2"},/turf/open/floor/plasteel,/area/engine/engineering)
"qIT" = (/obj/item/wirecutters,/turf/open/space/basic,/area/space)
"qOF" = (/obj/machinery/power/tesla_coil,/turf/open/floor/plating/airless,/area/engine/engineering)
"qQF" = (/obj/machinery/atmospherics/pipe/simple/supply/hidden/layer1{dir = 8; icon_state = "pipe11-1"},/obj/machinery/atmospherics/pipe/simple/scrubbers/hidden/layer3{dir = 4; icon_state = "pipe11-3"},/obj/structure/particle_accelerator/end_cap,/obj/structure/cable/yellow{icon_state = "4-8"},/turf/open/floor/engine,/area/engine/engineering)
"rmG" = (/obj/structure/cable/yellow{icon_state = "1-2"},/turf/open/floor/plasteel,/area/engine/engineering)
"rmP" = (/obj/machinery/atmospherics/pipe/simple/supply/hidden/layer1{dir = 8; icon_state = "pipe11-1"},/obj/machinery/atmospherics/pipe/simple/scrubbers/hidden/layer3{dir = 4; icon_state = "pipe11-3"},/obj/structure/cable/yellow{icon_state = "4-8"},/obj/machinery/door/poddoor/shutters/preopen{id = "engsm"; name = "Radiation Chamber Shutters"},/obj/machinery/door/firedoor/border_only{dir = 4},/obj/machinery/door/firedoor/border_only{dir = 8},/turf/open/floor/plating,/area/engine/engineering)
"rpk" = (/obj/effect/spawner/structure/window/plasma/reinforced,/obj/machinery/door/poddoor/shutters/preopen{id = "engsm"; name = "Radiation Chamber Shutters"},/obj/machinery/door/firedoor/window,/turf/open/floor/plating,/area/engine/engineering)
"rtf" = (/obj/structure/particle_accelerator/particle_emitter/left,/turf/open/floor/engine,/area/engine/engineering)
"rZS" = (/obj/effect/turf_decal/stripes/line,/turf/open/floor/engine,/area/engine/engineering)
"saW" = (/obj/structure/cable/yellow{icon_state = "0-4"},/turf/open/floor/plating/airless,/area/space)
"srB" = (/obj/machinery/power/emitter/anchored{dir = 4; state = 2},/obj/structure/cable{icon_state = "0-8"},/turf/open/floor/plating/airless,/area/engine/engineering)
"sEr" = (/obj/structure/sign/warning/vacuum/external{pixel_x = -32},/obj/structure/cable{icon_state = "1-2"},/turf/open/floor/plating,/area/engine/engineering)
"sJz" = (/obj/structure/cable{icon_state = "2-8"},/obj/structure/grille,/turf/open/floor/plating/airless,/area/engine/engineering)
"sQE" = (/obj/structure/sign/warning/electricshock,/turf/closed/wall/r_wall,/area/engine/engineering)
"tmm" = (/obj/structure/lattice/catwalk,/obj/structure/cable/yellow{icon_state = "1-8"},/turf/open/space/basic,/area/space)
"tMq" = (/obj/structure/table,/obj/item/book/manual/wiki/engineering_singulo_tesla,/obj/item/geiger_counter,/turf/open/floor/plasteel,/area/engine/engineering)
"tYl" = (/obj/effect/turf_decal/stripes/line{dir = 8},/turf/open/floor/engine,/area/engine/engineering)
"uaK" = (/obj/machinery/light,/turf/open/floor/plating/airless,/area/engine/engineering)
"upt" = (/obj/effect/spawner/structure/window/plasma/reinforced,/obj/machinery/door/poddoor/shutters/preopen{id = "engsm"; name = "Radiation Chamber Shutters"},/turf/open/floor/plating,/area/engine/engineering)
"uRn" = (/obj/structure/cable{icon_state = "2-4"},/obj/structure/grille,/turf/open/floor/plating/airless,/area/engine/engineering)
"viR" = (/obj/machinery/atmospherics/pipe/simple/supply/hidden/layer1{dir = 5; icon_state = "pipe11-1"},/obj/machinery/atmospherics/pipe/simple/scrubbers/hidden/layer3{dir = 5; icon_state = "pipe11-3"},/obj/structure/cable{icon_state = "1-2"},/turf/open/floor/plasteel,/area/engine/engineering)
"vyi" = (/turf/closed/wall,/area/engine/engineering)
"vCp" = (/obj/structure/cable{icon_state = "1-4"},/obj/structure/grille,/turf/open/floor/plating/airless,/area/engine/engineering)
"vIE" = (/obj/machinery/atmospherics/components/unary/vent_pump/on/layer1{dir = 1; icon_state = "vent_map_on-1"},/obj/machinery/button/door{dir = 8; id = "engsm"; name = "Radiation Shutters Control"; pixel_x = -24; pixel_y = 0; req_access_txt = "10"},/turf/open/floor/plasteel,/area/engine/engineering)
"vLP" = (/obj/machinery/power/emitter/anchored{dir = 8; state = 2},/obj/structure/cable{icon_state = "0-4"},/turf/open/floor/plating/airless,/area/engine/engineering)
"vTB" = (/obj/machinery/power/rad_collector,/turf/open/floor/plating/airless,/area/engine/engineering)
"vUB" = (/obj/structure/particle_accelerator/particle_emitter/right,/turf/open/floor/engine,/area/engine/engineering)
"wfi" = (/obj/machinery/power/grounding_rod,/obj/machinery/light{dir = 8},/turf/open/floor/plating/airless,/area/engine/engineering)
"wka" = (/obj/machinery/door/poddoor/shutters/preopen{id = "engsm"; name = "Radiation Chamber Shutters"},/obj/machinery/door/poddoor/shutters/preopen{id = "engsm"; name = "Radiation Chamber Shutters"},/obj/machinery/door/firedoor/border_only,/obj/machinery/door/firedoor/border_only{dir = 1},/turf/open/floor/plating,/area/engine/engineering)
"wCr" = (/obj/machinery/field/generator{anchored = 1; state = 2},/turf/open/floor/plating/airless,/area/space)
"wCy" = (/obj/effect/turf_decal/stripes/line{dir = 4},/obj/machinery/button/door{dir = 4; id = "engsm"; name = "Radiation Shutters Control"; pixel_x = 24; pixel_y = 0; req_access_txt = "10"},/turf/open/floor/engine,/area/engine/engineering)
"wFy" = (/obj/machinery/particle_accelerator/control_box,/obj/structure/cable/yellow,/turf/open/floor/engine,/area/engine/engineering)
"wHV" = (/obj/machinery/door/airlock/external{name = "Engineering External Access"; req_access_txt = "10;13"},/turf/open/floor/plating/airless,/area/engine/engineering)
"wKQ" = (/turf/closed/wall/r_wall,/area/engine/engineering)
"wZP" = (/turf/open/space/basic,/area/space)
"xEr" = (/obj/machinery/atmospherics/components/unary/vent_pump/on/layer1{dir = 1; icon_state = "vent_map_on-1"},/obj/machinery/button/door{dir = 4; id = "engsm"; name = "Radiation Shutters Control"; pixel_x = 24; pixel_y = 0; req_access_txt = "10"},/turf/open/floor/plasteel,/area/engine/engineering)
"xJd" = (/obj/structure/cable{icon_state = "1-2"},/turf/open/floor/plasteel,/area/engine/engineering)
"ydM" = (/obj/machinery/camera/emp_proof{c_tag = "Engineering Singularity Northeast"; network = list("ss13","engine")},/turf/open/space/basic,/area/space)

(1,1,1) = {"
arG
arG
arG
arG
arG
arG
arG
wZP
wZP
wZP
wZP
wZP
wZP
wZP
wZP
wZP
wZP
wZP
wZP
wZP
wZP
arG
arG
arG
arG
arG
"}
(2,1,1) = {"
arG
arG
arG
arG
arG
arG
arG
wZP
wZP
wZP
wZP
wZP
wZP
wZP
wZP
wZP
wZP
wZP
wZP
wZP
wZP
arG
arG
arG
arG
arG
"}
(3,1,1) = {"
arG
arG
arG
arG
arG
arG
arG
wZP
wZP
wZP
wZP
wZP
wZP
wZP
wZP
wZP
wZP
wZP
wZP
wZP
wZP
arG
arG
arG
arG
arG
"}
(4,1,1) = {"
arG
arG
arG
arG
arG
arG
arG
wZP
wZP
wZP
wZP
wZP
wZP
wZP
wZP
wZP
wZP
wZP
wZP
wZP
wZP
arG
arG
arG
arG
arG
"}
(5,1,1) = {"
arG
arG
arG
arG
arG
arG
arG
qAH
wZP
wZP
wZP
wZP
wZP
wZP
wZP
wZP
wZP
wZP
wZP
wZP
wZP
arG
arG
arG
arG
arG
"}
(6,1,1) = {"
arG
arG
arG
arG
arG
arG
arG
oIp
qAH
wZP
wZP
wZP
wZP
qAH
wZP
wZP
wZP
wZP
wZP
wZP
wZP
arG
arG
arG
arG
arG
"}
(7,1,1) = {"
arG
arG
arG
arG
vyi
vyi
wKQ
wKQ
wKQ
wKQ
wKQ
wKQ
wKQ
huH
wKQ
wKQ
wKQ
wKQ
sQE
wKQ
bUt
qAH
qAH
wZP
wZP
wZP
"}
(8,1,1) = {"
arG
arG
bQK
obj
vyi
ocn
wKQ
uRn
pjW
cdb
pjW
pjW
aav
aav
aav
pjW
pjW
vCp
iEy
iEy
wKQ
wZP
wZP
wZP
wZP
wZP
"}
(9,1,1) = {"
arG
arG
viR
xJd
ihX
emq
lRT
bGq
cJd
srB
qOF
qOF
qOF
wfi
vTB
vTB
vTB
srB
cJd
cJd
wHV
cJd
wZP
wZP
wZP
wZP
"}
(10,1,1) = {"
arG
jkb
alq
fVw
huH
wKQ
wKQ
ktN
wZP
cJd
cJd
cJd
cJd
amJ
cJd
cJd
cJd
cJd
cJd
cJd
wKQ
wKQ
iEy
wZP
wZP
wZP
"}
(11,1,1) = {"
aZI
edh
oBe
cfu
ncQ
gfT
wKQ
wZP
wZP
qAH
nDd
nDd
nDd
nDd
nDd
nDd
nDd
qAH
wZP
cJd
bRc
wKQ
iEy
wZP
wZP
wZP
"}
(12,1,1) = {"
gJS
gJS
ady
mJM
rmG
oXT
nCW
kFb
kFb
kFb
bvq
kFb
kFb
bvq
kFb
kFb
czB
qAH
wZP
qAH
cJd
wKQ
iEy
wZP
wZP
wZP
"}
(13,1,1) = {"
gJS
gJS
jpL
cyR
gJS
cyI
rpk
wZP
wZP
qAH
gyI
cEN
qAH
gyI
wZP
cEN
gyI
qAH
wZP
qAH
uaK
wKQ
iEy
qAH
wZP
wZP
"}
(14,1,1) = {"
nNS
fwF
dfV
xEr
gJS
cyI
rpk
aSe
qAH
wCr
wZP
wZP
wCr
wZP
wZP
wZP
wZP
wCr
qAH
qAH
cJd
wKQ
huH
qAH
wZP
wZP
"}
(15,1,1) = {"
huH
wKQ
kbN
wKQ
wKQ
upt
upt
aSe
qAH
wZP
wZP
wZP
qAH
wZP
wZP
wZP
mnC
wZP
wZP
wZP
cJd
wKQ
iEy
qAH
wZP
wZP
"}
(16,1,1) = {"
wKQ
bbY
eOL
oVy
jMJ
tYl
iYc
jKI
wZP
wZP
wZP
wZP
qAH
wZP
wZP
wZP
wZP
wZP
wZP
qAH
cJd
wKQ
iEy
wZP
wZP
wZP
"}
(17,1,1) = {"
wka
ehu
lyQ
wFy
cBE
rtf
rZS
jKI
wZP
wZP
wZP
wZP
oIp
oLS
oIp
qAH
qAH
wCr
qAH
qAH
cJd
wKQ
iEy
wZP
wZP
wZP
"}
(18,1,1) = {"
wKQ
evf
qQF
fFl
ihP
lkn
qec
jKI
qAH
wZP
wZP
iCb
oIp
oIp
oIp
wZP
wZP
wZP
wZP
qAH
uaK
wKQ
iEy
wZP
wZP
wZP
"}
(19,1,1) = {"
psw
ehu
qtV
cBE
iiL
vUB
rZS
jKI
qAH
wCr
qAH
qAH
oIp
qcR
oIp
wZP
wZP
wZP
wZP
wZP
cJd
wKQ
iEy
wZP
wZP
wZP
"}
(20,1,1) = {"
wKQ
pmi
dqx
wCy
mvs
mvs
hfQ
jKI
qAH
wZP
wZP
wZP
wZP
wZP
qAH
qIT
wZP
wZP
wZP
wZP
cJd
wKQ
iEy
qAH
wZP
wZP
"}
(21,1,1) = {"
huH
wKQ
rmP
wKQ
wKQ
upt
upt
aSe
qAH
wZP
wZP
wZP
nNb
wZP
qAH
wZP
wZP
wZP
wZP
wZP
cJd
wKQ
iEy
qAH
wZP
wZP
"}
(22,1,1) = {"
hEH
lqG
dfV
vIE
gJS
cyI
rpk
aSe
qAH
wCr
wZP
wZP
wZP
wZP
wCr
wZP
wZP
wCr
qAH
qAH
cJd
wKQ
huH
qAH
wZP
wZP
"}
(23,1,1) = {"
gJS
gJS
jpL
gJS
gJS
cyI
rpk
wZP
wZP
qAH
saW
cEN
wZP
saW
qAH
cEN
saW
qAH
wZP
qAH
uaK
wKQ
iEy
qAH
wZP
wZP
"}
(24,1,1) = {"
gJS
gJS
hSF
mJM
rmG
oXT
nCW
kFb
kFb
kFb
baW
kFb
kFb
baW
kFb
kFb
tmm
qAH
wZP
qAH
cJd
wKQ
iEy
wZP
wZP
wZP
"}
(25,1,1) = {"
ihQ
tMq
alq
hzR
ojb
aQp
wKQ
wZP
wZP
qAH
nDd
nDd
nDd
nDd
nDd
nDd
nDd
qAH
wZP
cJd
cHL
wKQ
iEy
wZP
wZP
wZP
"}
(26,1,1) = {"
gJS
gJS
alq
fVw
huH
wKQ
wKQ
ydM
wZP
cJd
cJd
cJd
cJd
amJ
cJd
cJd
cJd
cJd
cJd
cJd
wKQ
wKQ
iEy
wZP
wZP
wZP
"}
(27,1,1) = {"
arG
haU
qFs
xJd
ihX
sEr
lRT
pXi
cJd
vLP
qOF
qOF
qOF
mRM
vTB
vTB
vTB
vLP
cJd
cJd
wHV
cJd
wZP
wZP
wZP
wZP
"}
(28,1,1) = {"
arG
aaW
ihJ
cyI
vyi
cje
wKQ
sJz
pjW
oYI
pjW
pjW
aav
aav
aav
pjW
pjW
hBR
iEy
iEy
wKQ
qAH
wZP
wZP
wZP
wZP
"}
(29,1,1) = {"
arG
gNp
hNv
vyi
vyi
vyi
wKQ
wKQ
wKQ
wKQ
wKQ
wKQ
wKQ
huH
wKQ
wKQ
wKQ
wKQ
sQE
wKQ
bUt
qAH
qAH
qAH
wZP
wZP
"}
