//MAP CONVERTED BY dmm2tgm.py THIS HEADER COMMENT PREVENTS RECONVERSION, DO NOT REMOVE
"a" = (
/obj/machinery/atmospherics/pipe/simple/supply/hidden/layer1,
/obj/machinery/atmospherics/pipe/simple/scrubbers/hidden/layer3{
	dir = 9
	},
/turf/template_noop,
/area/hydroponics)
"e" = (
/obj/structure/sink{
	dir = 8;
	pixel_x = -12;
	pixel_y = 2
	},
/turf/template_noop,
/area/hydroponics)
"f" = (
/obj/machinery/vending/hydronutrients,
/turf/template_noop,
/area/hydroponics)
"p" = (
/obj/effect/landmark/start/botanist,
/turf/template_noop,
/area/hydroponics)
"t" = (
/obj/machinery/atmospherics/pipe/simple/scrubbers/hidden/layer3{
	dir = 6
	},
/turf/template_noop,
/area/hydroponics)
"u" = (
/obj/structure/reagent_dispensers/watertank/high,
/turf/template_noop,
/area/hydroponics)
"v" = (
/obj/machinery/disposal/bin,
/obj/structure/disposalpipe/trunk{
	dir = 8
	},
/turf/template_noop,
/area/hydroponics)
"B" = (
/obj/machinery/biogenerator,
/turf/template_noop,
/area/hydroponics)
"I" = (
/obj/effect/landmark/start/botanist,
/obj/structure/chair/stool,
/turf/template_noop,
/area/hydroponics)
"K" = (
/obj/structure/disposalpipe/segment{
	dir = 5
	},
/obj/machinery/atmospherics/pipe/simple/supply/hidden/layer1,
/obj/machinery/atmospherics/pipe/simple/scrubbers/hidden/layer3,
/turf/template_noop,
/area/hydroponics)
"M" = (
/obj/item/reagent_containers/glass/bucket,
/turf/template_noop,
/area/hydroponics)
"N" = (
/turf/template_noop,
/area/hydroponics)
"O" = (
/obj/machinery/atmospherics/pipe/simple/supply/hidden/layer1,
/obj/machinery/atmospherics/pipe/simple/scrubbers/hidden/layer3,
/turf/template_noop,
/area/hydroponics)
"P" = (
/obj/machinery/atmospherics/components/unary/vent_pump/on/layer1{
	dir = 1
	},
/turf/template_noop,
/area/hydroponics)
"Q" = (
/obj/machinery/atmospherics/pipe/simple/scrubbers/hidden/layer3{
	dir = 4
	},
/turf/template_noop,
/area/hydroponics)
"R" = (
/obj/machinery/hydroponics/constructable,
/turf/template_noop,
/area/hydroponics)
"S" = (
/obj/machinery/atmospherics/components/unary/vent_scrubber/on/layer3{
	dir = 1
	},
/turf/template_noop,
/area/hydroponics)
"U" = (
/obj/structure/table/glass,
/turf/template_noop,
/area/hydroponics)
"Y" = (
/obj/machinery/seed_extractor,
/turf/template_noop,
/area/hydroponics)
"Z" = (
/obj/machinery/vending/hydroseeds{
	slogan_delay = 700
	},
/turf/template_noop,
/area/hydroponics)

(1,1,1) = {"
u
e
R
N
N
R
R
R
e
"}
(2,1,1) = {"
Y
N
t
S
N
N
N
N
N
"}
(3,1,1) = {"
B
N
Q
U
U
p
N
N
N
"}
(4,1,1) = {"
R
N
Q
R
R
M
N
f
N
"}
(5,1,1) = {"
R
N
Q
R
R
N
N
Z
N
"}
(6,1,1) = {"
R
N
Q
N
N
N
N
I
N
"}
(7,1,1) = {"
K
O
a
P
N
N
N
M
N
"}
(8,1,1) = {"
v
R
R
R
R
R
R
u
N
"}
