//MAP CONVERTED BY dmm2tgm.py THIS HEADER COMMENT PREVENTS RECONVERSION, DO NOT REMOVE
"a" = (
/obj/structure/sink{
	dir = 4;
	pixel_x = 11
	},
/turf/template_noop,
/area/hydroponics)
"d" = (
/obj/machinery/atmospherics/components/unary/vent_pump/on/layer1{
	dir = 1
	},
/obj/effect/turf_decal/tile/green{
	dir = 8
	},
/obj/effect/turf_decal/tile/green{
	dir = 1
	},
/turf/template_noop,
/area/hydroponics)
"e" = (
/obj/structure/table/glass,
/obj/item/stack/packageWrap,
/obj/item/stack/packageWrap,
/obj/item/hand_labeler,
/turf/template_noop,
/area/hydroponics)
"f" = (
/obj/effect/turf_decal/tile/green{
	dir = 4
	},
/turf/template_noop,
/area/hydroponics)
"g" = (
/obj/machinery/biogenerator,
/turf/template_noop,
/area/hydroponics)
"h" = (
/obj/machinery/atmospherics/pipe/simple/scrubbers/hidden/layer3{
	dir = 6
	},
/obj/machinery/hydroponics/constructable,
/obj/effect/turf_decal/tile/black{
	dir = 1
	},
/obj/effect/turf_decal/tile/black{
	dir = 4
	},
/obj/effect/turf_decal/tile/black,
/obj/effect/turf_decal/tile/black{
	dir = 8
	},
/turf/template_noop,
/area/hydroponics)
"j" = (
/obj/machinery/atmospherics/pipe/simple/scrubbers/hidden/layer3{
	dir = 4
	},
/obj/machinery/hydroponics/constructable,
/obj/effect/turf_decal/tile/black{
	dir = 1
	},
/obj/effect/turf_decal/tile/black{
	dir = 4
	},
/obj/effect/turf_decal/tile/black,
/obj/effect/turf_decal/tile/black{
	dir = 8
	},
/turf/template_noop,
/area/hydroponics)
"l" = (
/obj/effect/landmark/start/botanist,
/obj/effect/turf_decal/tile/green{
	dir = 8
	},
/obj/effect/turf_decal/tile/green,
/obj/effect/turf_decal/tile/green{
	dir = 4
	},
/obj/effect/turf_decal/tile/green{
	dir = 1
	},
/turf/template_noop,
/area/hydroponics)
"m" = (
/obj/structure/reagent_dispensers/watertank/high,
/obj/item/reagent_containers/glass/bucket,
/turf/template_noop,
/area/hydroponics)
"n" = (
/obj/effect/turf_decal/tile/green{
	dir = 8
	},
/obj/effect/turf_decal/tile/green,
/obj/effect/turf_decal/tile/green{
	dir = 4
	},
/obj/effect/turf_decal/tile/green{
	dir = 1
	},
/turf/template_noop,
/area/hydroponics)
"r" = (
/obj/machinery/seed_extractor,
/turf/template_noop,
/area/hydroponics)
"s" = (
/obj/effect/turf_decal/tile/green{
	dir = 1
	},
/turf/template_noop,
/area/hydroponics)
"v" = (
/obj/structure/sink{
	dir = 8;
	pixel_x = -12;
	pixel_y = 2
	},
/turf/template_noop,
/area/hydroponics)
"w" = (
/obj/effect/turf_decal/tile/green{
	dir = 4
	},
/obj/effect/turf_decal/tile/green,
/turf/template_noop,
/area/hydroponics)
"x" = (
/obj/effect/turf_decal/tile/green{
	dir = 4
	},
/obj/effect/turf_decal/tile/green{
	dir = 1
	},
/turf/template_noop,
/area/hydroponics)
"y" = (
/obj/machinery/light{
	dir = 8
	},
/turf/template_noop,
/area/hydroponics)
"A" = (
/obj/machinery/atmospherics/components/unary/vent_scrubber/on/layer3{
	dir = 1
	},
/obj/effect/turf_decal/tile/green,
/obj/effect/turf_decal/tile/green{
	dir = 4
	},
/obj/effect/turf_decal/tile/green{
	dir = 1
	},
/turf/template_noop,
/area/hydroponics)
"B" = (
/obj/machinery/hydroponics/constructable,
/obj/effect/turf_decal/tile/black{
	dir = 4
	},
/obj/effect/turf_decal/tile/black,
/obj/effect/turf_decal/tile/black{
	dir = 8
	},
/obj/effect/turf_decal/tile/black{
	dir = 1
	},
/turf/template_noop,
/area/hydroponics)
"C" = (
/obj/machinery/light{
	dir = 4
	},
/obj/structure/disposalpipe/trunk{
	dir = 8
	},
/obj/machinery/disposal/bin,
/obj/effect/turf_decal/tile/green{
	dir = 4
	},
/obj/effect/turf_decal/tile/green{
	dir = 1
	},
/turf/template_noop,
/area/hydroponics)
"E" = (
/obj/item/twohanded/required/kirbyplants/random,
/turf/template_noop,
/area/hydroponics)
"G" = (
/obj/machinery/atmospherics/pipe/simple/supply/hidden/layer1,
/obj/machinery/atmospherics/pipe/simple/scrubbers/hidden/layer3,
/obj/effect/turf_decal/tile/green{
	dir = 8
	},
/obj/effect/turf_decal/tile/green{
	dir = 1
	},
/obj/structure/disposalpipe/segment{
	dir = 5
	},
/obj/effect/turf_decal/tile/green{
	dir = 4
	},
/turf/template_noop,
/area/hydroponics)
"H" = (
/obj/structure/chair/stool,
/obj/effect/landmark/start/botanist,
/turf/template_noop,
/area/hydroponics)
"K" = (
/obj/effect/turf_decal/tile/green,
/obj/effect/turf_decal/tile/green{
	dir = 4
	},
/turf/template_noop,
/area/hydroponics)
"M" = (
/obj/machinery/hydroponics/constructable,
/obj/effect/turf_decal/tile/black{
	dir = 1
	},
/obj/effect/turf_decal/tile/black{
	dir = 4
	},
/obj/effect/turf_decal/tile/black,
/obj/effect/turf_decal/tile/black{
	dir = 8
	},
/turf/template_noop,
/area/hydroponics)
"O" = (
/obj/structure/table/glass,
/obj/item/storage/box/syringes,
/obj/item/storage/box/beakers{
	pixel_x = 2;
	pixel_y = 2
	},
/obj/machinery/light{
	dir = 4
	},
/turf/template_noop,
/area/hydroponics)
"P" = (
/obj/machinery/vending/hydronutrients,
/turf/template_noop,
/area/hydroponics)
"Q" = (
/obj/effect/turf_decal/tile/green,
/obj/effect/turf_decal/tile/green{
	dir = 4
	},
/obj/effect/turf_decal/tile/green{
	dir = 1
	},
/obj/machinery/light{
	dir = 8
	},
/turf/template_noop,
/area/hydroponics)
"R" = (
/turf/template_noop,
/area/hydroponics)
"S" = (
/obj/effect/turf_decal/tile/green{
	dir = 4
	},
/obj/effect/turf_decal/tile/green{
	dir = 1
	},
/obj/machinery/holopad,
/turf/template_noop,
/area/hydroponics)
"T" = (
/obj/machinery/atmospherics/pipe/simple/supply/hidden/layer1,
/obj/machinery/atmospherics/pipe/simple/scrubbers/hidden/layer3{
	dir = 9
	},
/obj/effect/turf_decal/tile/green{
	dir = 8
	},
/obj/effect/turf_decal/tile/green{
	dir = 1
	},
/turf/template_noop,
/area/hydroponics)
"U" = (
/obj/effect/turf_decal/tile/green{
	dir = 8
	},
/obj/effect/turf_decal/tile/green{
	dir = 1
	},
/turf/template_noop,
/area/hydroponics)
"X" = (
/obj/machinery/vending/hydroseeds{
	slogan_delay = 700
	},
/turf/template_noop,
/area/hydroponics)
"Y" = (
/obj/machinery/atmospherics/pipe/simple/supply/hidden/layer1,
/obj/machinery/atmospherics/pipe/simple/scrubbers/hidden/layer3,
/obj/effect/turf_decal/tile/green{
	dir = 8
	},
/obj/effect/turf_decal/tile/green{
	dir = 1
	},
/obj/structure/disposalpipe/segment{
	dir = 2
	},
/obj/effect/turf_decal/tile/green{
	dir = 4
	},
/obj/effect/turf_decal/tile/green,
/turf/template_noop,
/area/hydroponics)

(1,1,1) = {"
M
Q
w
f
R
y
v
X
P
"}
(2,1,1) = {"
M
l
h
A
K
f
R
R
R
"}
(3,1,1) = {"
M
n
j
n
M
x
R
R
R
"}
(4,1,1) = {"
M
n
j
n
M
x
R
g
R
"}
(5,1,1) = {"
M
n
j
n
M
S
R
r
R
"}
(6,1,1) = {"
M
n
j
n
M
x
R
H
R
"}
(7,1,1) = {"
Y
G
T
d
U
s
R
R
R
"}
(8,1,1) = {"
B
C
E
a
e
O
m
m
R
"}
