//MAP CONVERTED BY dmm2tgm.py THIS HEADER COMMENT PREVENTS RECONVERSION, DO NOT REMOVE
"a" = (
/obj/structure/sink{
	dir = 4;
	pixel_x = 11
	},
/turf/template_noop,
/area/hydroponics)
"c" = (
/obj/structure/disposalpipe/segment{
	dir = 5
	},
/obj/machinery/atmospherics/pipe/simple/supply/hidden/layer1,
/obj/machinery/atmospherics/pipe/simple/scrubbers/hidden/layer3,
/turf/template_noop,
/area/hydroponics)
"d" = (
/obj/machinery/atmospherics/components/unary/vent_scrubber/on/layer3{
	dir = 1
	},
/turf/template_noop,
/area/hydroponics)
"f" = (
/obj/machinery/atmospherics/components/unary/vent_pump/on/layer1{
	dir = 1
	},
/turf/template_noop,
/area/hydroponics)
"g" = (
/obj/machinery/biogenerator,
/turf/template_noop,
/area/hydroponics)
"m" = (
/obj/machinery/atmospherics/pipe/simple/supply/hidden/layer1,
/obj/machinery/atmospherics/pipe/simple/scrubbers/hidden/layer3,
/turf/template_noop,
/area/hydroponics)
"o" = (
/obj/machinery/atmospherics/pipe/simple/scrubbers/hidden/layer3{
	dir = 6
	},
/turf/template_noop,
/area/hydroponics)
"r" = (
/obj/machinery/seed_extractor,
/turf/template_noop,
/area/hydroponics)
"v" = (
/obj/structure/sink{
	dir = 8;
	pixel_x = -12;
	pixel_y = 2
	},
/turf/template_noop,
/area/hydroponics)
"x" = (
/obj/item/reagent_containers/glass/bucket,
/turf/template_noop,
/area/hydroponics)
"y" = (
/obj/machinery/atmospherics/pipe/simple/scrubbers/hidden/layer3{
	dir = 4
	},
/obj/item/reagent_containers/glass/bucket,
/turf/template_noop,
/area/hydroponics)
"B" = (
/obj/machinery/atmospherics/pipe/simple/scrubbers/hidden/layer3{
	dir = 4
	},
/obj/effect/landmark/start/botanist,
/turf/template_noop,
/area/hydroponics)
"C" = (
/obj/structure/table/glass,
/turf/template_noop,
/area/hydroponics)
"E" = (
/obj/item/twohanded/required/kirbyplants/random,
/turf/template_noop,
/area/hydroponics)
"H" = (
/obj/structure/chair/stool,
/obj/effect/landmark/start/botanist,
/turf/template_noop,
/area/hydroponics)
"J" = (
/obj/machinery/atmospherics/pipe/simple/scrubbers/hidden/layer3{
	dir = 4
	},
/obj/machinery/hydroponics/constructable,
/turf/template_noop,
/area/hydroponics)
"N" = (
/obj/structure/reagent_dispensers/watertank/high,
/turf/template_noop,
/area/hydroponics)
"P" = (
/obj/machinery/vending/hydronutrients,
/turf/template_noop,
/area/hydroponics)
"R" = (
/turf/template_noop,
/area/hydroponics)
"T" = (
/obj/machinery/atmospherics/pipe/simple/supply/hidden/layer1,
/obj/machinery/atmospherics/pipe/simple/scrubbers/hidden/layer3{
	dir = 9
	},
/turf/template_noop,
/area/hydroponics)
"V" = (
/obj/machinery/hydroponics/constructable,
/turf/template_noop,
/area/hydroponics)
"X" = (
/obj/machinery/vending/hydroseeds{
	slogan_delay = 700
	},
/turf/template_noop,
/area/hydroponics)
"Y" = (
/obj/machinery/disposal/bin,
/obj/structure/disposalpipe/trunk{
	dir = 8
	},
/turf/template_noop,
/area/hydroponics)

(1,1,1) = {"
N
N
E
R
R
X
P
R
v
"}
(2,1,1) = {"
R
R
o
d
R
R
R
R
R
"}
(3,1,1) = {"
R
V
J
V
V
V
R
R
R
"}
(4,1,1) = {"
R
R
B
V
R
R
R
C
R
"}
(5,1,1) = {"
R
R
y
V
R
R
R
C
R
"}
(6,1,1) = {"
R
V
J
V
V
V
R
H
R
"}
(7,1,1) = {"
c
m
T
f
R
R
R
x
R
"}
(8,1,1) = {"
Y
V
V
V
V
g
r
a
R
"}
