//MAP CONVERTED BY dmm2tgm.py THIS HEADER COMMENT PREVENTS RECONVERSION, DO NOT REMOVE
"b" = (
/obj/structure/sink{
	dir = 8;
	pixel_x = -12;
	pixel_y = 2
	},
/obj/effect/turf_decal/tile/green{
	dir = 1
	},
/obj/effect/turf_decal/tile/green{
	dir = 4
	},
/turf/template_noop,
/area/hydroponics)
"c" = (
/obj/machinery/atmospherics/pipe/simple/supply/hidden/layer1,
/obj/machinery/atmospherics/pipe/simple/scrubbers/hidden/layer3,
/obj/effect/turf_decal/tile/green{
	dir = 1
	},
/obj/effect/turf_decal/tile/green{
	dir = 4
	},
/obj/effect/turf_decal/tile/green,
/turf/template_noop,
/area/hydroponics)
"d" = (
/obj/machinery/atmospherics/pipe/simple/scrubbers/hidden/layer3{
	dir = 4
	},
/obj/effect/turf_decal/tile/green{
	dir = 8
	},
/turf/template_noop,
/area/hydroponics)
"f" = (
/obj/machinery/vending/hydronutrients,
/turf/template_noop,
/area/hydroponics)
"k" = (
/obj/structure/disposalpipe/segment{
	dir = 5
	},
/obj/machinery/atmospherics/pipe/simple/supply/hidden/layer1,
/obj/machinery/atmospherics/pipe/simple/scrubbers/hidden/layer3,
/obj/effect/turf_decal/tile/green,
/obj/effect/turf_decal/tile/green{
	dir = 8
	},
/obj/effect/turf_decal/tile/green{
	dir = 1
	},
/turf/template_noop,
/area/hydroponics)
"l" = (
/obj/machinery/atmospherics/components/unary/vent_pump/on/layer1{
	dir = 1
	},
/obj/effect/turf_decal/tile/green{
	dir = 4
	},
/obj/effect/turf_decal/tile/green,
/turf/template_noop,
/area/hydroponics)
"m" = (
/obj/structure/sink{
	dir = 8;
	pixel_x = -12;
	pixel_y = 2
	},
/obj/effect/turf_decal/tile/green,
/obj/effect/turf_decal/tile/green{
	dir = 8
	},
/turf/template_noop,
/area/hydroponics)
"n" = (
/obj/effect/turf_decal/tile/green{
	dir = 1
	},
/obj/effect/turf_decal/tile/green{
	dir = 4
	},
/turf/template_noop,
/area/hydroponics)
"o" = (
/obj/machinery/hydroponics/constructable,
/obj/effect/turf_decal/tile/black{
	dir = 1
	},
/obj/effect/turf_decal/tile/black{
	dir = 4
	},
/obj/effect/turf_decal/tile/black,
/obj/effect/turf_decal/tile/black{
	dir = 8
	},
/obj/machinery/light{
	dir = 8
	},
/turf/template_noop,
/area/hydroponics)
"p" = (
/obj/machinery/atmospherics/pipe/simple/supply/hidden/layer1,
/obj/machinery/atmospherics/pipe/simple/scrubbers/hidden/layer3{
	dir = 9
	},
/obj/effect/turf_decal/tile/green{
	dir = 4
	},
/obj/effect/turf_decal/tile/green,
/turf/template_noop,
/area/hydroponics)
"q" = (
/obj/effect/turf_decal/tile/green{
	dir = 1
	},
/obj/effect/turf_decal/tile/green{
	dir = 4
	},
/obj/machinery/holopad,
/turf/template_noop,
/area/hydroponics)
"r" = (
/obj/machinery/disposal/bin,
/obj/structure/disposalpipe/trunk{
	dir = 8
	},
/obj/effect/turf_decal/tile/green,
/obj/effect/turf_decal/tile/green{
	dir = 8
	},
/turf/template_noop,
/area/hydroponics)
"s" = (
/obj/machinery/hydroponics/constructable,
/obj/effect/turf_decal/tile/black{
	dir = 1
	},
/obj/effect/turf_decal/tile/black{
	dir = 4
	},
/obj/effect/turf_decal/tile/black,
/obj/effect/turf_decal/tile/black{
	dir = 8
	},
/obj/machinery/light{
	dir = 4
	},
/turf/template_noop,
/area/hydroponics)
"t" = (
/obj/structure/reagent_dispensers/watertank/high,
/obj/item/reagent_containers/glass/bucket,
/turf/template_noop,
/area/hydroponics)
"u" = (
/obj/effect/turf_decal/tile/green{
	dir = 1
	},
/turf/template_noop,
/area/hydroponics)
"v" = (
/obj/structure/table/glass,
/obj/effect/turf_decal/tile/green{
	dir = 4
	},
/obj/effect/turf_decal/tile/green,
/obj/item/stack/packageWrap,
/obj/item/stack/packageWrap,
/obj/item/hand_labeler,
/turf/template_noop,
/area/hydroponics)
"w" = (
/obj/structure/reagent_dispensers/watertank/high,
/obj/effect/turf_decal/tile/green{
	dir = 1
	},
/obj/effect/turf_decal/tile/green{
	dir = 4
	},
/obj/item/reagent_containers/glass/bucket,
/turf/template_noop,
/area/hydroponics)
"A" = (
/obj/effect/turf_decal/tile/green{
	dir = 4
	},
/obj/effect/turf_decal/tile/green,
/turf/template_noop,
/area/hydroponics)
"C" = (
/obj/machinery/atmospherics/pipe/simple/scrubbers/hidden/layer3{
	dir = 6
	},
/obj/effect/turf_decal/tile/green{
	dir = 1
	},
/obj/effect/turf_decal/tile/green{
	dir = 8
	},
/turf/template_noop,
/area/hydroponics)
"E" = (
/obj/machinery/atmospherics/pipe/simple/scrubbers/hidden/layer3{
	dir = 4
	},
/obj/effect/turf_decal/tile/green,
/obj/effect/turf_decal/tile/green{
	dir = 8
	},
/turf/template_noop,
/area/hydroponics)
"F" = (
/obj/effect/turf_decal/tile/green,
/obj/effect/turf_decal/tile/green{
	dir = 8
	},
/turf/template_noop,
/area/hydroponics)
"G" = (
/obj/effect/turf_decal/tile/green{
	dir = 8
	},
/turf/template_noop,
/area/hydroponics)
"I" = (
/obj/effect/landmark/start/botanist,
/obj/structure/chair/stool,
/turf/template_noop,
/area/hydroponics)
"J" = (
/obj/machinery/hydroponics/constructable,
/obj/effect/turf_decal/tile/black{
	dir = 1
	},
/obj/effect/turf_decal/tile/black{
	dir = 4
	},
/obj/effect/turf_decal/tile/black,
/obj/effect/turf_decal/tile/black{
	dir = 8
	},
/turf/template_noop,
/area/hydroponics)
"M" = (
/obj/machinery/biogenerator,
/obj/effect/turf_decal/tile/green{
	dir = 4
	},
/obj/effect/turf_decal/tile/green,
/turf/template_noop,
/area/hydroponics)
"N" = (
/turf/template_noop,
/area/hydroponics)
"O" = (
/obj/effect/turf_decal/tile/green{
	dir = 4
	},
/turf/template_noop,
/area/hydroponics)
"P" = (
/obj/effect/turf_decal/tile/green{
	dir = 1
	},
/obj/effect/turf_decal/tile/green{
	dir = 8
	},
/turf/template_noop,
/area/hydroponics)
"S" = (
/obj/machinery/atmospherics/pipe/simple/scrubbers/hidden/layer3{
	dir = 4
	},
/obj/effect/turf_decal/tile/green,
/turf/template_noop,
/area/hydroponics)
"T" = (
/obj/machinery/atmospherics/components/unary/vent_scrubber/on/layer3{
	dir = 1
	},
/obj/effect/turf_decal/tile/green{
	dir = 1
	},
/turf/template_noop,
/area/hydroponics)
"W" = (
/obj/effect/landmark/start/botanist,
/obj/effect/turf_decal/tile/green{
	dir = 4
	},
/turf/template_noop,
/area/hydroponics)
"X" = (
/obj/structure/table/glass,
/obj/effect/turf_decal/tile/green{
	dir = 4
	},
/obj/effect/turf_decal/tile/green,
/obj/item/storage/box/syringes,
/obj/item/storage/box/beakers{
	pixel_x = 2;
	pixel_y = 2
	},
/turf/template_noop,
/area/hydroponics)
"Y" = (
/obj/machinery/seed_extractor,
/turf/template_noop,
/area/hydroponics)
"Z" = (
/obj/machinery/vending/hydroseeds{
	slogan_delay = 700
	},
/turf/template_noop,
/area/hydroponics)

(1,1,1) = {"
t
m
o
n
F
o
J
J
b
"}
(2,1,1) = {"
Y
G
C
T
G
P
P
P
u
"}
(3,1,1) = {"
M
O
S
X
v
W
N
N
N
"}
(4,1,1) = {"
J
n
E
J
J
n
N
f
N
"}
(5,1,1) = {"
J
n
E
J
J
q
N
Z
N
"}
(6,1,1) = {"
J
n
d
P
P
u
N
I
N
"}
(7,1,1) = {"
k
c
p
l
A
A
A
O
N
"}
(8,1,1) = {"
r
s
J
J
J
s
J
w
N
"}
