//MAP CONVERTED BY dmm2tgm.py THIS HEADER COMMENT PREVENTS RECONVERSION, DO NOT REMOVE
"a" = (
/obj/machinery/atmospherics/pipe/simple/supply/hidden/layer1,
/obj/machinery/atmospherics/pipe/simple/scrubbers/hidden/layer3{
	dir = 9
	},
/turf/template_noop,
/area/hydroponics)
"b" = (
/obj/effect/landmark/start/botanist,
/obj/structure/chair/stool,
/turf/template_noop,
/area/hydroponics)
"c" = (
/obj/effect/turf_decal/tile/green{
	dir = 1
	},
/turf/template_noop,
/area/hydroponics)
"e" = (
/obj/machinery/atmospherics/pipe/simple/scrubbers/hidden/layer3{
	dir = 6
	},
/obj/effect/turf_decal/tile/green{
	dir = 1
	},
/obj/effect/turf_decal/tile/green{
	dir = 8
	},
/turf/template_noop,
/area/hydroponics)
"g" = (
/obj/effect/turf_decal/tile/green{
	dir = 1
	},
/obj/effect/turf_decal/tile/green{
	dir = 8
	},
/turf/template_noop,
/area/hydroponics)
"h" = (
/obj/machinery/vending/hydroseeds{
	slogan_delay = 700
	},
/turf/template_noop,
/area/hydroponics)
"m" = (
/obj/structure/table/glass,
/turf/template_noop,
/area/hydroponics)
"n" = (
/obj/effect/turf_decal/tile/green{
	dir = 1
	},
/obj/effect/turf_decal/tile/green{
	dir = 4
	},
/turf/template_noop,
/area/hydroponics)
"o" = (
/turf/template_noop,
/area/hydroponics)
"p" = (
/obj/machinery/atmospherics/components/unary/vent_scrubber/on/layer3{
	dir = 1
	},
/obj/effect/turf_decal/tile/green{
	dir = 1
	},
/turf/template_noop,
/area/hydroponics)
"r" = (
/obj/structure/sink{
	dir = 8;
	pixel_x = -12;
	pixel_y = 2
	},
/turf/template_noop,
/area/hydroponics)
"s" = (
/obj/effect/turf_decal/tile/green{
	dir = 4
	},
/turf/template_noop,
/area/hydroponics)
"t" = (
/obj/structure/reagent_dispensers/watertank/high,
/turf/template_noop,
/area/hydroponics)
"u" = (
/obj/machinery/atmospherics/pipe/simple/scrubbers/hidden/layer3{
	dir = 4
	},
/obj/effect/turf_decal/tile/green{
	dir = 4
	},
/obj/effect/turf_decal/tile/green,
/turf/template_noop,
/area/hydroponics)
"v" = (
/obj/effect/turf_decal/tile/green{
	dir = 8
	},
/turf/template_noop,
/area/hydroponics)
"A" = (
/obj/item/reagent_containers/glass/bucket,
/obj/effect/turf_decal/tile/green{
	dir = 4
	},
/obj/effect/turf_decal/tile/green,
/turf/template_noop,
/area/hydroponics)
"B" = (
/obj/structure/table/glass,
/obj/effect/turf_decal/tile/green{
	dir = 8
	},
/obj/effect/turf_decal/tile/green,
/turf/template_noop,
/area/hydroponics)
"G" = (
/obj/effect/turf_decal/tile/green{
	dir = 4
	},
/obj/effect/turf_decal/tile/green,
/turf/template_noop,
/area/hydroponics)
"I" = (
/obj/machinery/atmospherics/pipe/simple/scrubbers/hidden/layer3{
	dir = 4
	},
/obj/machinery/hydroponics/constructable,
/obj/effect/turf_decal/tile/black{
	dir = 1
	},
/obj/effect/turf_decal/tile/black{
	dir = 4
	},
/obj/effect/turf_decal/tile/black{
	dir = 8
	},
/obj/effect/turf_decal/tile/black,
/turf/template_noop,
/area/hydroponics)
"J" = (
/obj/machinery/atmospherics/pipe/simple/scrubbers/hidden/layer3{
	dir = 4
	},
/obj/effect/turf_decal/tile/green{
	dir = 1
	},
/obj/effect/turf_decal/tile/green{
	dir = 8
	},
/turf/template_noop,
/area/hydroponics)
"L" = (
/obj/effect/turf_decal/tile/green{
	dir = 8
	},
/obj/effect/turf_decal/tile/green,
/turf/template_noop,
/area/hydroponics)
"M" = (
/obj/machinery/biogenerator,
/turf/template_noop,
/area/hydroponics)
"P" = (
/obj/machinery/atmospherics/pipe/simple/supply/hidden/layer1,
/obj/machinery/atmospherics/pipe/simple/scrubbers/hidden/layer3,
/turf/template_noop,
/area/hydroponics)
"Q" = (
/obj/machinery/hydroponics/constructable,
/obj/effect/turf_decal/tile/black{
	dir = 1
	},
/obj/effect/turf_decal/tile/black{
	dir = 4
	},
/obj/effect/turf_decal/tile/black{
	dir = 8
	},
/obj/effect/turf_decal/tile/black,
/turf/template_noop,
/area/hydroponics)
"R" = (
/obj/machinery/seed_extractor,
/turf/template_noop,
/area/hydroponics)
"S" = (
/obj/machinery/atmospherics/components/unary/vent_pump/on/layer1{
	dir = 1
	},
/turf/template_noop,
/area/hydroponics)
"T" = (
/obj/item/twohanded/required/kirbyplants/random,
/turf/template_noop,
/area/hydroponics)
"U" = (
/obj/structure/disposalpipe/segment{
	dir = 5
	},
/obj/machinery/atmospherics/pipe/simple/supply/hidden/layer1,
/obj/machinery/atmospherics/pipe/simple/scrubbers/hidden/layer3,
/turf/template_noop,
/area/hydroponics)
"V" = (
/obj/machinery/disposal/bin,
/obj/structure/disposalpipe/trunk{
	dir = 8
	},
/turf/template_noop,
/area/hydroponics)
"W" = (
/obj/machinery/vending/hydronutrients,
/turf/template_noop,
/area/hydroponics)
"X" = (
/obj/structure/reagent_dispensers/watertank/high,
/obj/effect/turf_decal/tile/green{
	dir = 1
	},
/obj/effect/turf_decal/tile/green{
	dir = 4
	},
/turf/template_noop,
/area/hydroponics)
"Y" = (
/obj/item/reagent_containers/glass/bucket,
/turf/template_noop,
/area/hydroponics)
"Z" = (
/obj/effect/landmark/start/botanist,
/obj/effect/turf_decal/tile/green{
	dir = 8
	},
/turf/template_noop,
/area/hydroponics)

(1,1,1) = {"
B
Q
Q
n
L
Q
Q
X
r
"}
(2,1,1) = {"
Z
g
e
p
v
g
g
c
o
"}
(3,1,1) = {"
A
G
u
G
G
G
s
o
o
"}
(4,1,1) = {"
Q
Q
I
Q
Q
Q
n
m
o
"}
(5,1,1) = {"
Q
Q
I
Q
Q
Q
n
m
o
"}
(6,1,1) = {"
g
g
J
g
g
g
c
b
o
"}
(7,1,1) = {"
U
P
a
S
o
o
o
Y
o
"}
(8,1,1) = {"
V
M
R
h
W
t
T
o
o
"}
