//MAP CONVERTED BY dmm2tgm.py THIS HEADER COMMENT PREVENTS RECONVERSION, DO NOT REMOVE
"a" = (
/obj/structure/table/glass,
/turf/template_noop,
/area/hydroponics)
"b" = (
/obj/structure/sink{
	dir = 8;
	pixel_x = -12;
	pixel_y = 2
	},
/turf/template_noop,
/area/hydroponics)
"e" = (
/obj/machinery/atmospherics/pipe/simple/supply/hidden/layer1,
/obj/machinery/atmospherics/pipe/simple/scrubbers/hidden/layer3{
	dir = 9
	},
/turf/template_noop,
/area/hydroponics)
"f" = (
/obj/machinery/vending/hydronutrients,
/turf/template_noop,
/area/hydroponics)
"h" = (
/obj/item/reagent_containers/glass/bucket,
/turf/template_noop,
/area/hydroponics)
"m" = (
/obj/effect/landmark/start/botanist,
/turf/template_noop,
/area/hydroponics)
"p" = (
/obj/structure/reagent_dispensers/watertank/high,
/turf/template_noop,
/area/hydroponics)
"r" = (
/obj/machinery/biogenerator,
/turf/template_noop,
/area/hydroponics)
"u" = (
/obj/machinery/atmospherics/pipe/simple/scrubbers/hidden/layer3{
	dir = 6
	},
/turf/template_noop,
/area/hydroponics)
"y" = (
/obj/structure/chair/stool,
/obj/effect/landmark/start/botanist,
/turf/template_noop,
/area/hydroponics)
"A" = (
/obj/machinery/hydroponics/constructable,
/turf/template_noop,
/area/hydroponics)
"D" = (
/obj/machinery/disposal/bin,
/obj/structure/disposalpipe/trunk{
	dir = 8
	},
/turf/template_noop,
/area/hydroponics)
"G" = (
/turf/template_noop,
/area/hydroponics)
"H" = (
/obj/machinery/seed_extractor,
/turf/template_noop,
/area/hydroponics)
"L" = (
/obj/machinery/atmospherics/components/unary/vent_pump/on/layer1{
	dir = 1
	},
/turf/template_noop,
/area/hydroponics)
"M" = (
/obj/machinery/vending/hydroseeds{
	slogan_delay = 700
	},
/turf/template_noop,
/area/hydroponics)
"N" = (
/obj/machinery/atmospherics/pipe/simple/scrubbers/hidden/layer3{
	dir = 4
	},
/obj/machinery/hydroponics/constructable,
/turf/template_noop,
/area/hydroponics)
"O" = (
/obj/item/twohanded/required/kirbyplants/random,
/turf/template_noop,
/area/hydroponics)
"Q" = (
/obj/machinery/atmospherics/pipe/simple/supply/hidden/layer1,
/obj/machinery/atmospherics/pipe/simple/scrubbers/hidden/layer3,
/turf/template_noop,
/area/hydroponics)
"U" = (
/obj/machinery/atmospherics/components/unary/vent_scrubber/on/layer3{
	dir = 1
	},
/turf/template_noop,
/area/hydroponics)
"Z" = (
/obj/structure/disposalpipe/segment{
	dir = 5
	},
/obj/machinery/atmospherics/pipe/simple/supply/hidden/layer1,
/obj/machinery/atmospherics/pipe/simple/scrubbers/hidden/layer3,
/turf/template_noop,
/area/hydroponics)

(1,1,1) = {"
p
G
G
G
G
G
G
G
b
"}
(2,1,1) = {"
a
G
u
U
G
G
G
G
G
"}
(3,1,1) = {"
A
G
N
G
A
G
A
G
G
"}
(4,1,1) = {"
A
G
N
m
A
G
A
G
G
"}
(5,1,1) = {"
A
G
N
h
A
G
A
G
G
"}
(6,1,1) = {"
A
G
N
G
A
G
A
y
G
"}
(7,1,1) = {"
Z
Q
e
L
G
G
G
h
G
"}
(8,1,1) = {"
D
r
H
M
f
p
O
G
G
"}
