"a" = (/turf/template_noop,/area/template_noop)
"b" = (/obj/structure/cable{icon_state = "1-2"},/obj/machinery/atmospherics/pipe/simple/supply/hidden/layer1,/obj/machinery/atmospherics/pipe/simple/scrubbers/hidden/layer3,/obj/structure/disposalpipe/segment{dir = 10},/obj/effect/landmark/event_spawn,/turf/open/floor/plating,/area/maintenance/starboard/aft)
"c" = (/turf/closed/wall,/area/maintenance/starboard/aft)
"d" = (/obj/structure/lattice,/turf/open/space,/area/space/nearstation)
"e" = (/obj/structure/disposalpipe/segment,/obj/structure/lattice/catwalk,/turf/open/space/basic,/area/space/nearstation)
"f" = (/turf/open/floor/plating,/area/maintenance/aft)
"g" = (/obj/structure/cable{icon_state = "1-2"},/obj/machinery/atmospherics/pipe/simple/supply/hidden/layer1,/obj/machinery/atmospherics/pipe/simple/scrubbers/hidden/layer3,/obj/structure/disposalpipe/segment,/turf/open/floor/plating,/area/maintenance/starboard/aft)
"h" = (/turf/open/floor/plating/airless,/area/space/nearstation)
"i" = (/obj/structure/disposalpipe/segment,/turf/open/floor/plating/airless,/area/space/nearstation)
"j" = (/obj/effect/spawner/structure/window/reinforced,/turf/open/floor/plating,/area/maintenance/starboard/aft)
"k" = (/obj/structure/lattice,/turf/open/space/basic,/area/space/nearstation)
"l" = (/obj/structure/grille,/turf/open/floor/plating,/area/space/nearstation)
"m" = (/obj/structure/disposalpipe/segment{dir = 6},/obj/machinery/atmospherics/pipe/simple/scrubbers/hidden/layer3{icon_state = "pipe11-3"; dir = 6},/obj/machinery/atmospherics/pipe/simple/supply/hidden/layer1{icon_state = "pipe11-1"; dir = 6},/obj/structure/cable{icon_state = "2-4"},/turf/open/floor/plating,/area/maintenance/starboard/aft)
"n" = (/turf/closed/wall,/area/science/nanite)
"o" = (/obj/structure/cable{icon_state = "1-2"},/obj/machinery/atmospherics/pipe/simple/supply/hidden/layer1,/obj/machinery/atmospherics/pipe/simple/scrubbers/hidden/layer3,/obj/structure/disposalpipe/segment,/obj/machinery/door/airlock/external{name = "Solar Maintenance"; req_access_txt = "10; 13"},/obj/effect/mapping_helpers/airlock/cyclelink_helper_target{dirx = 1; diry = -2},/turf/open/floor/plating,/area/maintenance/starboard/aft)
"p" = (/obj/structure/cable{icon_state = "4-8"},/obj/machinery/atmospherics/pipe/simple/supply/hidden/layer1{icon_state = "pipe11-1"; dir = 8},/obj/machinery/atmospherics/pipe/simple/scrubbers/hidden/layer3{icon_state = "pipe11-3"; dir = 4},/obj/structure/disposalpipe/segment{dir = 4},/obj/machinery/door/airlock/external{name = "Solar Maintenance"; req_access_txt = "10; 13"},/obj/effect/mapping_helpers/airlock/cyclelink_helper_target{dirx = -2; diry = -1},/turf/open/floor/plating,/area/maintenance/starboard/aft)
"q" = (/obj/structure/disposalpipe/segment{dir = 5},/obj/machinery/atmospherics/pipe/simple/scrubbers/hidden/layer3{icon_state = "pipe11-3"; dir = 5},/obj/machinery/atmospherics/pipe/simple/supply/hidden/layer1{icon_state = "pipe11-1"; dir = 5},/obj/structure/cable{icon_state = "1-4"},/obj/machinery/light/small,/turf/open/floor/plating,/area/maintenance/starboard/aft)
"r" = (/obj/structure/disposalpipe/segment{dir = 9},/obj/machinery/atmospherics/pipe/simple/scrubbers/hidden/layer3{icon_state = "pipe11-3"; dir = 9},/obj/machinery/atmospherics/pipe/simple/supply/hidden/layer1{icon_state = "pipe11-1"; dir = 9},/obj/structure/cable{icon_state = "1-8"},/obj/machinery/light/small{dir = 4},/turf/open/floor/plating,/area/maintenance/starboard/aft)
"s" = (/obj/effect/spawner/structure/window/reinforced,/turf/open/floor/plating,/area/maintenance/aft)
"t" = (/obj/machinery/door/airlock/external{name = "Solar Maintenance"; req_access_txt = "10; 13"},/obj/effect/mapping_helpers/airlock/cyclelink_helper_target{dirx = -1; diry = 2},/turf/open/floor/plating,/area/maintenance/aft)
"u" = (/obj/structure/lattice/catwalk,/turf/open/space,/area/space/nearstation)
"v" = (/obj/structure/disposalpipe/segment{dir = 4},/obj/machinery/atmospherics/pipe/simple/scrubbers/hidden/layer3{icon_state = "pipe11-3"; dir = 4},/obj/machinery/atmospherics/pipe/simple/supply/hidden/layer1{icon_state = "pipe11-1"; dir = 8},/obj/structure/cable{icon_state = "4-8"},/obj/machinery/door/airlock/external{name = "Solar Maintenance"; req_access_txt = "10; 13"},/obj/effect/mapping_helpers/airlock/cyclelink_helper_target{dirx = -1; diry = 2},/turf/open/floor/plating,/area/maintenance/starboard/aft)
"w" = (/obj/structure/disposalpipe/segment{dir = 4},/obj/machinery/atmospherics/pipe/simple/scrubbers/hidden/layer3{icon_state = "pipe11-3"; dir = 4},/obj/machinery/atmospherics/pipe/simple/supply/hidden/layer1{icon_state = "pipe11-1"; dir = 8},/obj/structure/cable{icon_state = "4-8"},/obj/machinery/door/airlock/external{name = "Solar Maintenance"; req_access_txt = "10; 13"},/obj/effect/mapping_helpers/airlock/cyclelink_helper_target{dirx = 2; diry = 1},/turf/open/floor/plating,/area/maintenance/starboard/aft)
"x" = (/obj/structure/disposalpipe/segment{dir = 4},/obj/machinery/atmospherics/pipe/simple/scrubbers/hidden/layer3{icon_state = "pipe11-3"; dir = 4},/obj/machinery/atmospherics/pipe/simple/supply/hidden/layer1{icon_state = "pipe11-1"; dir = 8},/obj/structure/cable{icon_state = "4-8"},/turf/open/floor/plating/airless,/area/space/nearstation)
"y" = (/obj/structure/lattice/catwalk,/turf/open/space/basic,/area/space/nearstation)
"z" = (/obj/structure/disposalpipe/junction/flip{dir = 4},/obj/machinery/atmospherics/pipe/simple/scrubbers/hidden/layer3{icon_state = "pipe11-3"; dir = 4},/obj/machinery/atmospherics/pipe/simple/supply/hidden/layer1{icon_state = "pipe11-1"; dir = 8},/obj/structure/cable{icon_state = "4-8"},/turf/open/floor/plating/airless,/area/space/nearstation)

(1,1,1) = {"
bcaaaaadedaaaaan
ocyyyyyyeyyyyjjc
gjhhhhhhihhhhjmp
qvxxxxxxzxxxxwrc
ccyyyyyyyyyyyjjc
fsaaakaaakaaadac
fsaalllllllladac
tsaaaaaaaaaaadac
uuaaaaaaaaaaaddc
yyaaaaaaaaaaaddc
"}
