// This map has been converted using maphash
"alr" = (/obj/structure/lattice,/turf/open/space,/area/space/nearstation)
"arG" = (/turf/template_noop,/area/template_noop)
"cuj" = (/obj/structure/disposalpipe/segment{dir = 5},/obj/machinery/atmospherics/pipe/simple/scrubbers/hidden/layer3{dir = 5; icon_state = "pipe11-3"},/obj/machinery/atmospherics/pipe/simple/supply/hidden/layer1{dir = 5; icon_state = "pipe11-1"},/obj/structure/cable{icon_state = "1-4"},/obj/machinery/light/small,/turf/open/floor/plating,/area/maintenance/starboard/aft)
"cWl" = (/turf/open/floor/plating,/area/maintenance/aft)
"dYA" = (/obj/structure/disposalpipe/segment,/obj/structure/lattice/catwalk,/turf/open/space/basic,/area/space/nearstation)
"eLK" = (/turf/closed/wall,/area/science/nanite)
"eNn" = (/obj/structure/cable{icon_state = "1-2"},/obj/machinery/atmospherics/pipe/simple/scrubbers/hidden/layer3,/obj/structure/disposalpipe/segment,/obj/machinery/atmospherics/pipe/simple/supply/hidden/layer1,/turf/open/floor/plating,/area/maintenance/starboard/aft)
"jHZ" = (/obj/effect/spawner/structure/window/reinforced,/turf/open/floor/plating,/area/maintenance/starboard/aft)
"leS" = (/obj/structure/disposalpipe/segment,/turf/open/floor/plating/airless,/area/space/nearstation)
"mbw" = (/obj/effect/spawner/structure/window/reinforced/shutter,/turf/open/floor/plating,/area/maintenance/starboard/aft)
"ndi" = (/obj/structure/cable{icon_state = "1-2"},/obj/machinery/atmospherics/pipe/simple/scrubbers/hidden/layer3,/obj/structure/disposalpipe/segment,/obj/machinery/door/airlock/external{name = "External Access"; req_access_txt = "10; 13"},/obj/effect/mapping_helpers/airlock/cyclelink_helper_target{dirx = 1; diry = -2},/obj/machinery/door/firedoor/border_only{dir = 1},/obj/machinery/door/firedoor/border_only,/obj/machinery/atmospherics/pipe/simple/supply/hidden/layer1,/turf/open/floor/plating,/area/maintenance/starboard/aft)
"nef" = (/turf/closed/wall,/area/maintenance/starboard/aft)
"onh" = (/obj/effect/spawner/structure/window/reinforced/shutter,/turf/open/floor/plating,/area/maintenance/aft)
"otG" = (/obj/structure/grille,/turf/open/floor/plating/airless,/area/space/nearstation)
"oIp" = (/turf/open/floor/plating/airless,/area/space/nearstation)
"psB" = (/obj/structure/lattice/catwalk,/turf/open/space/basic,/area/space/nearstation)
"pHI" = (/obj/structure/cable{icon_state = "4-8"},/obj/machinery/atmospherics/pipe/simple/supply/hidden/layer1{dir = 8; icon_state = "pipe11-1"},/obj/machinery/atmospherics/pipe/simple/scrubbers/hidden/layer3{dir = 4; icon_state = "pipe11-3"},/obj/structure/disposalpipe/segment{dir = 4},/obj/effect/mapping_helpers/airlock/cyclelink_helper_target{dirx = -2; diry = -1},/obj/machinery/door/airlock/external{name = "External Access"; req_access_txt = "10; 13"},/obj/machinery/door/firedoor/border_only{dir = 4},/obj/machinery/door/firedoor/border_only{dir = 8},/turf/open/floor/plating,/area/maintenance/starboard/aft)
"qAH" = (/obj/structure/lattice,/turf/open/space/basic,/area/space/nearstation)
"rXC" = (/obj/structure/disposalpipe/junction/flip{dir = 4},/obj/machinery/atmospherics/pipe/simple/scrubbers/hidden/layer3{dir = 4; icon_state = "pipe11-3"},/obj/machinery/atmospherics/pipe/simple/supply/hidden/layer1{dir = 8; icon_state = "pipe11-1"},/obj/structure/cable{icon_state = "4-8"},/turf/open/floor/plating/airless,/area/space/nearstation)
"sFO" = (/obj/structure/cable{icon_state = "1-2"},/obj/machinery/atmospherics/pipe/simple/scrubbers/hidden/layer3,/obj/structure/disposalpipe/segment{dir = 10},/obj/effect/landmark/event_spawn,/obj/machinery/atmospherics/pipe/simple/supply/hidden/layer1,/turf/open/floor/plating,/area/maintenance/starboard/aft)
"sQj" = (/obj/structure/disposalpipe/segment{dir = 4},/obj/machinery/atmospherics/pipe/simple/scrubbers/hidden/layer3{dir = 4; icon_state = "pipe11-3"},/obj/machinery/atmospherics/pipe/simple/supply/hidden/layer1{dir = 8; icon_state = "pipe11-1"},/obj/structure/cable{icon_state = "4-8"},/turf/open/floor/plating/airless,/area/space/nearstation)
"sSM" = (/obj/structure/disposalpipe/segment{dir = 9},/obj/machinery/atmospherics/pipe/simple/scrubbers/hidden/layer3{dir = 9; icon_state = "pipe11-3"},/obj/machinery/atmospherics/pipe/simple/supply/hidden/layer1{dir = 9; icon_state = "pipe11-1"},/obj/structure/cable{icon_state = "1-8"},/obj/machinery/light/small{dir = 4},/turf/open/floor/plating,/area/maintenance/starboard/aft)
"tuD" = (/obj/structure/disposalpipe/segment{dir = 4},/obj/machinery/atmospherics/pipe/simple/scrubbers/hidden/layer3{dir = 4; icon_state = "pipe11-3"},/obj/machinery/atmospherics/pipe/simple/supply/hidden/layer1{dir = 8; icon_state = "pipe11-1"},/obj/structure/cable{icon_state = "4-8"},/obj/effect/mapping_helpers/airlock/cyclelink_helper_target{dirx = 2; diry = 1},/obj/machinery/door/airlock/external{name = "External Access"; req_access_txt = "10; 13"},/turf/open/floor/plating,/area/maintenance/starboard/aft)
"usv" = (/obj/machinery/door/airlock/external{name = "Solar Maintenance"; req_access_txt = "10; 13"},/obj/effect/mapping_helpers/airlock/cyclelink_helper_target{dirx = -1; diry = 2},/turf/open/floor/plating,/area/maintenance/aft)
"vnB" = (/obj/structure/disposalpipe/segment{dir = 6},/obj/machinery/atmospherics/pipe/simple/scrubbers/hidden/layer3{dir = 6; icon_state = "pipe11-3"},/obj/machinery/atmospherics/pipe/simple/supply/hidden/layer1{dir = 6; icon_state = "pipe11-1"},/obj/structure/cable{icon_state = "2-4"},/turf/open/floor/plating,/area/maintenance/starboard/aft)
"vyx" = (/obj/structure/disposalpipe/segment{dir = 4},/obj/machinery/atmospherics/pipe/simple/scrubbers/hidden/layer3{dir = 4; icon_state = "pipe11-3"},/obj/machinery/atmospherics/pipe/simple/supply/hidden/layer1{dir = 8; icon_state = "pipe11-1"},/obj/structure/cable{icon_state = "4-8"},/obj/effect/mapping_helpers/airlock/cyclelink_helper_target{dirx = -1; diry = 2},/obj/machinery/door/airlock/external{name = "External Access"; req_access_txt = "10; 13"},/turf/open/floor/plating,/area/maintenance/starboard/aft)
"vZu" = (/obj/structure/lattice/catwalk,/turf/open/space,/area/space/nearstation)

(1,1,1) = {"
sFO
ndi
eNn
cuj
nef
cWl
cWl
usv
vZu
psB
"}
(2,1,1) = {"
nef
nef
mbw
vyx
nef
onh
onh
onh
vZu
psB
"}
(3,1,1) = {"
arG
psB
oIp
sQj
psB
arG
arG
arG
arG
arG
"}
(4,1,1) = {"
arG
psB
oIp
sQj
psB
arG
arG
arG
arG
arG
"}
(5,1,1) = {"
arG
psB
oIp
sQj
psB
arG
otG
arG
arG
arG
"}
(6,1,1) = {"
arG
psB
oIp
sQj
psB
qAH
otG
arG
arG
arG
"}
(7,1,1) = {"
arG
psB
oIp
sQj
psB
arG
otG
arG
arG
arG
"}
(8,1,1) = {"
alr
psB
oIp
sQj
psB
arG
otG
arG
arG
arG
"}
(9,1,1) = {"
dYA
dYA
leS
rXC
psB
arG
otG
arG
arG
arG
"}
(10,1,1) = {"
alr
psB
oIp
sQj
psB
qAH
otG
arG
arG
arG
"}
(11,1,1) = {"
arG
psB
oIp
sQj
psB
arG
otG
arG
arG
arG
"}
(12,1,1) = {"
arG
psB
oIp
sQj
psB
arG
otG
arG
arG
arG
"}
(13,1,1) = {"
arG
psB
oIp
sQj
psB
arG
arG
arG
arG
arG
"}
(14,1,1) = {"
arG
mbw
mbw
tuD
mbw
alr
alr
alr
alr
alr
"}
(15,1,1) = {"
arG
mbw
vnB
sSM
mbw
arG
arG
arG
alr
alr
"}
(16,1,1) = {"
eLK
nef
pHI
jHZ
nef
nef
nef
nef
nef
nef
"}
