// This map has been converted using maphash
"alr" = (/obj/structure/lattice,/turf/open/space,/area/space/nearstation)
"arG" = (/turf/template_noop,/area/template_noop)
"cWl" = (/turf/open/floor/plating,/area/maintenance/aft)
"dLE" = (/obj/structure/cable{icon_state = "1-2"},/obj/machinery/atmospherics/pipe/simple/scrubbers/hidden/layer3,/obj/structure/disposalpipe/segment{dir = 10},/obj/machinery/atmospherics/pipe/simple/supply/hidden/layer1,/turf/open/floor/plating,/area/maintenance/starboard/aft)
"eLK" = (/turf/closed/wall,/area/science/nanite)
"eNn" = (/obj/structure/cable{icon_state = "1-2"},/obj/machinery/atmospherics/pipe/simple/scrubbers/hidden/layer3,/obj/structure/disposalpipe/segment,/obj/machinery/atmospherics/pipe/simple/supply/hidden/layer1,/turf/open/floor/plating,/area/maintenance/starboard/aft)
"fWz" = (/obj/structure/chair,/obj/structure/disposalpipe/junction/flip{dir = 4},/turf/open/floor/plating,/area/maintenance/starboard/aft)
"gZY" = (/obj/structure/chair,/obj/item/storage/fancy/cigarettes,/obj/structure/disposalpipe/segment{dir = 4},/turf/open/floor/plating,/area/maintenance/starboard/aft)
"hxH" = (/obj/structure/cable{icon_state = "4-8"},/obj/effect/landmark/event_spawn,/obj/machinery/atmospherics/pipe/simple/supply/hidden/layer1{dir = 8; icon_state = "pipe11-1"},/obj/machinery/atmospherics/pipe/simple/scrubbers/hidden/layer3{dir = 4; icon_state = "pipe11-3"},/turf/open/floor/plating,/area/maintenance/starboard/aft)
"iNk" = (/obj/structure/disposalpipe/segment,/obj/effect/spawner/structure/window/reinforced/shutter,/turf/open/floor/plating,/area/maintenance/starboard/aft)
"kOe" = (/obj/structure/disposalpipe/segment{dir = 5},/turf/open/floor/plating,/area/maintenance/starboard/aft)
"lcA" = (/obj/structure/cable{icon_state = "4-8"},/obj/machinery/atmospherics/pipe/simple/scrubbers/hidden/layer3{dir = 4; icon_state = "pipe11-3"},/obj/structure/disposalpipe/segment{dir = 6},/obj/machinery/atmospherics/pipe/simple/supply/hidden/layer1{dir = 8},/turf/open/floor/plating,/area/maintenance/starboard/aft)
"leS" = (/obj/structure/disposalpipe/segment,/turf/open/floor/plating/airless,/area/space/nearstation)
"mbw" = (/obj/effect/spawner/structure/window/reinforced/shutter,/turf/open/floor/plating,/area/maintenance/starboard/aft)
"nef" = (/turf/closed/wall,/area/maintenance/starboard/aft)
"npW" = (/obj/structure/cable{icon_state = "1-4"},/obj/machinery/atmospherics/pipe/simple/scrubbers/hidden/layer3{dir = 5; icon_state = "pipe11-3"},/obj/structure/disposalpipe/segment,/obj/machinery/atmospherics/pipe/simple/supply/hidden/layer1{dir = 5; icon_state = "pipe11-1"},/turf/open/floor/plating,/area/maintenance/starboard/aft)
"onh" = (/obj/effect/spawner/structure/window/reinforced/shutter,/turf/open/floor/plating,/area/maintenance/aft)
"psB" = (/obj/structure/lattice/catwalk,/turf/open/space/basic,/area/space/nearstation)
"pJy" = (/obj/machinery/door/airlock/maintenance{req_access_txt = "12"},/obj/structure/cable{icon_state = "4-8"},/obj/machinery/atmospherics/pipe/simple/supply/hidden/layer1{dir = 8; icon_state = "pipe11-1"},/obj/machinery/atmospherics/pipe/simple/scrubbers/hidden/layer3{dir = 4; icon_state = "pipe11-3"},/obj/structure/disposalpipe/segment{dir = 4},/obj/machinery/door/firedoor/border_only{dir = 4},/obj/machinery/door/firedoor/border_only{dir = 8},/turf/open/floor/plating,/area/maintenance/starboard/aft)
"thD" = (/obj/structure/disposalpipe/segment{dir = 9},/turf/open/floor/plating,/area/maintenance/starboard/aft)
"usv" = (/obj/machinery/door/airlock/external{name = "Solar Maintenance"; req_access_txt = "10; 13"},/obj/effect/mapping_helpers/airlock/cyclelink_helper_target{dirx = -1; diry = 2},/turf/open/floor/plating,/area/maintenance/aft)
"vZu" = (/obj/structure/lattice/catwalk,/turf/open/space,/area/space/nearstation)
"xra" = (/obj/structure/cable{icon_state = "4-8"},/obj/machinery/atmospherics/pipe/simple/supply/hidden/layer1{dir = 8; icon_state = "pipe11-1"},/obj/machinery/atmospherics/pipe/simple/scrubbers/hidden/layer3{dir = 4; icon_state = "pipe11-3"},/turf/open/floor/plating,/area/maintenance/starboard/aft)
"xzC" = (/obj/structure/disposalpipe/segment{dir = 4},/turf/open/floor/plating,/area/maintenance/starboard/aft)
"ykn" = (/obj/structure/cable{icon_state = "4-8"},/obj/machinery/atmospherics/pipe/simple/scrubbers/hidden/layer3{dir = 4; icon_state = "pipe11-3"},/obj/structure/disposalpipe/segment,/obj/machinery/atmospherics/pipe/simple/supply/hidden/layer1{dir = 8; icon_state = "pipe11-1"},/turf/open/floor/plating,/area/maintenance/starboard/aft)

(1,1,1) = {"
dLE
eNn
npW
kOe
nef
cWl
cWl
usv
vZu
psB
"}
(2,1,1) = {"
nef
nef
xra
xzC
nef
onh
onh
onh
vZu
psB
"}
(3,1,1) = {"
arG
nef
xra
xzC
mbw
arG
arG
arG
arG
arG
"}
(4,1,1) = {"
arG
mbw
xra
xzC
mbw
arG
arG
arG
arG
arG
"}
(5,1,1) = {"
arG
mbw
xra
xzC
mbw
arG
arG
arG
arG
arG
"}
(6,1,1) = {"
arG
nef
xra
xzC
nef
arG
arG
arG
arG
arG
"}
(7,1,1) = {"
arG
nef
hxH
xzC
nef
arG
arG
arG
arG
arG
"}
(8,1,1) = {"
alr
mbw
xra
gZY
mbw
arG
arG
arG
arG
arG
"}
(9,1,1) = {"
leS
iNk
ykn
fWz
mbw
arG
arG
arG
arG
arG
"}
(10,1,1) = {"
alr
mbw
xra
xzC
mbw
arG
arG
arG
arG
arG
"}
(11,1,1) = {"
arG
nef
xra
xzC
nef
arG
arG
arG
arG
arG
"}
(12,1,1) = {"
arG
nef
xra
xzC
nef
arG
arG
arG
arG
arG
"}
(13,1,1) = {"
arG
mbw
xra
xzC
mbw
arG
arG
arG
arG
arG
"}
(14,1,1) = {"
arG
mbw
xra
xzC
mbw
alr
alr
alr
alr
alr
"}
(15,1,1) = {"
arG
mbw
lcA
thD
mbw
arG
arG
arG
alr
alr
"}
(16,1,1) = {"
eLK
nef
pJy
nef
nef
nef
nef
nef
nef
nef
"}
