//MAP CONVERTED BY dmm2tgm.py THIS HEADER COMMENT PREVENTS RECONVERSION, DO NOT REMOVE
"a" = (
/obj/item/storage/pill_bottle,
/turf/open/floor/plating,
/area/template_noop)
"f" = (
/obj/structure/table/reinforced,
/obj/item/reagent_containers/pill/floorpill{
	pixel_x = -12
	},
/obj/item/reagent_containers/pill/floorpill{
	pixel_x = 4;
	pixel_y = 2
	},
/obj/item/reagent_containers/pill/floorpill{
	pixel_x = -2;
	pixel_y = 10
	},
/obj/item/reagent_containers/pill/floorpill{
	pixel_x = -22;
	pixel_y = -6
	},
/obj/item/reagent_containers/pill/floorpill{
	pixel_x = 26;
	pixel_y = 26
	},
/turf/open/floor/plating,
/area/template_noop)
"k" = (
/obj/effect/decal/cleanable/vomit/old,
/turf/open/floor/plating,
/area/template_noop)
"r" = (
/obj/structure/table/reinforced,
/obj/item/reagent_containers/pill/floorpill{
	pixel_y = -10
	},
/obj/item/reagent_containers/pill/floorpill{
	pixel_x = -20;
	pixel_y = 6
	},
/obj/item/reagent_containers/pill/floorpill{
	pixel_x = 8
	},
/obj/item/reagent_containers/pill/floorpill{
	pixel_x = 12;
	pixel_y = 12
	},
/turf/open/floor/plating,
/area/template_noop)
"B" = (
/obj/effect/decal/cleanable/vomit/old,
/obj/item/storage/pill_bottle,
/turf/open/floor/plating,
/area/template_noop)
"C" = (
/turf/open/floor/plating,
/area/template_noop)
"I" = (
/obj/structure/table/reinforced,
/obj/item/reagent_containers/pill/floorpill,
/obj/item/reagent_containers/pill/floorpill{
	pixel_x = 28;
	pixel_y = 12
	},
/obj/item/reagent_containers/pill/floorpill{
	pixel_y = 14
	},
/obj/item/reagent_containers/pill/floorpill{
	pixel_x = -14;
	pixel_y = -8
	},
/turf/open/floor/plating,
/area/template_noop)

(1,1,1) = {"
C
k
a
"}
(2,1,1) = {"
a
f
k
"}
(3,1,1) = {"
C
r
B
"}
(4,1,1) = {"
C
I
C
"}
(5,1,1) = {"
C
C
C
"}
