//MAP CONVERTED BY dmm2tgm.py THIS HEADER COMMENT PREVENTS RECONVERSION, DO NOT REMOVE
"a" = (
/obj/machinery/light{
	dir = 8
	},
/turf/open/floor/mineral/titanium/blue,
/area/shuttle/ai)
"b" = (
/obj/structure/chair/comfy/shuttle{
	dir = 8
	},
/obj/machinery/light{
	dir = 4
	},
/turf/open/floor/mineral/titanium/blue,
/area/shuttle/ai)
"e" = (
/turf/template_noop,
/area/template_noop)
"h" = (
/obj/structure/shuttle/engine/heater{
	dir = 1
	},
/obj/structure/window/reinforced{
	layer = 2.9
	},
/obj/structure/window/reinforced{
	dir = 4
	},
/obj/structure/window/reinforced{
	dir = 8
	},
/turf/open/floor/plating/airless,
/area/shuttle/ai)
"m" = (
/obj/effect/spawner/structure/window/shuttle,
/obj/machinery/door/firedoor/border_only{
	dir = 1
	},
/turf/open/floor/plating,
/area/shuttle/ai)
"o" = (
/turf/open/floor/mineral/titanium/blue,
/area/shuttle/ai)
"q" = (
/turf/open/floor/mineral/titanium,
/area/shuttle/ai)
"u" = (
/obj/effect/spawner/structure/window/shuttle,
/obj/machinery/door/firedoor/border_only,
/turf/open/floor/plating,
/area/shuttle/ai)
"z" = (
/obj/machinery/computer/shuttle/ai_ship{
	dir = 1
	},
/turf/open/floor/mineral/titanium/blue,
/area/shuttle/ai)
"C" = (
/obj/structure/chair/comfy/shuttle,
/turf/open/floor/mineral/titanium,
/area/shuttle/ai)
"G" = (
/obj/structure/chair/comfy/shuttle{
	dir = 4
	},
/turf/open/floor/mineral/titanium/blue,
/area/shuttle/ai)
"H" = (
/obj/structure/shuttle/engine/propulsion/burst{
	dir = 1
	},
/turf/open/floor/plating/airless,
/area/shuttle/ai)
"M" = (
/obj/machinery/door/airlock/titanium{
	name = "Mining Shuttle Airlock"
	},
/obj/machinery/door/firedoor/border_only,
/obj/machinery/door/firedoor/border_only{
	dir = 1
	},
/obj/docking_port/mobile{
	dir = 2;
	dwidth = 2;
	height = 6;
	id = "ai_ship";
	name = "ai ship shuttle";
	port_direction = 4;
	width = 5
	},
/turf/open/floor/plating,
/area/shuttle/ai)
"N" = (
/turf/closed/wall/mineral/titanium,
/area/shuttle/ai)
"Q" = (
/obj/machinery/door/firedoor/border_only{
	dir = 4
	},
/obj/effect/spawner/structure/window/shuttle,
/turf/open/floor/plating,
/area/shuttle/ai)
"U" = (
/obj/structure/chair/comfy/shuttle{
	dir = 8
	},
/turf/open/floor/mineral/titanium/blue,
/area/shuttle/ai)
"W" = (
/obj/machinery/door/airlock/titanium{
	name = "Mining Shuttle Airlock"
	},
/obj/machinery/door/firedoor/border_only{
	dir = 8
	},
/obj/machinery/door/firedoor/border_only{
	dir = 4
	},
/turf/open/floor/plating,
/area/shuttle/ai)

(1,1,1) = {"
H
h
N
W
N
e
"}
(2,1,1) = {"
m
G
a
q
N
N
"}
(3,1,1) = {"
M
q
q
C
z
u
"}
(4,1,1) = {"
m
U
b
o
N
N
"}
(5,1,1) = {"
H
h
N
Q
N
e
"}
