//MAP CONVERTED BY dmm2tgm.py THIS HEADER COMMENT PREVENTS RECONVERSION, DO NOT REMOVE
"a" = (
/turf/template_noop,
/area/template_noop)
"c" = (
/obj/machinery/light/small{
	dir = 1
	},
/turf/open/floor/plating/indoor/metal/plate,
/area/shuttle/arrival)
"g" = (
/obj/structure/chair/comfy/brown{
	dir = 8
	},
/turf/open/floor/plating/indoor/grooved,
/area/shuttle/arrival)
"k" = (
/obj/machinery/door/unpowered/halflife/seethrough/metal{
	dir = 4
	},
/obj/structure/fans/tiny/invisible,
/turf/open/floor/plating/indoor/grooved,
/area/shuttle/arrival)
"m" = (
/turf/closed/wall/halflife/metal,
/area/shuttle/arrival)
"s" = (
/obj/machinery/door/unpowered/halflife/seethrough/metal{
	dir = 8
	},
/obj/structure/fans/tiny/invisible,
/turf/open/floor/plating/indoor/grooved,
/area/shuttle/arrival)
"t" = (
/obj/machinery/light/small{
	dir = 8
	},
/turf/open/floor/plating/indoor/grooved,
/area/shuttle/arrival)
"u" = (
/obj/structure/chair/comfy/brown{
	dir = 4
	},
/turf/open/floor/plating/indoor/grooved,
/area/shuttle/arrival)
"B" = (
/obj/docking_port/mobile/arrivals{
	dir = 2
	},
/turf/closed/wall/halflife/metal,
/area/shuttle/arrival)
"H" = (
/obj/machinery/light/small{
	dir = 4
	},
/turf/open/floor/plating/indoor/grooved,
/area/shuttle/arrival)
"L" = (
/obj/machinery/light/small,
/turf/open/floor/plating/indoor/metal/plate,
/area/shuttle/arrival)
"T" = (
/turf/open/floor/plating/indoor/metal/plate,
/area/shuttle/arrival)
"W" = (
/turf/open/floor/plating/indoor/grooved,
/area/shuttle/arrival)

(1,1,1) = {"
a
m
m
m
m
s
m
m
m
a
"}
(2,1,1) = {"
m
m
u
u
t
W
u
u
m
m
"}
(3,1,1) = {"
m
T
T
T
T
T
T
T
T
m
"}
(4,1,1) = {"
B
c
T
T
T
T
T
T
L
m
"}
(5,1,1) = {"
m
T
T
T
T
T
T
T
T
m
"}
(6,1,1) = {"
m
m
g
g
H
W
g
g
m
m
"}
(7,1,1) = {"
a
m
m
m
m
k
m
m
m
a
"}
