// This map has been converted using maphash
"arG" = (/turf/template_noop,/area/template_noop)
"aXN" = (/turf/open/floor/mineral/titanium,/area/shuttle/arrival)
"caS" = (/obj/structure/shuttle/engine/propulsion{dir = 4},/turf/open/floor/plating/airless,/area/shuttle/arrival)
"cvt" = (/obj/structure/extinguisher_cabinet{pixel_y = -29},/obj/machinery/light,/turf/open/floor/mineral/titanium/blue,/area/shuttle/arrival)
"cVh" = (/obj/machinery/door/airlock/titanium{name = "Arrivals Shuttle Airlock"},/obj/machinery/door/firedoor/border_only{dir = 1},/obj/machinery/door/firedoor/border_only,/turf/open/floor/plating,/area/shuttle/arrival)
"dgX" = (/obj/structure/closet/wardrobe/mixed,/turf/open/floor/mineral/titanium/blue,/area/shuttle/arrival)
"dGO" = (/obj/structure/shuttle/engine/heater{dir = 4},/obj/structure/window/reinforced{dir = 8},/turf/open/floor/plating/airless,/area/shuttle/arrival)
"emn" = (/obj/machinery/door/airlock/titanium{name = "Arrivals Shuttle Airlock"},/obj/machinery/door/firedoor/border_only{dir = 4},/obj/machinery/door/firedoor/border_only{dir = 8},/turf/open/floor/mineral/titanium/blue,/area/shuttle/arrival)
"eCu" = (/obj/structure/grille,/obj/structure/window/shuttle,/obj/machinery/door/poddoor/shutters/preopen{id = "arrivy"; name = "ship shutters"},/obj/machinery/door/firedoor/border_only{dir = 4},/obj/machinery/door/firedoor/border_only{dir = 8},/turf/open/floor/plating,/area/shuttle/arrival)
"fyV" = (/obj/machinery/light/small,/turf/open/floor/mineral/titanium/blue,/area/shuttle/arrival)
"gMs" = (/obj/structure/shuttle/engine/propulsion/burst/right{dir = 4},/turf/open/floor/plating/airless,/area/shuttle/arrival)
"hse" = (/obj/effect/spawner/structure/window/shuttle,/obj/machinery/door/firedoor/border_only{dir = 1},/turf/open/floor/plating,/area/shuttle/arrival)
"hFf" = (/turf/closed/wall/mineral/titanium,/area/shuttle/arrival)
"jEA" = (/obj/item/radio/intercom{name = "Station Intercom (General)"; pixel_y = -29},/obj/machinery/light,/turf/open/floor/mineral/titanium/blue,/area/shuttle/arrival)
"owl" = (/obj/structure/table,/obj/item/storage/firstaid/regular{pixel_y = 4},/obj/item/storage/toolbox/emergency,/turf/open/floor/mineral/titanium/blue,/area/shuttle/arrival)
"owv" = (/turf/open/floor/mineral/titanium/blue,/area/shuttle/arrival)
"oBr" = (/obj/structure/closet/emcloset,/obj/item/storage/firstaid/o2,/obj/item/tank/internals/emergency_oxygen,/obj/item/clothing/mask/breath,/turf/open/floor/mineral/titanium/blue,/area/shuttle/arrival)
"oEM" = (/obj/machinery/light{dir = 1},/obj/structure/sign/poster/official/enlist{pixel_y = 32},/turf/open/floor/mineral/titanium/blue,/area/shuttle/arrival)
"pjW" = (/obj/structure/shuttle/engine/propulsion{dir = 4},/obj/docking_port/mobile/arrivals{height = 13; name = "pubby arrivals shuttle"; width = 6},/turf/open/floor/plating/airless,/area/shuttle/arrival)
"rvz" = (/obj/structure/chair/comfy/shuttle{dir = 8},/turf/open/floor/mineral/titanium,/area/shuttle/arrival)
"seD" = (/obj/machinery/requests_console{department = "Arrival shuttle"; name = "Arrivals Shuttle console"; pixel_y = 30},/obj/machinery/light{dir = 1},/turf/open/floor/mineral/titanium/blue,/area/shuttle/arrival)
"tRQ" = (/obj/effect/spawner/structure/window/shuttle,/obj/machinery/door/firedoor/border_only,/turf/open/floor/plating,/area/shuttle/arrival)
"uvR" = (/obj/structure/shuttle/engine/propulsion/burst/left{dir = 4},/turf/open/floor/plating/airless,/area/shuttle/arrival)
"xJV" = (/obj/structure/closet/wardrobe/black,/turf/open/floor/mineral/titanium/blue,/area/shuttle/arrival)

(1,1,1) = {"
arG
hFf
eCu
eCu
hFf
arG
"}
(2,1,1) = {"
arG
hFf
owv
fyV
hFf
arG
"}
(3,1,1) = {"
hFf
hFf
emn
emn
hFf
hFf
"}
(4,1,1) = {"
hFf
owl
aXN
aXN
oBr
hFf
"}
(5,1,1) = {"
cVh
owv
rvz
rvz
owv
cVh
"}
(6,1,1) = {"
hFf
oEM
aXN
aXN
cvt
hFf
"}
(7,1,1) = {"
hse
xJV
rvz
rvz
owv
tRQ
"}
(8,1,1) = {"
hse
dgX
aXN
aXN
owv
tRQ
"}
(9,1,1) = {"
hse
owv
rvz
rvz
owv
tRQ
"}
(10,1,1) = {"
hFf
seD
rvz
rvz
jEA
hFf
"}
(11,1,1) = {"
cVh
owv
aXN
aXN
owv
cVh
"}
(12,1,1) = {"
hFf
dGO
dGO
dGO
dGO
hFf
"}
(13,1,1) = {"
hFf
gMs
pjW
caS
uvR
hFf
"}
