//MAP CONVERTED BY dmm2tgm.py THIS HEADER COMMENT PREVENTS RECONVERSION, DO NOT REMOVE
"a" = (
/turf/open/floor/mineral/titanium/white,
/area/shuttle/supply)
"b" = (
/turf/closed/wall/mineral/titanium,
/area/shuttle/supply)
"c" = (
/obj/structure/window/reinforced,
/obj/structure/shuttle/engine/heater{
	dir = 1
	},
/turf/open/floor/plating/airless,
/area/shuttle/supply)
"e" = (
/turf/open/floor/mineral/titanium/blue,
/area/shuttle/supply)
"f" = (
/obj/machinery/conveyor{
	dir = 4;
	id = "QMLoad2"
	},
/obj/machinery/door/poddoor{
	id = "QMLoaddoor2";
	name = "supply dock loading door"
	},
/obj/machinery/door/firedoor/border_only{
	dir = 4
	},
/obj/machinery/door/firedoor/border_only{
	dir = 8
	},
/turf/open/floor/plating,
/area/shuttle/supply)
"g" = (
/obj/machinery/door/airlock/titanium{
	name = "Supply Shuttle Airlock";
	req_access_txt = "31"
	},
/obj/machinery/door/firedoor/border_only{
	dir = 4
	},
/obj/machinery/door/firedoor/border_only{
	dir = 8
	},
/turf/open/floor/plating,
/area/shuttle/supply)
"i" = (
/obj/machinery/door/airlock/titanium{
	name = "Supply Shuttle Airlock";
	req_access_txt = "31"
	},
/obj/docking_port/mobile/supply{
	dwidth = 5;
	width = 12
	},
/obj/machinery/door/firedoor/border_only{
	dir = 4
	},
/obj/machinery/door/firedoor/border_only{
	dir = 8
	},
/turf/open/floor/plating,
/area/shuttle/supply)
"j" = (
/obj/machinery/conveyor{
	dir = 8;
	id = "QMLoad"
	},
/obj/machinery/door/poddoor{
	id = "QMLoaddoor";
	name = "supply dock loading door"
	},
/obj/machinery/door/firedoor/border_only{
	dir = 4
	},
/obj/machinery/door/firedoor/border_only{
	dir = 8
	},
/turf/open/floor/plating,
/area/shuttle/supply)
"l" = (
/turf/closed/wall/mineral/titanium/interior,
/area/shuttle/supply)
"s" = (
/turf/template_noop,
/area/template_noop)
"v" = (
/obj/machinery/light,
/turf/open/floor/mineral/titanium/blue,
/area/shuttle/supply)
"x" = (
/obj/machinery/light{
	dir = 8
	},
/turf/open/floor/mineral/titanium/blue,
/area/shuttle/supply)
"y" = (
/obj/structure/shuttle/engine/propulsion{
	dir = 1
	},
/turf/open/floor/plating/airless,
/area/shuttle/supply)
"z" = (
/obj/machinery/light{
	dir = 4
	},
/obj/machinery/button/door{
	dir = 2;
	id = "QMLoaddoor2";
	name = "Loading Doors";
	pixel_x = 24;
	pixel_y = 8
	},
/obj/machinery/button/door{
	id = "QMLoaddoor";
	name = "Loading Doors";
	pixel_x = 24;
	pixel_y = -8
	},
/turf/open/floor/mineral/titanium/blue,
/area/shuttle/supply)
"A" = (
/obj/structure/shuttle/engine/propulsion/burst/right{
	dir = 1
	},
/turf/open/floor/plating/airless,
/area/shuttle/supply)
"H" = (
/obj/structure/shuttle/engine/propulsion/burst/left{
	dir = 1
	},
/turf/open/floor/plating/airless,
/area/shuttle/supply)

(1,1,1) = {"
s
b
b
b
b
b
b
b
b
b
b
b
"}
(2,1,1) = {"
A
b
l
e
e
e
x
e
e
e
e
b
"}
(3,1,1) = {"
y
c
e
e
a
e
e
e
a
e
e
b
"}
(4,1,1) = {"
y
c
e
e
a
a
a
a
a
e
v
b
"}
(5,1,1) = {"
y
c
e
e
a
e
e
e
a
e
e
b
"}
(6,1,1) = {"
H
b
l
e
e
e
z
e
e
e
e
b
"}
(7,1,1) = {"
s
b
b
b
f
g
b
i
j
b
b
b
"}
