//MAP CONVERTED BY dmm2tgm.py THIS HEADER COMMENT PREVENTS RECONVERSION, DO NOT REMOVE
"f" = (
/obj/machinery/light{
	dir = 8
	},
/turf/open/floor/plating/indoor/metal/plate,
/area/shuttle/supply)
"g" = (
/obj/machinery/light{
	dir = 1
	},
/turf/open/floor/plating/indoor/metal/plate,
/area/shuttle/supply)
"i" = (
/obj/docking_port/mobile/supply{
	dwidth = 5;
	width = 12
	},
/obj/structure/fans/tiny/invisible,
/obj/machinery/door/unpowered/halflife/metal{
	dir = 4
	},
/turf/open/floor/plating/indoor/metal/grate,
/area/shuttle/supply)
"o" = (
/turf/closed/wall/halflife/metal,
/area/shuttle/supply)
"q" = (
/obj/structure/window/reinforced{
	dir = 1
	},
/obj/structure/shuttle/engine/heater,
/turf/open/floor/plating/airless,
/area/shuttle/supply)
"s" = (
/turf/template_noop,
/area/template_noop)
"t" = (
/obj/structure/shuttle/engine/propulsion/burst/left,
/turf/open/floor/plating/airless,
/area/shuttle/supply)
"u" = (
/obj/structure/shuttle/engine/propulsion,
/turf/open/floor/plating/airless,
/area/shuttle/supply)
"v" = (
/obj/structure/shuttle/engine/propulsion/burst/right,
/turf/open/floor/plating/airless,
/area/shuttle/supply)
"z" = (
/obj/machinery/light{
	dir = 4
	},
/turf/open/floor/plating/indoor/metal/plate,
/area/shuttle/supply)
"J" = (
/turf/open/floor/plating/indoor/metal/plate,
/area/shuttle/supply)
"P" = (
/obj/structure/fans/tiny/invisible,
/obj/machinery/door/unpowered/halflife/metal{
	dir = 4
	},
/turf/open/floor/plating/indoor/metal/grate,
/area/shuttle/supply)
"Z" = (
/obj/machinery/door/unpowered/halflife/metal{
	dir = 8
	},
/obj/structure/fans/tiny/invisible,
/turf/open/floor/plating/indoor/metal/grate,
/area/shuttle/supply)

(1,1,1) = {"
o
o
o
o
Z
o
Z
o
o
o
o
s
"}
(2,1,1) = {"
o
J
J
J
J
f
J
J
J
o
o
t
"}
(3,1,1) = {"
o
J
J
J
J
J
J
J
J
J
q
u
"}
(4,1,1) = {"
o
g
J
J
J
J
J
J
J
J
q
u
"}
(5,1,1) = {"
o
J
J
J
J
J
J
J
J
J
q
u
"}
(6,1,1) = {"
o
J
J
J
J
z
J
J
J
o
o
v
"}
(7,1,1) = {"
o
o
o
o
P
o
i
o
o
o
o
s
"}
