"a" = (/obj/structure/chair/comfy/shuttle{dir = 8},/obj/structure/extinguisher_cabinet{pixel_y = 30; pixel_x = 5},/obj/machinery/light/small{dir = 4},/turf/open/floor/pod/dark,/area/space)
"b" = (/obj/machinery/door/firedoor/border_only{dir = 4},/obj/machinery/door/firedoor/border_only{dir = 8},/obj/machinery/door/airlock/survival_pod/glass{name = "D.I.V.E.R. A"},/turf/open/floor/pod,/area/space)
"d" = (/obj/structure/window/reinforced/survival_pod{dir = 6},/turf/open/floor/pod/light,/area/space)
"e" = (/obj/machinery/door/firedoor/window,/obj/structure/window/shuttle/survival_pod/spawner,/turf/closed/wall/mineral/titanium/survival/pod,/area/space)
"g" = (/obj/structure/chair/comfy/shuttle{dir = 4},/obj/machinery/light/small{brightness = 3; dir = 8},/turf/open/floor/pod/dark,/area/space)
"h" = (/obj/machinery/door/firedoor/border_only,/obj/machinery/door/firedoor/border_only{dir = 1},/obj/machinery/door/airlock/survival_pod/glass{name = "D.I.V.E.R. A"},/turf/open/floor/pod,/area/space)
"k" = (/obj/structure/chair/comfy/shuttle{dir = 4},/turf/open/floor/pod/dark,/area/space)
"w" = (/turf/closed/wall/mineral/titanium/survival/pod,/area/space)
"x" = (/obj/structure/window/reinforced/survival_pod{dir = 9},/turf/open/floor/pod/light,/area/space)
"z" = (/obj/machinery/light/floor,/obj/machinery/computer/shuttle/diver_a,/turf/open/floor/pod/dark,/area/space)
"A" = (/obj/structure/window/reinforced/survival_pod,/turf/open/floor/pod/light,/area/space)
"C" = (/obj/structure/window/reinforced/survival_pod{dir = 5},/turf/open/floor/pod/light,/area/space)
"E" = (/obj/structure/chair/comfy/shuttle{dir = 8},/obj/machinery/light/small{dir = 4},/turf/open/floor/pod/dark,/area/space)
"H" = (/obj/machinery/door/firedoor/window,/obj/structure/window/shuttle/survival_pod/spawner,/turf/open/floor/plating,/area/space)
"N" = (/obj/structure/chair/comfy/shuttle{dir = 8},/turf/open/floor/pod/dark,/area/space)
"R" = (/obj/structure/window/reinforced/survival_pod{dir = 10},/turf/open/floor/pod/light,/area/space)
"W" = (/obj/structure/chair/comfy/shuttle{dir = 1},/turf/open/floor/pod/dark,/area/space)
"Z" = (/turf/open/floor/pod/light,/area/space)

(1,1,1) = {"
wwHhHww
wgZZZaw
HkdARNH
bZCzxZb
ekZZZWH
wgZZZEw
wwHhHww
"}
