//MAP CONVERTED BY dmm2tgm.py THIS HEADER COMMENT PREVENTS RECONVERSION, DO NOT REMOVE
"a" = (
/turf/template_noop,
/area/template_noop)
"b" = (
/obj/machinery/stasis{
	dir = 4
	},
/turf/open/floor/mineral/titanium/white,
/area/shuttle/escape)
"c" = (
/obj/structure/chair/comfy/shuttle{
	dir = 4
	},
/obj/machinery/vending/wallmed{
	pixel_x = -32
	},
/turf/open/floor/mineral/titanium/blue,
/area/shuttle/escape)
"d" = (
/turf/closed/wall/mineral/titanium,
/area/shuttle/escape)
"e" = (
/obj/structure/chair/comfy/shuttle{
	dir = 4
	},
/obj/machinery/door/firedoor/border_only{
	dir = 8
	},
/turf/open/floor/mineral/titanium/blue,
/area/shuttle/escape)
"f" = (
/obj/machinery/status_display/evac,
/turf/closed/wall/mineral/titanium,
/area/shuttle/escape)
"g" = (
/obj/machinery/door/airlock/titanium{
	name = "Emergency Shuttle Airlock"
	},
/obj/machinery/door/firedoor/border_only{
	dir = 1
	},
/obj/machinery/door/firedoor/border_only,
/turf/open/floor/plating,
/area/shuttle/escape)
"h" = (
/obj/machinery/door/airlock/titanium{
	name = "Emergency Shuttle Airlock"
	},
/obj/docking_port/mobile/emergency{
	dheight = 0;
	dir = 2;
	dwidth = 9;
	name = "NES Port";
	width = 19
	},
/obj/machinery/door/firedoor/border_only{
	dir = 1
	},
/obj/machinery/door/firedoor/border_only,
/turf/open/floor/plating,
/area/shuttle/escape)
"i" = (
/obj/structure/chair/comfy/shuttle{
	dir = 4
	},
/obj/machinery/door/firedoor/border_only,
/obj/machinery/door/firedoor/border_only{
	dir = 4
	},
/turf/open/floor/mineral/titanium/blue,
/area/shuttle/escape)
"j" = (
/obj/machinery/door/firedoor/border_only{
	dir = 8
	},
/turf/open/floor/mineral/titanium,
/area/shuttle/escape)
"k" = (
/obj/machinery/door/firedoor/border_only,
/turf/open/floor/mineral/titanium,
/area/shuttle/escape)
"l" = (
/obj/machinery/vending/wallmed,
/turf/closed/wall/mineral/titanium,
/area/shuttle/escape)
"m" = (
/obj/effect/spawner/structure/window/shuttle,
/turf/open/floor/plating,
/area/shuttle/escape)
"n" = (
/turf/open/floor/mineral/titanium/white,
/area/shuttle/escape)
"o" = (
/obj/machinery/door/firedoor/border_only,
/obj/machinery/door/firedoor/border_only{
	dir = 8
	},
/obj/machinery/portable_atmospherics/canister/air,
/turf/open/floor/mineral/titanium/blue,
/area/shuttle/escape)
"p" = (
/obj/structure/shuttle/engine/propulsion{
	dir = 8;
	icon_state = "propulsion"
	},
/turf/open/floor/plating/airless,
/area/shuttle/escape)
"r" = (
/turf/open/floor/mineral/titanium,
/area/shuttle/escape)
"s" = (
/obj/structure/chair/comfy/shuttle{
	dir = 4
	},
/turf/open/floor/mineral/titanium/blue,
/area/shuttle/escape)
"t" = (
/turf/closed/wall/mineral/titanium/interior,
/area/shuttle/escape)
"u" = (
/obj/structure/chair/comfy/brown{
	dir = 4
	},
/obj/machinery/light/small{
	dir = 1
	},
/turf/open/floor/mineral/titanium/yellow,
/area/shuttle/escape)
"v" = (
/obj/structure/table,
/obj/effect/spawner/lootdrop/maintenance,
/turf/open/floor/mineral/titanium/white,
/area/shuttle/escape)
"w" = (
/obj/machinery/door/airlock/public/glass{
	name = "Emergency Shuttle Infirmary"
	},
/obj/machinery/door/firedoor/border_only{
	dir = 4
	},
/obj/machinery/door/firedoor/border_only{
	dir = 8
	},
/turf/open/floor/mineral/titanium/white,
/area/shuttle/escape)
"x" = (
/obj/machinery/door/firedoor/border_only{
	dir = 8
	},
/obj/machinery/door/firedoor/border_only{
	dir = 1
	},
/obj/machinery/portable_atmospherics/canister/air,
/turf/open/floor/mineral/titanium/blue,
/area/shuttle/escape)
"y" = (
/obj/effect/spawner/structure/window/shuttle,
/obj/machinery/door/firedoor/border_only{
	dir = 1
	},
/turf/open/floor/plating,
/area/shuttle/escape)
"z" = (
/obj/structure/chair/comfy/shuttle{
	dir = 4
	},
/obj/machinery/light{
	dir = 4
	},
/obj/machinery/door/firedoor/border_only{
	dir = 1
	},
/turf/open/floor/mineral/titanium/blue,
/area/shuttle/escape)
"A" = (
/obj/structure/chair/comfy/brown{
	dir = 4
	},
/turf/open/floor/mineral/titanium/yellow,
/area/shuttle/escape)
"B" = (
/obj/machinery/vending/wallmed{
	pixel_y = 32
	},
/turf/open/floor/mineral/titanium/white,
/area/shuttle/escape)
"C" = (
/obj/machinery/door/firedoor/border_only{
	dir = 1
	},
/turf/open/floor/mineral/titanium,
/area/shuttle/escape)
"D" = (
/obj/structure/chair/comfy/brown{
	dir = 4
	},
/obj/machinery/light/small,
/turf/open/floor/mineral/titanium/yellow,
/area/shuttle/escape)
"E" = (
/obj/machinery/door/airlock/public/glass{
	name = "Emergency Shuttle Cockpit";
	req_access_txt = "19"
	},
/obj/machinery/door/firedoor/border_only{
	dir = 4
	},
/obj/machinery/door/firedoor/border_only{
	dir = 8
	},
/turf/open/floor/mineral/titanium/yellow,
/area/shuttle/escape)
"F" = (
/turf/open/floor/mineral/titanium/yellow,
/area/shuttle/escape)
"G" = (
/obj/structure/table/reinforced,
/obj/item/storage/toolbox/emergency,
/turf/open/floor/mineral/titanium/yellow,
/area/shuttle/escape)
"H" = (
/obj/structure/chair/comfy/shuttle{
	dir = 4
	},
/turf/open/floor/mineral/plastitanium/red/brig,
/area/shuttle/escape)
"I" = (
/obj/structure/table/reinforced,
/obj/item/radio,
/turf/open/floor/mineral/titanium/yellow,
/area/shuttle/escape)
"J" = (
/turf/open/floor/mineral/plastitanium/red/brig,
/area/shuttle/escape)
"K" = (
/obj/machinery/door/airlock/public/glass{
	name = "Emergency Shuttle Brig";
	req_access_txt = "2"
	},
/obj/machinery/door/firedoor/border_only{
	dir = 4
	},
/obj/machinery/door/firedoor/border_only{
	dir = 8
	},
/turf/open/floor/mineral/plastitanium/red/brig,
/area/shuttle/escape)
"L" = (
/obj/machinery/computer/emergency_shuttle{
	dir = 8
	},
/turf/open/floor/mineral/titanium/yellow,
/area/shuttle/escape)
"M" = (
/obj/structure/chair/comfy/shuttle{
	dir = 4
	},
/obj/machinery/door/firedoor/border_only{
	dir = 1
	},
/turf/open/floor/mineral/titanium/blue,
/area/shuttle/escape)
"N" = (
/obj/structure/table/reinforced,
/obj/item/storage/firstaid/regular,
/turf/open/floor/mineral/titanium/yellow,
/area/shuttle/escape)
"O" = (
/obj/effect/spawner/structure/window/shuttle,
/obj/machinery/door/firedoor/border_only{
	dir = 4
	},
/turf/open/floor/plating,
/area/shuttle/escape)
"P" = (
/obj/effect/spawner/structure/window/shuttle,
/obj/machinery/door/firedoor/border_only,
/turf/open/floor/plating,
/area/shuttle/escape)
"Q" = (
/obj/machinery/light,
/obj/machinery/door/firedoor/border_only{
	dir = 4
	},
/turf/open/floor/mineral/titanium,
/area/shuttle/escape)
"R" = (
/obj/machinery/light/small,
/turf/open/floor/mineral/titanium/white,
/area/shuttle/escape)
"S" = (
/obj/structure/chair/comfy/shuttle{
	dir = 4
	},
/obj/machinery/light{
	dir = 4
	},
/obj/machinery/door/firedoor/border_only,
/turf/open/floor/mineral/titanium/blue,
/area/shuttle/escape)
"T" = (
/obj/structure/chair/comfy/shuttle{
	dir = 4
	},
/obj/machinery/light/small{
	dir = 1
	},
/turf/open/floor/mineral/plastitanium/red/brig,
/area/shuttle/escape)
"U" = (
/obj/structure/chair/comfy/shuttle{
	dir = 4
	},
/obj/machinery/door/firedoor/border_only{
	dir = 1
	},
/obj/machinery/door/firedoor/border_only{
	dir = 4
	},
/turf/open/floor/mineral/titanium/blue,
/area/shuttle/escape)
"V" = (
/obj/machinery/light{
	dir = 1
	},
/obj/machinery/door/firedoor/border_only{
	dir = 4
	},
/turf/open/floor/mineral/titanium,
/area/shuttle/escape)
"W" = (
/obj/structure/shuttle/engine/heater{
	dir = 8
	},
/obj/structure/window/reinforced{
	dir = 4
	},
/turf/open/floor/plating/airless,
/area/shuttle/escape)
"Z" = (
/obj/structure/chair/comfy/shuttle{
	dir = 4
	},
/obj/machinery/door/firedoor/border_only,
/turf/open/floor/mineral/titanium/blue,
/area/shuttle/escape)

(1,1,1) = {"
a
d
p
p
p
d
p
p
p
d
a
"}
(2,1,1) = {"
p
d
W
W
W
d
W
W
W
d
p
"}
(3,1,1) = {"
W
d
b
v
b
d
H
H
H
d
W
"}
(4,1,1) = {"
d
d
B
n
R
d
T
J
H
l
d
"}
(5,1,1) = {"
d
d
d
w
f
d
f
K
d
d
d
"}
(6,1,1) = {"
a
d
Z
r
M
c
Z
r
M
d
a
"}
(7,1,1) = {"
a
y
Z
r
M
s
Z
r
M
P
a
"}
(8,1,1) = {"
d
d
i
Q
d
m
d
V
U
d
d
"}
(9,1,1) = {"
g
k
r
r
C
r
k
r
r
C
g
"}
(10,1,1) = {"
h
k
r
r
C
r
k
r
r
C
g
"}
(11,1,1) = {"
d
d
e
e
o
j
x
e
e
d
d
"}
(12,1,1) = {"
a
y
s
s
Z
r
M
s
s
P
a
"}
(13,1,1) = {"
a
y
s
s
Z
r
M
s
s
P
a
"}
(14,1,1) = {"
a
d
t
s
S
r
z
s
t
d
a
"}
(15,1,1) = {"
a
d
d
m
d
E
f
m
d
d
a
"}
(16,1,1) = {"
a
a
y
G
A
F
A
N
P
a
a
"}
(17,1,1) = {"
a
a
d
d
u
A
D
d
d
a
a
"}
(18,1,1) = {"
a
a
a
y
I
L
N
P
a
a
a
"}
(19,1,1) = {"
a
a
a
d
O
O
O
d
a
a
a
"}
