// This map has been converted using maphash
"agy" = (/obj/item/toy/snappop/phoenix,/obj/machinery/light/small{dir = 1},/turf/open/floor/bluespace,/area/shuttle/escape)
"arG" = (/turf/template_noop,/area/template_noop)
"aLe" = (/obj/structure/window/reinforced{dir = 4},/obj/structure/bed,/obj/item/bedsheet/random,/turf/open/floor/mineral/bananium,/area/shuttle/escape)
"aYe" = (/obj/structure/table,/obj/item/toy/sword,/obj/machinery/door/firedoor/border_only,/turf/open/floor/mineral/bananium,/area/shuttle/escape)
"bUW" = (/obj/machinery/light/small{dir = 4},/obj/machinery/door/firedoor/border_only,/turf/open/floor/mineral/bananium,/area/shuttle/escape)
"cme" = (/obj/machinery/vending/clothing{extended_inventory = 1},/turf/open/floor/mineral/bananium,/area/shuttle/escape)
"cSF" = (/turf/closed/wall/mineral/titanium,/area/shuttle/escape)
"duT" = (/obj/item/toy/snappop/phoenix,/obj/machinery/door/firedoor/border_only{dir = 4},/turf/open/floor/bluespace,/area/shuttle/escape)
"dyY" = (/obj/machinery/vending/wallmed{name = "Emergency NanoMed"; use_power = 0},/turf/closed/wall/mineral/titanium/nodiagonal,/area/shuttle/escape)
"dCw" = (/obj/structure/window/reinforced{dir = 4},/obj/structure/bed,/obj/item/bedsheet/random,/obj/machinery/door/firedoor/border_only,/turf/open/floor/mineral/bananium,/area/shuttle/escape)
"dWN" = (/obj/effect/spawner/structure/window/shuttle,/obj/machinery/door/firedoor/border_only{dir = 4},/turf/open/floor/plating,/area/shuttle/escape)
"ebi" = (/obj/item/toy/snappop/phoenix,/obj/machinery/door/firedoor/border_only{dir = 1},/turf/open/floor/bluespace,/area/shuttle/escape)
"epL" = (/obj/structure/closet/crate/trashcart{desc = "A heavy, metal trashcart with wheels. Feel free to hop in at any time!"},/obj/item/toy/sword,/turf/open/floor/mineral/bananium,/area/shuttle/escape)
"eZb" = (/obj/structure/window/reinforced{dir = 8},/obj/structure/bed,/obj/item/bedsheet/random,/turf/open/floor/mineral/bananium,/area/shuttle/escape)
"fBs" = (/obj/machinery/door/airlock/bananium/glass{name = "Emergency Shuttle Greentext"},/obj/machinery/door/firedoor/border_only{dir = 4},/obj/machinery/door/firedoor/border_only{dir = 8},/turf/open/floor/bluespace,/area/shuttle/escape)
"fVT" = (/obj/machinery/door/airlock/bananium/glass{name = "Emergency Shuttle Premium Lounge"},/obj/machinery/door/firedoor/border_only{dir = 1},/obj/machinery/door/firedoor/border_only,/turf/open/floor/bluespace,/area/shuttle/escape)
"fYX" = (/obj/machinery/door/airlock/bananium/glass{name = "Emergency Shuttle Infirmary"},/obj/machinery/door/firedoor/border_only{dir = 1},/obj/machinery/door/firedoor/border_only,/turf/open/floor/bluespace,/area/shuttle/escape)
"gJi" = (/obj/structure/table,/obj/item/storage/firstaid/fire,/obj/item/storage/firstaid/regular{pixel_x = 2; pixel_y = 3},/obj/item/crowbar,/turf/open/floor/mineral/bananium,/area/shuttle/escape)
"het" = (/obj/structure/extinguisher_cabinet{pixel_x = -5; pixel_y = 30},/obj/item/toy/snappop/phoenix,/turf/open/floor/bluespace,/area/shuttle/escape)
"hgR" = (/obj/item/toy/snappop/phoenix,/turf/open/floor/bluespace,/area/shuttle/escape)
"hFe" = (/obj/structure/chair/comfy/shuttle{dir = 4},/turf/open/floor/bluespace,/area/shuttle/escape)
"hVE" = (/obj/structure/bed,/obj/item/bedsheet/random,/turf/open/floor/mineral/bananium,/area/shuttle/escape)
"icz" = (/obj/machinery/door/airlock/bananium{name = "Emergency Shuttle Airlock"},/obj/machinery/door/firedoor/border_only{dir = 4},/obj/machinery/door/firedoor/border_only{dir = 8},/turf/open/floor/plating,/area/shuttle/escape)
"iyO" = (/obj/structure/table,/obj/item/toy/sword,/obj/machinery/door/firedoor/border_only,/obj/machinery/door/firedoor/border_only{dir = 4},/turf/open/floor/mineral/bananium,/area/shuttle/escape)
"iNK" = (/obj/machinery/door/firedoor/border_only{dir = 4},/turf/open/floor/mineral/bananium,/area/shuttle/escape)
"jkb" = (/obj/structure/table,/obj/item/multitool/ai_detect,/obj/machinery/door/firedoor/border_only{dir = 4},/turf/open/floor/mineral/bananium,/area/shuttle/escape)
"jpi" = (/obj/structure/bed,/obj/item/bedsheet/random,/obj/structure/window/reinforced{dir = 8},/obj/machinery/door/firedoor/border_only{dir = 1},/turf/open/floor/mineral/bananium,/area/shuttle/escape)
"jCJ" = (/obj/structure/closet/emcloset,/obj/item/toy/sword,/turf/open/floor/mineral/bananium,/area/shuttle/escape)
"jMi" = (/obj/item/greentext/quiet{anchored = 1},/turf/open/floor/mineral/plastitanium/red/brig,/area/shuttle/escape)
"jUN" = (/obj/structure/table,/obj/item/toy/sword,/obj/machinery/light{dir = 8},/obj/machinery/door/firedoor/border_only,/turf/open/floor/mineral/bananium,/area/shuttle/escape)
"kcX" = (/obj/machinery/computer/security{dir = 8},/turf/open/floor/mineral/bananium,/area/shuttle/escape)
"kyH" = (/obj/structure/bed,/obj/item/bedsheet/random,/obj/machinery/door/firedoor/border_only,/turf/open/floor/mineral/bananium,/area/shuttle/escape)
"kLD" = (/obj/machinery/status_display/evac,/turf/closed/wall/mineral/titanium,/area/shuttle/escape)
"lbq" = (/obj/structure/table,/obj/item/storage/firstaid/regular{pixel_x = 2; pixel_y = 3},/obj/item/crowbar,/turf/open/floor/mineral/bananium,/area/shuttle/escape)
"lhC" = (/obj/structure/chair/comfy/shuttle,/turf/open/floor/mineral/bananium,/area/shuttle/escape)
"lXT" = (/turf/open/chasm,/area/shuttle/escape)
"mad" = (/obj/machinery/door/airlock/bananium{name = "Emergency Shuttle Cargo"},/obj/machinery/door/firedoor/border_only{dir = 1},/obj/machinery/door/firedoor/border_only,/turf/open/floor/bluespace,/area/shuttle/escape)
"meq" = (/obj/item/radio/intercom{name = "Station Intercom (General)"; pixel_y = -29},/obj/item/toy/snappop/phoenix,/turf/open/floor/bluespace,/area/shuttle/escape)
"mBb" = (/obj/structure/chair/comfy/shuttle{dir = 4},/turf/open/floor/mineral/bananium,/area/shuttle/escape)
"mEx" = (/obj/structure/extinguisher_cabinet{pixel_x = 27},/obj/item/toy/snappop/phoenix,/obj/machinery/light/small{dir = 4},/turf/open/floor/bluespace,/area/shuttle/escape)
"mIX" = (/obj/structure/extinguisher_cabinet{pixel_x = 27},/obj/machinery/portable_atmospherics/canister/air,/turf/open/floor/mineral/bananium,/area/shuttle/escape)
"mPQ" = (/obj/machinery/vending/autodrobe{extended_inventory = 1; scan_id = 0},/turf/open/floor/mineral/bananium,/area/shuttle/escape)
"mZW" = (/turf/closed/wall/mineral/titanium/interior,/area/shuttle/escape)
"ndh" = (/obj/structure/extinguisher_cabinet{pixel_y = -30},/obj/item/toy/snappop/phoenix,/turf/open/floor/bluespace,/area/shuttle/escape)
"njn" = (/obj/machinery/computer/emergency_shuttle,/turf/open/floor/bluespace,/area/shuttle/escape)
"nmY" = (/obj/effect/spawner/structure/window/shuttle,/obj/machinery/door/firedoor/border_only{dir = 8},/turf/open/floor/plating,/area/shuttle/escape)
"nFB" = (/obj/machinery/stasis,/turf/open/floor/mineral/bananium,/area/shuttle/escape)
"oye" = (/obj/item/toy/snappop/phoenix,/obj/machinery/door/firedoor/border_only,/turf/open/floor/bluespace,/area/shuttle/escape)
"oBg" = (/obj/structure/window/reinforced{dir = 8},/obj/structure/bed,/obj/item/bedsheet/random,/obj/machinery/door/firedoor/border_only{dir = 1},/turf/open/floor/mineral/bananium,/area/shuttle/escape)
"pnZ" = (/obj/item/toy/snappop/phoenix,/obj/machinery/light,/turf/open/floor/bluespace,/area/shuttle/escape)
"qat" = (/obj/machinery/light{dir = 1},/turf/open/floor/mineral/bananium,/area/shuttle/escape)
"rFS" = (/obj/item/toy/snappop/phoenix,/obj/machinery/light/small,/turf/open/floor/bluespace,/area/shuttle/escape)
"rMn" = (/obj/structure/window/reinforced{dir = 1},/obj/structure/shuttle/engine/heater,/turf/open/floor/plating/airless,/area/shuttle/escape)
"rTO" = (/obj/structure/chair/comfy/shuttle{dir = 1},/turf/open/floor/bluespace,/area/shuttle/escape)
"ttd" = (/obj/structure/window/reinforced{dir = 8},/obj/structure/bed,/obj/item/bedsheet/random,/obj/machinery/door/firedoor/border_only,/turf/open/floor/mineral/bananium,/area/shuttle/escape)
"tzg" = (/obj/machinery/light/small{dir = 4},/obj/machinery/portable_atmospherics/canister/air,/turf/open/floor/mineral/bananium,/area/shuttle/escape)
"ujx" = (/obj/structure/chair/comfy/shuttle{dir = 8},/obj/structure/extinguisher_cabinet{pixel_y = -30},/turf/open/floor/bluespace,/area/shuttle/escape)
"uoL" = (/obj/structure/chair/comfy/shuttle{dir = 8},/turf/open/floor/bluespace,/area/shuttle/escape)
"uCs" = (/obj/structure/table,/obj/item/storage/firstaid/fire,/turf/open/floor/mineral/bananium,/area/shuttle/escape)
"uNp" = (/obj/structure/window/reinforced{dir = 4},/obj/structure/bed,/obj/item/bedsheet/random,/obj/machinery/door/firedoor/border_only{dir = 1},/turf/open/floor/mineral/bananium,/area/shuttle/escape)
"uRM" = (/obj/effect/spawner/structure/window/shuttle,/turf/open/floor/plating,/area/shuttle/escape)
"vOG" = (/obj/structure/shuttle/engine/propulsion,/turf/open/floor/plating/airless,/area/shuttle/escape)
"wEa" = (/obj/item/toy/snappop/phoenix,/obj/machinery/door/firedoor/border_only{dir = 8},/turf/open/floor/bluespace,/area/shuttle/escape)
"wWX" = (/obj/machinery/computer/crew{dir = 4},/turf/open/floor/mineral/bananium,/area/shuttle/escape)
"xsx" = (/obj/effect/spawner/structure/window/shuttle,/obj/machinery/door/firedoor/border_only{dir = 1},/turf/open/floor/plating,/area/shuttle/escape)
"xtB" = (/obj/structure/bed,/obj/item/bedsheet/random,/obj/machinery/door/firedoor/border_only{dir = 1},/turf/open/floor/mineral/bananium,/area/shuttle/escape)
"xxl" = (/obj/structure/table,/obj/item/storage/firstaid/fire,/obj/item/storage/firstaid/regular{pixel_x = 2; pixel_y = 3},/obj/item/crowbar,/obj/structure/extinguisher_cabinet{pixel_x = 27},/obj/machinery/light/small{dir = 4},/turf/open/floor/mineral/bananium,/area/shuttle/escape)
"xRV" = (/obj/machinery/door/airlock/bananium{name = "Emergency Shuttle Airlock"},/obj/docking_port/mobile/emergency{name = "Snappop(tm)!"},/obj/machinery/door/firedoor/border_only{dir = 4},/obj/machinery/door/firedoor/border_only{dir = 8},/turf/open/floor/plating,/area/shuttle/escape)
"ybW" = (/obj/machinery/computer/atmos_alert{dir = 4},/turf/open/floor/mineral/bananium,/area/shuttle/escape)
"yey" = (/obj/machinery/light/small{brightness = 3; dir = 8},/turf/open/floor/mineral/bananium,/area/shuttle/escape)
"yhL" = (/turf/open/floor/mineral/bananium,/area/shuttle/escape)
"yia" = (/obj/machinery/computer/communications{dir = 8},/turf/open/floor/mineral/bananium,/area/shuttle/escape)

(1,1,1) = {"
arG
arG
arG
arG
cSF
cSF
cSF
cSF
cSF
xRV
cSF
nmY
nmY
nmY
cSF
icz
cSF
icz
cSF
cSF
cSF
arG
"}
(2,1,1) = {"
arG
cSF
cSF
cSF
cSF
lXT
lXT
lXT
cSF
agy
xtB
hVE
hVE
hVE
kyH
rFS
cSF
yhL
yey
epL
cSF
cSF
"}
(3,1,1) = {"
cSF
mZW
ybW
wWX
cSF
lXT
jMi
lXT
cSF
het
ebi
hgR
hgR
hgR
oye
ndh
cSF
yhL
yhL
epL
rMn
vOG
"}
(4,1,1) = {"
xsx
uCs
uoL
ujx
cSF
lXT
lXT
lXT
cSF
hgR
uNp
aLe
aLe
aLe
dCw
hgR
mad
yhL
yhL
mPQ
rMn
vOG
"}
(5,1,1) = {"
xsx
rTO
hgR
meq
cSF
uRM
fBs
uRM
dyY
wEa
oBg
eZb
eZb
eZb
ttd
wEa
cSF
mIX
tzg
cme
rMn
vOG
"}
(6,1,1) = {"
xsx
njn
hgR
pnZ
cSF
qat
hgR
lhC
jUN
hgR
ebi
hgR
hgR
hgR
oye
pnZ
kLD
cSF
cSF
cSF
rMn
vOG
"}
(7,1,1) = {"
xsx
rTO
hgR
hgR
fVT
hgR
hgR
mBb
aYe
duT
uNp
aLe
aLe
aLe
dCw
duT
uRM
jCJ
yey
jCJ
rMn
vOG
"}
(8,1,1) = {"
xsx
lbq
hFe
hFe
kLD
iNK
duT
jkb
iyO
hgR
jpi
eZb
eZb
eZb
ttd
hgR
fYX
yhL
yhL
yhL
rMn
vOG
"}
(9,1,1) = {"
cSF
mZW
kcX
yia
cSF
jCJ
oye
hgR
hgR
hgR
ebi
hgR
hgR
hgR
oye
hgR
uRM
yhL
yhL
yhL
rMn
vOG
"}
(10,1,1) = {"
arG
cSF
cSF
cSF
cSF
gJi
bUW
yhL
yhL
mEx
xtB
hVE
hVE
hVE
kyH
mEx
uRM
nFB
xxl
nFB
cSF
cSF
"}
(11,1,1) = {"
arG
arG
arG
arG
cSF
dWN
cSF
dWN
cSF
cSF
cSF
dWN
dWN
dWN
cSF
cSF
cSF
dWN
cSF
dWN
cSF
arG
"}
