// This map has been converted using maphash
"arG" = (/turf/template_noop,/area/template_noop)
"avW" = (/obj/structure/chair/comfy/brown{dir = 8},/turf/open/floor/carpet,/area/shuttle/escape)
"bad" = (/obj/machinery/door/airlock/gold{req_access_txt = "19"},/obj/machinery/door/firedoor/border_only{dir = 1},/obj/machinery/door/firedoor/border_only,/turf/open/floor/mineral/gold,/area/shuttle/escape)
"bTq" = (/obj/structure/table/wood/fancy,/obj/item/reagent_containers/food/drinks/bottle/absinthe,/turf/open/floor/wood,/area/shuttle/escape)
"ccw" = (/obj/structure/table/wood,/obj/item/flashlight/lamp/green,/turf/open/floor/mineral/gold,/area/shuttle/escape)
"cFM" = (/turf/open/floor/light/colour_cycle,/area/shuttle/escape)
"cIK" = (/obj/structure/chair/comfy/brown{dir = 4},/turf/open/floor/mineral/gold,/area/shuttle/escape)
"dqR" = (/obj/structure/statue/plasma/scientist{anchored = 1; oreAmount = 50},/turf/open/floor/light/colour_cycle,/area/shuttle/escape)
"dIV" = (/obj/structure/table/wood/fancy,/obj/item/reagent_containers/food/drinks/bottle/vodka/badminka,/turf/open/floor/wood,/area/shuttle/escape)
"eEg" = (/obj/machinery/computer/slot_machine{dir = 3},/turf/open/floor/wood,/area/shuttle/escape)
"eIK" = (/obj/machinery/computer/crew{dir = 4},/turf/open/floor/mineral/gold,/area/shuttle/escape)
"eMx" = (/turf/open/floor/carpet,/area/shuttle/escape)
"eNi" = (/obj/machinery/jukebox/disco/indestructible,/turf/open/floor/light/colour_cycle,/area/shuttle/escape)
"eXF" = (/obj/structure/chair/comfy/brown{dir = 1},/turf/open/floor/mineral/gold,/area/shuttle/escape)
"flK" = (/obj/docking_port/mobile/emergency{name = "Disco Inferno"},/obj/machinery/door/airlock/gold{armor = list("melee" = 30, "bullet" = 30, "laser" = 20, "energy" = 20, "bomb" = 10, "bio" = 100, "rad" = 100, "fire" = 100, "acid" = 100); heat_proof = 1; resistance_flags = 2},/obj/machinery/door/firedoor/border_only{dir = 4},/obj/machinery/door/firedoor/border_only{dir = 8},/turf/open/floor/mineral/plasma,/area/shuttle/escape)
"fun" = (/obj/effect/spawner/structure/window/plasma/reinforced,/obj/machinery/door/firedoor/border_only{dir = 1},/turf/open/floor/plasteel/elevatorshaft,/area/shuttle/escape)
"fJf" = (/obj/structure/table/wood,/obj/item/storage/fancy/cigarettes/cigars/havana,/obj/item/lighter{pixel_x = -4; pixel_y = 6},/turf/open/floor/mineral/gold,/area/shuttle/escape)
"fSK" = (/turf/open/floor/wood,/area/shuttle/escape)
"gOC" = (/obj/structure/table/wood/fancy,/obj/item/reagent_containers/food/drinks/bottle/lizardwine,/turf/open/floor/wood,/area/shuttle/escape)
"imk" = (/obj/structure/chair/comfy/brown{dir = 1},/turf/open/floor/carpet,/area/shuttle/escape)
"iqc" = (/obj/machinery/computer/emergency_shuttle,/turf/open/floor/mineral/gold,/area/shuttle/escape)
"ivA" = (/obj/effect/spawner/structure/window/plasma/reinforced,/obj/machinery/door/firedoor/border_only{dir = 8},/turf/open/floor/plasteel/elevatorshaft,/area/shuttle/escape)
"iHd" = (/obj/effect/spawner/structure/window/plasma/reinforced,/turf/open/floor/plasteel/elevatorshaft,/area/shuttle/escape)
"jYJ" = (/obj/machinery/portable_atmospherics/canister/air,/turf/open/floor/wood,/area/shuttle/escape)
"kfC" = (/obj/structure/shuttle/engine/heater,/obj/structure/window/plasma/reinforced{dir = 1},/turf/open/floor/plating/airless,/area/shuttle/escape)
"kKf" = (/turf/closed/wall/mineral/plastitanium,/area/shuttle/escape)
"leS" = (/obj/machinery/computer/communications{dir = 8},/turf/open/floor/mineral/gold,/area/shuttle/escape)
"mEM" = (/obj/machinery/computer/security{dir = 8},/turf/open/floor/mineral/gold,/area/shuttle/escape)
"mGg" = (/obj/machinery/computer/atmos_alert{dir = 4},/turf/open/floor/mineral/gold,/area/shuttle/escape)
"oum" = (/obj/structure/chair/comfy/brown{dir = 4},/turf/open/floor/carpet,/area/shuttle/escape)
"oHS" = (/turf/closed/wall/mineral/plastitanium/nodiagonal,/area/shuttle/escape)
"oWc" = (/turf/open/floor/mineral/silver,/area/shuttle/escape)
"qAV" = (/obj/structure/chair/comfy/brown{dir = 8},/turf/open/floor/wood,/area/shuttle/escape)
"rbn" = (/turf/open/floor/mineral/plasma,/area/shuttle/escape)
"rbI" = (/obj/structure/table/wood/fancy,/obj/item/reagent_containers/food/drinks/bottle/cognac,/turf/open/floor/wood,/area/shuttle/escape)
"rvU" = (/obj/machinery/door/airlock/gold,/obj/machinery/door/firedoor/border_only{dir = 4},/obj/machinery/door/firedoor/border_only{dir = 8},/turf/open/floor/wood,/area/shuttle/escape)
"suz" = (/obj/structure/chair/comfy/brown{dir = 8},/turf/open/floor/mineral/gold,/area/shuttle/escape)
"sQp" = (/obj/machinery/portable_atmospherics/canister/air,/turf/open/floor/mineral/plasma,/area/shuttle/escape)
"tbL" = (/obj/structure/table/wood/fancy,/obj/item/reagent_containers/food/drinks/drinkingglass/shotglass,/obj/item/reagent_containers/food/drinks/drinkingglass/shotglass,/obj/item/reagent_containers/food/drinks/drinkingglass/shotglass,/obj/machinery/light{dir = 4},/obj/item/coin/plasma,/obj/item/coin/plasma,/turf/open/floor/wood,/area/shuttle/escape)
"tGz" = (/obj/structure/table/wood/poker,/obj/item/toy/cards/deck,/turf/open/floor/carpet,/area/shuttle/escape)
"vOG" = (/obj/structure/shuttle/engine/propulsion,/turf/open/floor/plating/airless,/area/shuttle/escape)
"wzX" = (/obj/structure/table/wood/poker,/obj/item/storage/box/drinkingglasses,/obj/item/reagent_containers/food/drinks/bottle/whiskey,/obj/machinery/light,/turf/open/floor/mineral/gold,/area/shuttle/escape)
"xuk" = (/obj/structure/chair/comfy/brown{dir = 2},/turf/open/floor/carpet,/area/shuttle/escape)
"xCO" = (/turf/open/floor/mineral/gold,/area/shuttle/escape)
"xIi" = (/obj/machinery/computer/slot_machine,/obj/machinery/light{dir = 8},/turf/open/floor/wood,/area/shuttle/escape)
"xXA" = (/obj/effect/spawner/structure/window/plasma/reinforced,/obj/machinery/door/firedoor/border_only{dir = 4},/turf/open/floor/plasteel/elevatorshaft,/area/shuttle/escape)

(1,1,1) = {"
arG
arG
arG
arG
kKf
kKf
kKf
ivA
kKf
flK
kKf
ivA
ivA
ivA
kKf
oHS
kKf
rvU
kKf
ivA
kKf
arG
"}
(2,1,1) = {"
arG
kKf
kKf
kKf
oHS
dqR
rbn
rbn
rbn
rbn
xCO
rbn
rbn
rbn
rbn
dqR
iHd
fSK
xIi
eEg
kKf
kKf
"}
(3,1,1) = {"
kKf
kKf
mGg
eIK
iHd
rbn
rbn
rbn
rbn
oWc
xCO
oWc
rbn
rbn
rbn
rbn
iHd
fSK
qAV
qAV
kfC
vOG
"}
(4,1,1) = {"
fun
ccw
suz
suz
iHd
rbn
rbn
rbn
xCO
xCO
cFM
xCO
xCO
rbn
rbn
rbn
iHd
fSK
fSK
jYJ
kfC
vOG
"}
(5,1,1) = {"
fun
eXF
xCO
xCO
iHd
rbn
rbn
oWc
xCO
cFM
cFM
cFM
xCO
oWc
rbn
rbn
iHd
eMx
oum
eMx
kfC
vOG
"}
(6,1,1) = {"
fun
iqc
xCO
wzX
iHd
rbn
xCO
xCO
cFM
cFM
eNi
cFM
cFM
xCO
xCO
rbn
iHd
xuk
tGz
imk
kfC
vOG
"}
(7,1,1) = {"
fun
eXF
xCO
xCO
bad
rbn
rbn
oWc
xCO
cFM
cFM
cFM
xCO
oWc
rbn
rbn
iHd
eMx
avW
eMx
kfC
vOG
"}
(8,1,1) = {"
fun
fJf
cIK
cIK
iHd
rbn
rbn
rbn
xCO
xCO
cFM
xCO
xCO
rbn
rbn
rbn
iHd
fSK
fSK
fSK
kfC
vOG
"}
(9,1,1) = {"
kKf
kKf
mEM
leS
iHd
rbn
rbn
rbn
rbn
oWc
xCO
oWc
rbn
rbn
rbn
sQp
iHd
rbI
fSK
bTq
kfC
vOG
"}
(10,1,1) = {"
arG
kKf
kKf
kKf
oHS
dqR
rbn
rbn
rbn
rbn
xCO
rbn
rbn
rbn
rbn
dqR
iHd
dIV
tbL
gOC
kKf
kKf
"}
(11,1,1) = {"
arG
arG
arG
arG
kKf
kKf
kKf
xXA
kKf
kKf
kKf
xXA
xXA
xXA
kKf
kKf
kKf
xXA
kKf
xXA
kKf
arG
"}
