// This map has been converted using maphash
"avI" = (/obj/item/twohanded/required/kirbyplants,/turf/open/floor/wood,/area/shuttle/escape)
"bel" = (/obj/structure/table/reinforced,/obj/item/reagent_containers/food/drinks/shaker,/obj/effect/turf_decal/tile/bar,/obj/effect/turf_decal/tile/bar{dir = 1},/turf/open/floor/plasteel,/area/shuttle/escape)
"bwK" = (/obj/structure/table/reinforced,/obj/machinery/door/firedoor/border_only{dir = 8},/turf/open/floor/carpet,/area/shuttle/escape)
"cFX" = (/obj/structure/table/reinforced,/obj/item/reagent_containers/food/drinks/drinkingglass/shotglass,/obj/item/reagent_containers/food/drinks/drinkingglass/shotglass,/obj/item/reagent_containers/food/drinks/drinkingglass/shotglass,/obj/item/reagent_containers/food/drinks/drinkingglass/shotglass,/obj/effect/turf_decal/tile/bar,/obj/effect/turf_decal/tile/bar{dir = 1},/turf/open/floor/plasteel,/area/shuttle/escape)
"dAP" = (/obj/structure/table/reinforced,/obj/effect/turf_decal/tile/bar,/obj/effect/turf_decal/tile/bar{dir = 1},/turf/open/floor/plasteel,/area/shuttle/escape)
"eEW" = (/obj/machinery/status_display/evac,/turf/closed/wall/mineral/wood,/area/shuttle/escape)
"eHi" = (/turf/closed/wall/mineral/wood,/area/shuttle/escape)
"eKv" = (/obj/structure/chair/office/dark,/turf/open/floor/wood,/area/shuttle/escape)
"eMx" = (/turf/open/floor/carpet,/area/shuttle/escape)
"fDR" = (/obj/structure/table/wood,/obj/machinery/computer/libraryconsole/bookmanagement,/turf/open/floor/wood,/area/shuttle/escape)
"fSK" = (/turf/open/floor/wood,/area/shuttle/escape)
"gpD" = (/obj/machinery/door/firedoor/border_only{dir = 8},/turf/open/floor/carpet,/area/shuttle/escape)
"gXx" = (/obj/machinery/door/window{dir = 8},/obj/effect/turf_decal/tile/bar,/obj/effect/turf_decal/tile/bar{dir = 1},/obj/machinery/door/firedoor/border_only{dir = 8},/turf/open/floor/plasteel,/area/shuttle/escape)
"iiR" = (/obj/machinery/light_switch,/turf/closed/wall/mineral/wood,/area/shuttle/escape)
"iKz" = (/obj/structure/chair/comfy/teal,/turf/open/floor/carpet,/area/shuttle/escape)
"jeL" = (/obj/effect/decal/cleanable/blood,/obj/effect/decal/cleanable/blood/drip,/obj/effect/decal/cleanable/blood/gibs,/obj/effect/mob_spawn/human/corpse,/obj/item/gun/ballistic/automatic/pistol/m1911,/obj/machinery/light/small{dir = 8},/obj/item/reagent_containers/food/snacks/cakeslice/birthday,/turf/open/floor/carpet,/area/shuttle/escape)
"jjx" = (/obj/structure/mineral_door/wood,/obj/machinery/door/firedoor/border_only{dir = 8},/obj/machinery/door/firedoor/border_only{dir = 4},/turf/open/floor/wood,/area/shuttle/escape)
"jQq" = (/obj/machinery/door/firedoor/border_only,/obj/machinery/door/firedoor/border_only{dir = 8},/turf/open/floor/carpet,/area/shuttle/escape)
"lGp" = (/obj/machinery/light{dir = 8},/turf/open/floor/wood,/area/shuttle/escape)
"lSS" = (/obj/structure/table/reinforced,/obj/item/reagent_containers/food/snacks/store/cake/birthday,/obj/machinery/door/firedoor/border_only{dir = 8},/turf/open/floor/carpet,/area/shuttle/escape)
"mov" = (/obj/machinery/computer/emergency_shuttle{dir = 8},/turf/open/floor/carpet,/area/shuttle/escape)
"mZJ" = (/obj/machinery/door/firedoor/border_only,/turf/open/floor/carpet,/area/shuttle/escape)
"orl" = (/obj/machinery/light{dir = 1},/obj/machinery/door/firedoor/border_only{dir = 8},/turf/open/floor/carpet,/area/shuttle/escape)
"oKI" = (/obj/structure/table/reinforced,/obj/item/kitchen/knife,/obj/machinery/door/firedoor/border_only{dir = 8},/turf/open/floor/carpet,/area/shuttle/escape)
"pAs" = (/obj/docking_port/mobile/emergency{dheight = 0; dir = 4; dwidth = 1; height = 10; name = "Oh Hi Mark"; width = 12},/obj/machinery/door/airlock/wood,/obj/machinery/door/firedoor/border_only{dir = 4},/obj/machinery/door/firedoor/border_only{dir = 8},/turf/open/floor/wood,/area/shuttle/escape)
"pKT" = (/obj/structure/bed,/obj/item/bedsheet/red,/obj/item/paper/fluff/shuttles/daniel,/obj/machinery/portable_atmospherics/canister/air,/turf/open/floor/carpet,/area/shuttle/escape)
"rKB" = (/obj/machinery/light{dir = 4},/obj/machinery/vending/boozeomat{req_access = null},/obj/effect/turf_decal/tile/bar,/obj/effect/turf_decal/tile/bar{dir = 1},/turf/open/floor/plasteel,/area/shuttle/escape)
"sxK" = (/obj/structure/table/wood,/obj/item/papercutter,/obj/machinery/door/firedoor/border_only{dir = 8},/turf/open/floor/wood,/area/shuttle/escape)
"sGW" = (/obj/effect/turf_decal/tile/bar,/obj/effect/turf_decal/tile/bar{dir = 1},/turf/open/floor/plasteel,/area/shuttle/escape)
"sJm" = (/obj/structure/table/wood,/obj/item/flashlight/lamp,/turf/open/floor/carpet,/area/shuttle/escape)
"tuL" = (/obj/machinery/door/firedoor/border_only{dir = 8},/turf/open/floor/wood,/area/shuttle/escape)
"tPG" = (/obj/structure/table/glass,/turf/open/floor/carpet,/area/shuttle/escape)
"ugm" = (/obj/machinery/light,/obj/structure/table/wood,/obj/item/paper_bin,/obj/item/pen,/turf/open/floor/wood,/area/shuttle/escape)
"wci" = (/obj/structure/chair/comfy/teal{dir = 8},/turf/open/floor/carpet,/area/shuttle/escape)
"xNi" = (/obj/machinery/computer/security/wooden_tv,/obj/machinery/door/firedoor/border_only{dir = 8},/turf/open/floor/carpet,/area/shuttle/escape)

(1,1,1) = {"
eHi
pAs
eHi
eHi
eHi
eHi
eHi
eHi
eHi
"}
(2,1,1) = {"
iiR
fSK
fSK
fSK
fSK
lGp
fSK
avI
eHi
"}
(3,1,1) = {"
eHi
orl
xNi
gpD
jQq
tuL
tuL
sxK
eHi
"}
(4,1,1) = {"
eHi
iKz
tPG
tPG
mZJ
fSK
eKv
fDR
eHi
"}
(5,1,1) = {"
eHi
sJm
wci
wci
mZJ
fSK
fSK
ugm
eHi
"}
(6,1,1) = {"
eHi
eMx
eMx
eMx
mZJ
fSK
fSK
fSK
eHi
"}
(7,1,1) = {"
eHi
oKI
lSS
bwK
gXx
eHi
eEW
jjx
eHi
"}
(8,1,1) = {"
eHi
sGW
sGW
sGW
sGW
eHi
jeL
eMx
eHi
"}
(9,1,1) = {"
eHi
rKB
bel
cFX
dAP
eHi
pKT
mov
eHi
"}
(10,1,1) = {"
eHi
eHi
eHi
eHi
eHi
eHi
eHi
eHi
eHi
"}
