//MAP CONVERTED BY dmm2tgm.py THIS HEADER COMMENT PREVENTS RECONVERSION, DO NOT REMOVE
"bX" = (
/obj/structure/table/reinforced,
/obj/item/reagent_containers/food/drinks/soda_cans/space_up,
/turf/open/floor/wood,
/area/shuttle/escape)
"cc" = (
/obj/structure/railing{
	dir = 1
	},
/obj/effect/turf_decal/siding/wood{
	dir = 1
	},
/turf/open/floor/wood,
/area/shuttle/escape)
"ce" = (
/obj/effect/turf_decal/siding/wood{
	dir = 1
	},
/turf/open/floor/wood,
/area/shuttle/escape)
"dJ" = (
/obj/effect/turf_decal/siding/wood,
/turf/open/floor/wood,
/area/shuttle/escape)
"eR" = (
/obj/structure/table,
/obj/item/reagent_containers/food/drinks/shaker,
/obj/item/storage/box/drinkingglasses,
/turf/open/floor/wood,
/area/shuttle/escape)
"fK" = (
/obj/structure/table/reinforced,
/obj/item/reagent_containers/food/drinks/soda_cans/shamblers,
/turf/open/floor/wood,
/area/shuttle/escape)
"fX" = (
/obj/structure/table,
/obj/machinery/chem_dispenser/drinks/beer{
	dir = 1
	},
/turf/open/floor/wood,
/area/shuttle/escape)
"gv" = (
/obj/structure/table/reinforced,
/obj/item/reagent_containers/food/drinks/soda_cans/sol_dry,
/turf/open/floor/wood,
/area/shuttle/escape)
"hx" = (
/obj/structure/table/reinforced,
/obj/item/reagent_containers/food/drinks/soda_cans/cola,
/turf/open/floor/wood,
/area/shuttle/escape)
"hD" = (
/obj/machinery/door/airlock/gold/glass{
	req_access_txt = "19"
	},
/turf/open/floor/wood,
/area/shuttle/escape)
"hF" = (
/turf/closed/wall/mineral/plastitanium/nodiagonal,
/area/shuttle/escape)
"im" = (
/obj/machinery/computer/emergency_shuttle,
/turf/open/floor/wood,
/area/shuttle/escape)
"kg" = (
/obj/structure/table/wood/bar,
/obj/item/storage/bag/tray,
/obj/item/kitchen/knife,
/obj/item/reagent_containers/food/snacks/store/cake/birthday,
/turf/open/floor/wood,
/area/shuttle/escape)
"kN" = (
/obj/structure/table/reinforced,
/obj/item/reagent_containers/food/drinks/soda_cans/sodawater,
/turf/open/floor/wood,
/area/shuttle/escape)
"ln" = (
/obj/machinery/vending/games,
/turf/open/floor/eighties,
/area/shuttle/escape)
"ms" = (
/obj/machinery/computer/arcade/battle,
/turf/open/floor/eighties,
/area/shuttle/escape)
"ns" = (
/obj/structure/table/wood/bar,
/obj/effect/fun_balloon/sentience/emergency_shuttle{
	group_name = "snack bar drone at Uncle Pete's Rollerdome"
	},
/turf/open/floor/wood,
/area/shuttle/escape)
"nw" = (
/obj/structure/table,
/obj/machinery/chem_dispenser/drinks{
	dir = 1
	},
/turf/open/floor/wood,
/area/shuttle/escape)
"nN" = (
/obj/structure/railing{
	dir = 5
	},
/obj/effect/turf_decal/siding/wood{
	dir = 5
	},
/turf/open/floor/wood,
/area/shuttle/escape)
"nT" = (
/obj/machinery/computer/atmos_alert{
	dir = 4
	},
/turf/open/floor/wood,
/area/shuttle/escape)
"od" = (
/obj/structure/shuttle/engine/propulsion,
/turf/open/floor/plating/airless,
/area/shuttle/escape)
"pj" = (
/turf/template_noop,
/area/template_noop)
"pp" = (
/obj/structure/table/reinforced,
/obj/item/reagent_containers/food/drinks/soda_cans/pwr_game,
/turf/open/floor/wood,
/area/shuttle/escape)
"pI" = (
/obj/machinery/light{
	dir = 8
	},
/turf/open/floor/wood,
/area/shuttle/escape)
"qU" = (
/obj/machinery/light{
	dir = 4
	},
/turf/open/floor/wood,
/area/shuttle/escape)
"ss" = (
/obj/docking_port/mobile/emergency{
	name = "Uncle Pete's Rollerdome"
	},
/obj/machinery/door/airlock/gold/glass,
/turf/open/floor/wood,
/area/shuttle/escape)
"tG" = (
/turf/closed/wall/mineral/plastitanium,
/area/shuttle/escape)
"uN" = (
/obj/structure/table/wood/bar,
/obj/item/storage/bag/tray,
/turf/open/floor/wood,
/area/shuttle/escape)
"vq" = (
/obj/structure/railing{
	dir = 9
	},
/obj/effect/turf_decal/siding/wood{
	dir = 9
	},
/turf/open/floor/wood,
/area/shuttle/escape)
"wn" = (
/obj/structure/chair/comfy/brown{
	dir = 1
	},
/turf/open/floor/wood,
/area/shuttle/escape)
"xK" = (
/obj/structure/chair/comfy/brown{
	dir = 4
	},
/turf/open/floor/wood,
/area/shuttle/escape)
"ze" = (
/obj/structure/railing,
/obj/effect/turf_decal/siding/wood,
/turf/open/floor/wood,
/area/shuttle/escape)
"zs" = (
/obj/effect/turf_decal/siding/wood{
	dir = 4
	},
/turf/open/floor/wood,
/area/shuttle/escape)
"zt" = (
/obj/structure/table/wood,
/obj/item/storage/fancy/cigarettes/cigars/havana,
/obj/item/lighter{
	pixel_x = -4;
	pixel_y = 6
	},
/turf/open/floor/wood,
/area/shuttle/escape)
"zx" = (
/obj/effect/spawner/structure/window/reinforced,
/turf/open/floor/wood,
/area/shuttle/escape)
"zZ" = (
/obj/effect/turf_decal/siding/wood{
	dir = 8
	},
/turf/open/floor/wood,
/area/shuttle/escape)
"AT" = (
/obj/structure/etherealball,
/turf/open/floor/light,
/area/shuttle/escape)
"BD" = (
/obj/machinery/computer/arcade/minesweeper,
/turf/open/floor/eighties,
/area/shuttle/escape)
"Cg" = (
/turf/open/floor/eighties,
/area/shuttle/escape)
"Dh" = (
/obj/machinery/vending/snack/random,
/turf/open/floor/wood,
/area/shuttle/escape)
"DR" = (
/obj/structure/railing{
	dir = 6
	},
/obj/effect/turf_decal/siding/wood{
	dir = 6
	},
/turf/open/floor/wood,
/area/shuttle/escape)
"Hf" = (
/obj/structure/table/reinforced,
/obj/item/reagent_containers/food/drinks/soda_cans/space_mountain_wind,
/turf/open/floor/wood,
/area/shuttle/escape)
"Hi" = (
/obj/structure/table/wood,
/obj/item/flashlight/lamp/green,
/turf/open/floor/wood,
/area/shuttle/escape)
"Hx" = (
/obj/structure/table/reinforced,
/obj/item/reagent_containers/food/drinks/soda_cans/sprited_cranberry,
/turf/open/floor/wood,
/area/shuttle/escape)
"HA" = (
/obj/machinery/vending/cola/random,
/turf/open/floor/wood,
/area/shuttle/escape)
"HN" = (
/obj/effect/spawner/structure/window/plasma/reinforced/plastitanium,
/obj/effect/spawner/structure/window/plastitanium,
/turf/open/floor/plasteel/elevatorshaft,
/area/shuttle/escape)
"HS" = (
/turf/open/floor/light,
/area/shuttle/escape)
"Jq" = (
/obj/machinery/computer/security{
	dir = 8
	},
/turf/open/floor/wood,
/area/shuttle/escape)
"Jy" = (
/obj/effect/spawner/structure/window/plastitanium,
/turf/open/floor/plasteel/elevatorshaft,
/area/shuttle/escape)
"JR" = (
/obj/machinery/vending/boozeomat,
/turf/open/floor/wood,
/area/shuttle/escape)
"Ky" = (
/turf/open/floor/wood,
/area/shuttle/escape)
"KJ" = (
/obj/structure/shuttle/engine/heater,
/obj/structure/window/reinforced/spawner/north,
/turf/open/floor/plating/airless,
/area/shuttle/escape)
"Ow" = (
/obj/structure/table,
/obj/item/storage/box/drinkingglasses,
/turf/open/floor/wood,
/area/shuttle/escape)
"Ox" = (
/obj/structure/table/wood/bar,
/obj/item/pizzabox/meat,
/obj/item/pizzabox/meat,
/obj/item/pizzabox/meat,
/obj/item/pizzabox/mushroom,
/obj/item/pizzabox/margherita,
/obj/item/pizzabox/pineapple,
/obj/item/pizzabox/vegetable,
/turf/open/floor/wood,
/area/shuttle/escape)
"OG" = (
/obj/machinery/computer/communications{
	dir = 8
	},
/turf/open/floor/wood,
/area/shuttle/escape)
"ON" = (
/obj/machinery/vending/donksofttoyvendor,
/turf/open/floor/eighties,
/area/shuttle/escape)
"OY" = (
/obj/structure/table/reinforced,
/obj/item/reagent_containers/food/drinks/soda_cans/dr_gibb,
/turf/open/floor/wood,
/area/shuttle/escape)
"Qf" = (
/obj/machinery/computer/crew{
	dir = 4
	},
/turf/open/floor/wood,
/area/shuttle/escape)
"Qv" = (
/mob/living/simple_animal/drone/snowflake/bardrone,
/turf/open/floor/wood,
/area/shuttle/escape)
"QO" = (
/obj/machinery/door/airlock/gold/glass,
/turf/open/floor/wood,
/area/shuttle/escape)
"Ry" = (
/obj/effect/turf_decal/siding/wood,
/obj/structure/railing,
/turf/open/floor/wood,
/area/shuttle/escape)
"RN" = (
/obj/machinery/jukebox/disco/indestructible,
/turf/open/floor/light,
/area/shuttle/escape)
"Su" = (
/obj/structure/table/reinforced,
/obj/item/reagent_containers/food/drinks/soda_cans/lemon_lime,
/turf/open/floor/wood,
/area/shuttle/escape)
"TU" = (
/obj/structure/railing{
	dir = 10
	},
/obj/effect/turf_decal/siding/wood{
	dir = 10
	},
/turf/open/floor/wood,
/area/shuttle/escape)
"Uf" = (
/obj/machinery/computer/arcade/orion_trail,
/turf/open/floor/eighties,
/area/shuttle/escape)
"We" = (
/obj/structure/chair/comfy/brown{
	dir = 8
	},
/turf/open/floor/wood,
/area/shuttle/escape)
"Yr" = (
/obj/structure/table/wood/poker,
/obj/item/storage/box/drinkingglasses,
/obj/item/reagent_containers/food/drinks/bottle/whiskey,
/obj/machinery/light,
/turf/open/floor/wood,
/area/shuttle/escape)
"Zo" = (
/obj/structure/table/wood/bar,
/turf/open/floor/wood,
/area/shuttle/escape)
"ZN" = (
/obj/effect/turf_decal/siding/wood{
	dir = 1
	},
/obj/structure/railing{
	dir = 1
	},
/turf/open/floor/wood,
/area/shuttle/escape)

(1,1,1) = {"
pj
pj
pj
pj
tG
tG
tG
HN
tG
ss
tG
Jy
Jy
Jy
tG
hF
tG
QO
tG
Jy
tG
pj
"}
(2,1,1) = {"
pj
tG
tG
tG
hF
AT
Cg
Cg
Cg
Cg
Cg
Cg
Cg
Cg
Cg
AT
ce
Ky
pI
Ky
tG
tG
"}
(3,1,1) = {"
tG
tG
nT
Qf
zx
ln
Cg
vq
zZ
zZ
zZ
zZ
zZ
TU
Cg
Cg
ce
uN
Ox
kg
KJ
od
"}
(4,1,1) = {"
Jy
Hi
We
We
zx
ms
Cg
cc
Su
Ky
Ky
Ky
kN
ze
Cg
Cg
ce
Zo
Ky
eR
KJ
od
"}
(5,1,1) = {"
Jy
wn
Ky
Ky
zx
BD
Cg
ZN
hx
HS
HS
HS
gv
Ry
Cg
Cg
ce
uN
Ky
fX
KJ
od
"}
(6,1,1) = {"
Jy
im
Ky
Yr
zx
Uf
Cg
ce
OY
HS
RN
HS
Hf
dJ
Cg
Cg
ce
ns
Qv
JR
KJ
od
"}
(7,1,1) = {"
Jy
wn
Ky
Ky
hD
Cg
Cg
ZN
pp
HS
HS
HS
bX
Ry
Cg
Cg
ce
Zo
Ky
nw
KJ
od
"}
(8,1,1) = {"
Jy
zt
xK
xK
zx
ON
Cg
cc
fK
Ky
Ky
Ky
Hx
ze
Cg
Cg
ce
uN
Ky
Ow
KJ
od
"}
(9,1,1) = {"
tG
tG
Jq
OG
zx
ln
Cg
nN
zs
zs
zs
zs
zs
DR
Cg
Cg
ce
Zo
Dh
HA
KJ
od
"}
(10,1,1) = {"
pj
tG
tG
tG
hF
AT
Cg
Cg
Cg
Cg
Cg
Cg
Cg
Cg
Cg
AT
ce
Ky
qU
Ky
tG
tG
"}
(11,1,1) = {"
pj
pj
pj
pj
tG
tG
tG
Jy
tG
tG
tG
Jy
Jy
Jy
tG
tG
tG
Jy
tG
Jy
tG
pj
"}
