// This map has been converted using maphash
"aea" = (/obj/item/radio/intercom{name = "Station Intercom (General)"; pixel_y = -29},/turf/open/floor/plasteel/cult,/area/shuttle/escape)
"ars" = (/obj/structure/chair/comfy/shuttle{dir = 8},/obj/structure/extinguisher_cabinet{pixel_y = -30},/turf/open/floor/plasteel/cult,/area/shuttle/escape)
"arG" = (/turf/template_noop,/area/template_noop)
"aCp" = (/obj/effect/forcefield/cult,/turf/open/floor/plating,/area/shuttle/escape)
"eXK" = (/obj/structure/extinguisher_cabinet{pixel_x = 27},/obj/machinery/portable_atmospherics/canister/air,/turf/open/floor/plasteel/cult,/area/shuttle/escape)
"fao" = (/mob/living/simple_animal/hostile/construct/armored,/turf/open/floor/plasteel/cult,/area/shuttle/escape)
"gaJ" = (/obj/structure/table,/obj/item/storage/firstaid/regular{pixel_x = 2; pixel_y = 3},/obj/item/crowbar,/turf/open/floor/plasteel/cult,/area/shuttle/escape)
"gci" = (/obj/effect/decal/cleanable/blood/gibs/down,/turf/open/floor/plasteel/cult,/area/shuttle/escape)
"gcD" = (/mob/living/simple_animal/hostile/carp/eyeball{faction = list("cult"); name = "left eyeball"},/turf/open/floor/plasteel/cult,/area/shuttle/escape)
"guG" = (/obj/item/storage/firstaid/fire,/obj/item/storage/firstaid/regular{pixel_x = 2; pixel_y = 3},/obj/item/crowbar,/obj/structure/extinguisher_cabinet{pixel_x = 27},/obj/item/stack/sheet/metal,/turf/open/floor/plasteel/cult,/area/shuttle/escape)
"gUT" = (/obj/machinery/computer/crew{dir = 4},/turf/open/floor/plasteel/cult,/area/shuttle/escape)
"hgM" = (/obj/effect/rune/convert,/obj/effect/decal/remains/human,/turf/open/floor/plasteel/cult,/area/shuttle/escape)
"hDy" = (/obj/effect/decal/cleanable/blood/drip,/turf/open/floor/plasteel/cult,/area/shuttle/escape)
"igV" = (/obj/structure/chair/comfy/shuttle{dir = 1},/turf/open/floor/plasteel/cult,/area/shuttle/escape)
"ihI" = (/obj/machinery/computer/atmos_alert{dir = 4},/turf/open/floor/plasteel/cult,/area/shuttle/escape)
"jFd" = (/obj/structure/showcase/horrific_experiment,/turf/open/floor/plasteel/cult,/area/shuttle/escape)
"jVz" = (/obj/structure/table,/obj/item/storage/firstaid/fire,/obj/item/storage/firstaid/regular{pixel_x = 2; pixel_y = 3},/obj/item/crowbar,/turf/open/floor/plasteel/cult,/area/shuttle/escape)
"kDG" = (/turf/open/floor/plasteel/cult,/area/shuttle/escape)
"kJe" = (/obj/effect/rune/convert,/obj/effect/decal/remains/human,/obj/effect/decal/cleanable/blood/gibs/body,/obj/effect/decal/cleanable/blood/gibs/core,/turf/open/floor/plasteel/cult,/area/shuttle/escape)
"ljN" = (/obj/machinery/status_display/evac,/turf/closed/wall/mineral/cult,/area/shuttle/escape)
"lll" = (/mob/living/simple_animal/hostile/construct/builder,/turf/open/floor/plasteel/cult,/area/shuttle/escape)
"lmX" = (/obj/machinery/door/airlock/cult/friendly,/obj/machinery/door/firedoor/border_only{dir = 4},/obj/machinery/door/firedoor/border_only{dir = 8},/turf/open/floor/plating,/area/shuttle/escape)
"loR" = (/obj/effect/decal/cleanable/blood,/turf/open/floor/plasteel/cult,/area/shuttle/escape)
"lyl" = (/obj/effect/forcefield/cult,/obj/machinery/door/firedoor/border_only{dir = 4},/turf/open/floor/plating,/area/shuttle/escape)
"lLN" = (/obj/structure/closet/emcloset,/turf/open/floor/plasteel/cult,/area/shuttle/escape)
"mpk" = (/obj/item/stack/sheet/metal,/obj/effect/decal/remains/human,/turf/open/floor/plasteel/cult,/area/shuttle/escape)
"msX" = (/obj/structure/chair/comfy/shuttle{dir = 8},/turf/open/floor/plasteel/cult,/area/shuttle/escape)
"mNA" = (/obj/structure/extinguisher_cabinet{pixel_x = 27},/obj/item/extinguisher{safety = 0},/turf/open/floor/plasteel/cult,/area/shuttle/escape)
"mNO" = (/obj/machinery/door/airlock/cult/glass/friendly,/obj/machinery/door/firedoor/border_only{dir = 1},/obj/machinery/door/firedoor/border_only,/obj/machinery/door/firedoor/border_only{dir = 8},/turf/open/floor/plasteel/cult,/area/shuttle/escape)
"mRd" = (/mob/living/simple_animal/hostile/construct/wraith,/turf/open/floor/plasteel/cult,/area/shuttle/escape)
"ojW" = (/obj/effect/decal/cleanable/blood/gibs/up,/obj/item/candle/infinite,/turf/open/floor/plasteel/cult,/area/shuttle/escape)
"pgx" = (/obj/structure/table/wood,/obj/item/tome,/turf/open/floor/plasteel/cult,/area/shuttle/escape)
"pik" = (/turf/closed/wall/mineral/cult,/area/shuttle/escape)
"pUM" = (/obj/machinery/door/airlock/cult/unruned/glass/friendly,/obj/machinery/door/firedoor/border_only{dir = 1},/obj/machinery/door/firedoor/border_only,/obj/machinery/door/firedoor/border_only{dir = 4},/obj/machinery/door/firedoor/border_only{dir = 8},/turf/open/floor/plasteel/cult,/area/shuttle/escape)
"pVi" = (/mob/living/simple_animal/hostile/carp/eyeball{faction = list("cult"); name = "right eyeball"},/turf/open/floor/plasteel/cult,/area/shuttle/escape)
"pVw" = (/obj/structure/table,/obj/item/storage/firstaid/fire,/turf/open/floor/plasteel/cult,/area/shuttle/escape)
"qno" = (/obj/structure/extinguisher_cabinet{pixel_x = 27},/turf/open/floor/plasteel/cult,/area/shuttle/escape)
"qMA" = (/obj/machinery/door/airlock/cult/unruned/glass/friendly,/obj/machinery/door/firedoor/border_only{dir = 1},/obj/machinery/door/firedoor/border_only,/turf/open/floor/plasteel/cult,/area/shuttle/escape)
"rqf" = (/obj/item/candle/infinite,/turf/open/floor/plasteel/cult,/area/shuttle/escape)
"rMn" = (/obj/structure/window/reinforced{dir = 1},/obj/structure/shuttle/engine/heater,/turf/open/floor/plating/airless,/area/shuttle/escape)
"rMM" = (/obj/machinery/door/airlock/cult/friendly,/obj/docking_port/mobile/emergency{name = "shuttle 667"},/obj/machinery/door/firedoor/border_only{dir = 4},/obj/machinery/door/firedoor/border_only{dir = 8},/turf/open/floor/plating,/area/shuttle/escape)
"tAP" = (/obj/effect/rune/raise_dead,/turf/open/floor/plasteel/cult,/area/shuttle/escape)
"tMM" = (/obj/structure/bed,/obj/item/bedsheet/cult,/turf/open/floor/plasteel/cult,/area/shuttle/escape)
"ufU" = (/obj/machinery/computer/emergency_shuttle,/turf/open/floor/plasteel/cult,/area/shuttle/escape)
"uut" = (/obj/machinery/portable_atmospherics/canister/air,/turf/open/floor/plasteel/cult,/area/shuttle/escape)
"uBD" = (/obj/structure/dresser,/turf/open/floor/plasteel/cult,/area/shuttle/escape)
"uKH" = (/obj/item/stack/sheet/metal,/turf/open/floor/plasteel/cult,/area/shuttle/escape)
"uVH" = (/obj/structure/chair/comfy/shuttle{dir = 4},/turf/open/floor/plasteel/cult,/area/shuttle/escape)
"vdP" = (/obj/machinery/computer/communications{dir = 8},/turf/open/floor/plasteel/cult,/area/shuttle/escape)
"vOG" = (/obj/structure/shuttle/engine/propulsion,/turf/open/floor/plating/airless,/area/shuttle/escape)
"wde" = (/obj/effect/rune/narsie,/obj/effect/fun_balloon/sentience/emergency_shuttle{effect_range = 5; group_name = "horrible monsters on Shuttle 667"},/turf/open/floor/plasteel/cult,/area/shuttle/escape)
"wlW" = (/obj/machinery/computer/security{dir = 8},/turf/open/floor/plasteel/cult,/area/shuttle/escape)
"xmP" = (/obj/effect/forcefield/cult,/obj/machinery/door/firedoor/border_only{dir = 8},/turf/open/floor/plating,/area/shuttle/escape)
"xVa" = (/obj/effect/forcefield/cult,/obj/machinery/door/firedoor/border_only{dir = 1},/turf/open/floor/plating,/area/shuttle/escape)

(1,1,1) = {"
arG
arG
arG
arG
pik
pik
pik
lmX
pik
rMM
pik
xmP
xmP
xmP
pik
lmX
pik
lmX
pik
pik
pik
arG
"}
(2,1,1) = {"
arG
pik
pik
pik
pik
kDG
kDG
kDG
kDG
kDG
kDG
kDG
kDG
kDG
kDG
kDG
pik
kDG
kDG
uKH
pik
pik
"}
(3,1,1) = {"
pik
pik
ihI
gUT
pik
kDG
loR
kDG
rqf
kDG
tAP
kDG
rqf
kDG
kDG
loR
mpk
kDG
kDG
uKH
rMn
vOG
"}
(4,1,1) = {"
xVa
pVw
msX
ars
pik
kDG
kDG
ojW
kJe
gci
mRd
kDG
hgM
rqf
kDG
kDG
mNO
kDG
kDG
pgx
rMn
vOG
"}
(5,1,1) = {"
xVa
igV
kDG
aea
pik
kDG
lll
kDG
kDG
kDG
kDG
kDG
kDG
kDG
gcD
hDy
pik
uBD
eXK
tMM
rMn
vOG
"}
(6,1,1) = {"
xVa
ufU
kDG
kDG
mpk
kDG
kDG
tAP
fao
kDG
wde
kDG
fao
tAP
kDG
kDG
ljN
pik
pik
pik
rMn
vOG
"}
(7,1,1) = {"
xVa
igV
kDG
kDG
qMA
kDG
lll
kDG
kDG
kDG
kDG
kDG
kDG
kDG
pVi
hDy
aCp
lLN
uut
lLN
rMn
vOG
"}
(8,1,1) = {"
xVa
gaJ
uVH
uVH
ljN
kDG
kDG
rqf
hgM
kDG
mRd
kDG
hgM
rqf
loR
kDG
pUM
hDy
kDG
kDG
rMn
vOG
"}
(9,1,1) = {"
pik
pik
wlW
vdP
pik
lLN
kDG
loR
rqf
kDG
tAP
kDG
rqf
kDG
kDG
kDG
aCp
kDG
kDG
kDG
rMn
vOG
"}
(10,1,1) = {"
arG
pik
pik
pik
pik
jVz
kDG
kDG
kDG
mNA
kDG
kDG
kDG
kDG
kDG
qno
aCp
jFd
guG
jFd
pik
pik
"}
(11,1,1) = {"
arG
arG
arG
arG
pik
lyl
pik
lyl
pik
pik
pik
lyl
lyl
lyl
pik
pik
pik
lyl
pik
lyl
pik
arG
"}
