// This map has been converted using maphash
"aoU" = (/turf/open/floor/plating,/area/shuttle/escape)
"bwg" = (/obj/structure/window/reinforced,/obj/structure/table/reinforced,/obj/item/storage/firstaid/regular,/obj/item/book/manual/random,/obj/structure/extinguisher_cabinet{pixel_x = -30},/turf/open/floor/plasteel/dark,/area/shuttle/escape)
"bZv" = (/obj/structure/closet/crate,/obj/effect/spawner/lootdrop/maintenance{lootcount = 8; name = "8maintenance loot spawner"},/obj/effect/turf_decal/bot,/turf/open/floor/plasteel,/area/shuttle/escape)
"cSF" = (/turf/closed/wall/mineral/titanium,/area/shuttle/escape)
"dUQ" = (/obj/structure/chair/comfy/shuttle{dir = 1},/turf/open/floor/plasteel/dark,/area/shuttle/escape)
"dUV" = (/obj/machinery/door/window/southleft,/turf/open/floor/plasteel/dark,/area/shuttle/escape)
"dWN" = (/obj/effect/spawner/structure/window/shuttle,/obj/machinery/door/firedoor/border_only{dir = 4},/turf/open/floor/plating,/area/shuttle/escape)
"ezT" = (/obj/structure/closet/crate/secure/weapon,/obj/effect/spawner/lootdrop/armory_contraband,/obj/effect/turf_decal/bot,/obj/machinery/light{dir = 4},/turf/open/floor/plasteel,/area/shuttle/escape)
"eBC" = (/obj/structure/chair/comfy/shuttle{dir = 4},/turf/open/floor/plating,/area/shuttle/escape)
"iuP" = (/obj/structure/chair/comfy/shuttle{dir = 4},/obj/machinery/door/firedoor/border_only,/turf/open/floor/plating,/area/shuttle/escape)
"iTc" = (/obj/structure/closet/crate/secure/weapon,/obj/effect/spawner/lootdrop/armory_contraband,/obj/effect/turf_decal/bot,/turf/open/floor/plasteel,/area/shuttle/escape)
"iVk" = (/obj/structure/closet/crate,/obj/effect/spawner/lootdrop/maintenance{lootcount = 8; name = "8maintenance loot spawner"},/obj/effect/turf_decal/bot,/obj/machinery/door/firedoor/border_only{dir = 1},/turf/open/floor/plasteel,/area/shuttle/escape)
"jal" = (/obj/structure/closet/emcloset,/obj/machinery/light{dir = 4},/turf/open/floor/plating,/area/shuttle/escape)
"kfP" = (/obj/machinery/door/firedoor/border_only,/turf/open/floor/plating,/area/shuttle/escape)
"kJj" = (/obj/structure/table/reinforced,/obj/structure/window/reinforced,/obj/item/gps{gpstag = "STV5"},/turf/open/floor/plasteel/dark,/area/shuttle/escape)
"kLD" = (/obj/machinery/status_display/evac,/turf/closed/wall/mineral/titanium,/area/shuttle/escape)
"lsa" = (/obj/structure/closet/crate/secure/loot,/obj/effect/turf_decal/bot,/turf/open/floor/plasteel,/area/shuttle/escape)
"mgV" = (/obj/machinery/door/airlock/titanium{name = "Emergency Shuttle Airlock"},/obj/machinery/door/firedoor/border_only{dir = 4},/obj/machinery/door/firedoor/border_only{dir = 8},/turf/open/floor/plating,/area/shuttle/escape)
"nmY" = (/obj/effect/spawner/structure/window/shuttle,/obj/machinery/door/firedoor/border_only{dir = 8},/turf/open/floor/plating,/area/shuttle/escape)
"peP" = (/obj/machinery/door/firedoor/border_only{dir = 1},/turf/open/floor/plating,/area/shuttle/escape)
"pBa" = (/obj/machinery/door/airlock/titanium{name = "Emergency Shuttle Airlock"},/obj/docking_port/mobile/emergency{dwidth = 3; height = 5; name = "Secure Transport Vessel 5"; width = 14},/obj/machinery/door/firedoor/border_only{dir = 4},/obj/machinery/door/firedoor/border_only{dir = 8},/turf/open/floor/plating,/area/shuttle/escape)
"pYD" = (/obj/structure/closet/emcloset,/turf/open/floor/plating,/area/shuttle/escape)
"rFE" = (/obj/effect/turf_decal/bot,/obj/machinery/portable_atmospherics/canister/air,/turf/open/floor/plasteel,/area/shuttle/escape)
"rMn" = (/obj/structure/window/reinforced{dir = 1},/obj/structure/shuttle/engine/heater,/turf/open/floor/plating/airless,/area/shuttle/escape)
"uIe" = (/obj/structure/chair/comfy/shuttle{dir = 4},/obj/structure/extinguisher_cabinet{pixel_x = -30},/turf/open/floor/plating,/area/shuttle/escape)
"uWq" = (/turf/open/floor/plasteel/dark,/area/shuttle/escape)
"vOG" = (/obj/structure/shuttle/engine/propulsion,/turf/open/floor/plating/airless,/area/shuttle/escape)
"xjU" = (/obj/machinery/computer/emergency_shuttle{dir = 8},/turf/open/floor/plasteel/dark,/area/shuttle/escape)
"xsx" = (/obj/effect/spawner/structure/window/shuttle,/obj/machinery/door/firedoor/border_only{dir = 1},/turf/open/floor/plating,/area/shuttle/escape)
"xyx" = (/obj/structure/closet/crate/secure/loot,/obj/effect/turf_decal/bot,/obj/machinery/door/firedoor/border_only,/turf/open/floor/plasteel,/area/shuttle/escape)
"xMi" = (/obj/machinery/door/airlock/titanium{name = "Emergency Shuttle Airlock"; req_access_txt = "2"},/obj/machinery/door/firedoor/border_only{dir = 4},/obj/machinery/door/firedoor/border_only{dir = 8},/turf/open/floor/plating,/area/shuttle/escape)
"yhb" = (/obj/structure/chair/comfy/shuttle{dir = 4},/obj/machinery/door/firedoor/border_only{dir = 1},/turf/open/floor/plating,/area/shuttle/escape)

(1,1,1) = {"
cSF
xMi
cSF
pBa
cSF
nmY
nmY
nmY
cSF
mgV
cSF
mgV
cSF
cSF
"}
(2,1,1) = {"
xsx
uWq
bwg
aoU
yhb
eBC
eBC
eBC
iuP
aoU
uIe
aoU
rMn
vOG
"}
(3,1,1) = {"
xsx
dUQ
dUV
aoU
peP
aoU
aoU
aoU
kfP
aoU
aoU
aoU
rMn
vOG
"}
(4,1,1) = {"
xsx
xjU
kJj
jal
iVk
bZv
rFE
lsa
xyx
ezT
iTc
pYD
rMn
vOG
"}
(5,1,1) = {"
cSF
cSF
kLD
cSF
cSF
dWN
dWN
dWN
cSF
cSF
cSF
cSF
cSF
cSF
"}
