//MAP CONVERTED BY dmm2tgm.py THIS HEADER COMMENT PREVENTS RECONVERSION, DO NOT REMOVE
"aa" = (
/turf/template_noop,
/area/template_noop)
"ab" = (
/turf/closed/wall/mineral/titanium,
/area/shuttle/escape)
"ac" = (
/obj/effect/spawner/structure/window/shuttle,
/turf/open/floor/plating,
/area/shuttle/escape)
"ad" = (
/turf/closed/wall/mineral/titanium/interior,
/area/shuttle/escape)
"ae" = (
/obj/structure/table,
/obj/item/storage/firstaid/fire,
/turf/open/floor/mineral/bananium,
/area/shuttle/escape)
"af" = (
/obj/structure/chair/comfy/shuttle{
	dir = 1
	},
/turf/open/floor/bluespace,
/area/shuttle/escape)
"ag" = (
/obj/machinery/computer/emergency_shuttle,
/turf/open/floor/bluespace,
/area/shuttle/escape)
"ah" = (
/obj/structure/table,
/obj/item/storage/firstaid/regular{
	pixel_x = 2;
	pixel_y = 3
	},
/obj/item/crowbar,
/turf/open/floor/mineral/bananium,
/area/shuttle/escape)
"ai" = (
/obj/machinery/computer/atmos_alert{
	dir = 4
	},
/turf/open/floor/mineral/bananium,
/area/shuttle/escape)
"aj" = (
/obj/structure/chair/comfy/shuttle{
	dir = 8
	},
/turf/open/floor/bluespace,
/area/shuttle/escape)
"ak" = (
/obj/item/toy/snappop/phoenix,
/turf/open/floor/bluespace,
/area/shuttle/escape)
"al" = (
/obj/structure/chair/comfy/shuttle{
	dir = 4
	},
/turf/open/floor/bluespace,
/area/shuttle/escape)
"am" = (
/obj/machinery/computer/security{
	dir = 8
	},
/turf/open/floor/mineral/bananium,
/area/shuttle/escape)
"an" = (
/obj/machinery/computer/crew{
	dir = 4
	},
/turf/open/floor/mineral/bananium,
/area/shuttle/escape)
"ao" = (
/obj/structure/chair/comfy/shuttle{
	dir = 8
	},
/obj/structure/extinguisher_cabinet{
	pixel_y = -30
	},
/turf/open/floor/bluespace,
/area/shuttle/escape)
"ap" = (
/obj/item/radio/intercom{
	name = "Station Intercom (General)";
	pixel_y = -29
	},
/obj/item/toy/snappop/phoenix,
/turf/open/floor/bluespace,
/area/shuttle/escape)
"aq" = (
/obj/item/toy/snappop/phoenix,
/obj/machinery/light,
/turf/open/floor/bluespace,
/area/shuttle/escape)
"ar" = (
/obj/machinery/computer/communications{
	dir = 8
	},
/turf/open/floor/mineral/bananium,
/area/shuttle/escape)
"as" = (
/obj/machinery/door/airlock/bananium/glass{
	name = "Emergency Shuttle Premium Lounge"
	},
/obj/machinery/door/firedoor/border_only{
	dir = 1
	},
/obj/machinery/door/firedoor/border_only,
/turf/open/floor/bluespace,
/area/shuttle/escape)
"at" = (
/obj/machinery/status_display/evac,
/turf/closed/wall/mineral/titanium,
/area/shuttle/escape)
"av" = (
/obj/machinery/light{
	dir = 1
	},
/obj/machinery/flasher{
	id = "cockpit_flasher";
	pixel_x = 6;
	pixel_y = 24
	},
/turf/open/floor/mineral/bananium,
/area/shuttle/escape)
"aw" = (
/obj/structure/extinguisher_cabinet{
	pixel_y = 30
	},
/obj/item/toy/snappop/phoenix,
/turf/open/floor/bluespace,
/area/shuttle/escape)
"ay" = (
/obj/structure/table,
/obj/item/storage/firstaid/fire,
/obj/item/storage/firstaid/regular{
	pixel_x = 2;
	pixel_y = 3
	},
/obj/item/crowbar,
/turf/open/floor/mineral/bananium,
/area/shuttle/escape)
"az" = (
/obj/structure/chair/americandiner/black{
	desc = "If you're sitting here, you should be contemplating your life choices.";
	name = "the time-out chair"
	},
/turf/open/floor/mineral/plastitanium/red/brig,
/area/shuttle/escape)
"aA" = (
/obj/machinery/door/airlock/bananium/glass{
	name = "Emergency Shuttle Brig";
	req_access_txt = "2"
	},
/obj/machinery/door/firedoor/border_only{
	dir = 4
	},
/obj/machinery/door/firedoor/border_only{
	dir = 8
	},
/turf/open/floor/bluespace,
/area/shuttle/escape)
"aB" = (
/obj/item/toy/snappop/phoenix,
/obj/machinery/door/firedoor/border_only,
/turf/open/floor/bluespace,
/area/shuttle/escape)
"aC" = (
/obj/structure/chair/comfy/shuttle,
/turf/open/floor/mineral/bananium,
/area/shuttle/escape)
"aD" = (
/obj/structure/chair/comfy/shuttle{
	dir = 4
	},
/turf/open/floor/mineral/bananium,
/area/shuttle/escape)
"aE" = (
/obj/structure/table,
/obj/item/multitool/ai_detect,
/obj/machinery/door/firedoor/border_only{
	dir = 4
	},
/turf/open/floor/mineral/bananium,
/area/shuttle/escape)
"aF" = (
/obj/machinery/vending/wallmed{
	name = "Emergency NanoMed";
	use_power = 0
	},
/turf/closed/wall/mineral/titanium/nodiagonal,
/area/shuttle/escape)
"aG" = (
/obj/structure/table,
/obj/item/toy/sword,
/obj/machinery/light{
	dir = 8
	},
/obj/machinery/door/firedoor/border_only,
/turf/open/floor/mineral/bananium,
/area/shuttle/escape)
"aH" = (
/obj/structure/table,
/obj/item/toy/sword,
/obj/machinery/door/firedoor/border_only,
/turf/open/floor/mineral/bananium,
/area/shuttle/escape)
"aI" = (
/obj/machinery/door/airlock/bananium{
	name = "Emergency Shuttle Airlock"
	},
/obj/docking_port/mobile/emergency{
	name = "Snappop(tm)!"
	},
/obj/machinery/door/firedoor/border_only{
	dir = 4
	},
/obj/machinery/door/firedoor/border_only{
	dir = 8
	},
/turf/open/floor/plating,
/area/shuttle/escape)
"aJ" = (
/obj/item/toy/snappop/phoenix,
/obj/machinery/light/small{
	dir = 1
	},
/turf/open/floor/bluespace,
/area/shuttle/escape)
"aL" = (
/obj/structure/extinguisher_cabinet{
	pixel_x = 27
	},
/obj/item/toy/snappop/phoenix,
/obj/machinery/light/small{
	dir = 4
	},
/turf/open/floor/bluespace,
/area/shuttle/escape)
"aM" = (
/obj/structure/bed,
/obj/item/bedsheet/random,
/turf/open/floor/mineral/bananium,
/area/shuttle/escape)
"aN" = (
/obj/structure/window/reinforced{
	dir = 4
	},
/obj/structure/bed,
/obj/item/bedsheet/random,
/turf/open/floor/mineral/bananium,
/area/shuttle/escape)
"aO" = (
/obj/structure/window/reinforced{
	dir = 8
	},
/obj/structure/bed,
/obj/item/bedsheet/random,
/turf/open/floor/mineral/bananium,
/area/shuttle/escape)
"aP" = (
/obj/structure/bed,
/obj/item/bedsheet/random,
/obj/structure/window/reinforced{
	dir = 8
	},
/obj/machinery/door/firedoor/border_only{
	dir = 1
	},
/turf/open/floor/mineral/bananium,
/area/shuttle/escape)
"aQ" = (
/obj/machinery/door/airlock/bananium{
	name = "Emergency Shuttle Airlock"
	},
/obj/machinery/door/firedoor/border_only{
	dir = 4
	},
/obj/machinery/door/firedoor/border_only{
	dir = 8
	},
/turf/open/floor/plating,
/area/shuttle/escape)
"aR" = (
/obj/item/toy/snappop/phoenix,
/obj/machinery/light/small,
/turf/open/floor/bluespace,
/area/shuttle/escape)
"aS" = (
/obj/structure/extinguisher_cabinet{
	pixel_y = -30
	},
/obj/item/toy/snappop/phoenix,
/turf/open/floor/bluespace,
/area/shuttle/escape)
"aT" = (
/obj/machinery/door/airlock/bananium{
	name = "Emergency Shuttle Cargo"
	},
/obj/machinery/door/firedoor/border_only{
	dir = 1
	},
/obj/machinery/door/firedoor/border_only,
/turf/open/floor/bluespace,
/area/shuttle/escape)
"aU" = (
/obj/machinery/door/airlock/bananium/glass{
	name = "Emergency Shuttle Infirmary"
	},
/obj/machinery/door/firedoor/border_only{
	dir = 1
	},
/obj/machinery/door/firedoor/border_only,
/turf/open/floor/bluespace,
/area/shuttle/escape)
"aV" = (
/turf/open/floor/mineral/bananium,
/area/shuttle/escape)
"aW" = (
/obj/structure/extinguisher_cabinet{
	pixel_x = 27
	},
/obj/machinery/portable_atmospherics/canister/air,
/turf/open/floor/mineral/bananium,
/area/shuttle/escape)
"aY" = (
/obj/machinery/light/small{
	brightness = 3;
	dir = 8
	},
/turf/open/floor/mineral/bananium,
/area/shuttle/escape)
"aZ" = (
/obj/machinery/light/small{
	dir = 4
	},
/obj/machinery/door/firedoor/border_only,
/turf/open/floor/mineral/bananium,
/area/shuttle/escape)
"bb" = (
/obj/structure/table,
/obj/item/storage/firstaid/fire,
/obj/item/storage/firstaid/regular{
	pixel_x = 2;
	pixel_y = 3
	},
/obj/item/crowbar,
/obj/structure/extinguisher_cabinet{
	pixel_x = 27
	},
/obj/machinery/light/small{
	dir = 4
	},
/turf/open/floor/mineral/bananium,
/area/shuttle/escape)
"bc" = (
/obj/structure/closet/crate/trashcart{
	desc = "A heavy, metal trashcart with wheels. Feel free to hop in at any time!"
	},
/obj/item/toy/sword,
/turf/open/floor/mineral/bananium,
/area/shuttle/escape)
"bd" = (
/obj/machinery/vending/autodrobe{
	extended_inventory = 1;
	scan_id = 0
	},
/turf/open/floor/mineral/bananium,
/area/shuttle/escape)
"be" = (
/obj/machinery/vending/clothing{
	extended_inventory = 1
	},
/turf/open/floor/mineral/bananium,
/area/shuttle/escape)
"bf" = (
/obj/structure/window/reinforced{
	dir = 1
	},
/obj/structure/shuttle/engine/heater,
/turf/open/floor/plating/airless,
/area/shuttle/escape)
"bg" = (
/obj/structure/shuttle/engine/propulsion,
/turf/open/floor/plating/airless,
/area/shuttle/escape)
"cx" = (
/obj/machinery/door/firedoor/border_only{
	dir = 4
	},
/turf/open/floor/mineral/bananium,
/area/shuttle/escape)
"dh" = (
/obj/item/toy/snappop/phoenix,
/obj/machinery/door/firedoor/border_only{
	dir = 8
	},
/turf/open/floor/bluespace,
/area/shuttle/escape)
"dp" = (
/obj/structure/bed,
/obj/item/bedsheet/random,
/obj/machinery/door/firedoor/border_only{
	dir = 1
	},
/turf/open/floor/mineral/bananium,
/area/shuttle/escape)
"he" = (
/obj/structure/bed,
/obj/item/bedsheet/random,
/obj/machinery/door/firedoor/border_only,
/turf/open/floor/mineral/bananium,
/area/shuttle/escape)
"hx" = (
/obj/item/toy/snappop/phoenix,
/obj/machinery/light,
/obj/machinery/button/flasher{
	id = "cockpit_flasher";
	pixel_x = 6;
	pixel_y = -24
	},
/turf/open/floor/bluespace,
/area/shuttle/escape)
"ib" = (
/obj/effect/spawner/structure/window/shuttle,
/obj/machinery/door/firedoor/border_only{
	dir = 8
	},
/turf/open/floor/plating,
/area/shuttle/escape)
"jn" = (
/turf/open/floor/mineral/plastitanium/red/brig/fakepit,
/area/shuttle/escape)
"kl" = (
/obj/item/toy/snappop/phoenix,
/obj/machinery/door/firedoor/border_only{
	dir = 4
	},
/turf/open/floor/bluespace,
/area/shuttle/escape)
"oE" = (
/obj/structure/window/reinforced{
	dir = 8
	},
/obj/structure/bed,
/obj/item/bedsheet/random,
/obj/machinery/door/firedoor/border_only{
	dir = 1
	},
/turf/open/floor/mineral/bananium,
/area/shuttle/escape)
"rJ" = (
/obj/structure/table,
/obj/item/toy/sword,
/obj/machinery/door/firedoor/border_only,
/obj/machinery/door/firedoor/border_only{
	dir = 4
	},
/turf/open/floor/mineral/bananium,
/area/shuttle/escape)
"tc" = (
/obj/effect/spawner/structure/window/shuttle,
/obj/machinery/door/firedoor/border_only{
	dir = 1
	},
/turf/open/floor/plating,
/area/shuttle/escape)
"tr" = (
/obj/machinery/flasher{
	id = "shuttle_flasher";
	pixel_x = -24;
	pixel_y = 6
	},
/obj/machinery/button/flasher{
	id = "shuttle_flasher";
	pixel_x = -24;
	pixel_y = -6
	},
/obj/machinery/light/small{
	brightness = 3;
	dir = 8
	},
/turf/open/floor/mineral/plastitanium/red/brig/fakepit,
/area/shuttle/escape)
"Bq" = (
/obj/item/toy/snappop/phoenix,
/obj/machinery/door/firedoor/border_only{
	dir = 1
	},
/turf/open/floor/bluespace,
/area/shuttle/escape)
"Dc" = (
/obj/structure/window/reinforced{
	dir = 4
	},
/obj/structure/bed,
/obj/item/bedsheet/random,
/obj/machinery/door/firedoor/border_only,
/turf/open/floor/mineral/bananium,
/area/shuttle/escape)
"Gc" = (
/obj/effect/spawner/structure/window/shuttle,
/obj/machinery/door/firedoor/border_only{
	dir = 4
	},
/turf/open/floor/plating,
/area/shuttle/escape)
"IP" = (
/obj/machinery/door/airlock/bananium/glass{
	name = "Emergency Shuttle Brig";
	req_access_txt = "2"
	},
/obj/machinery/door/firedoor/border_only{
	dir = 8
	},
/obj/machinery/door/firedoor/border_only{
	dir = 4
	},
/turf/open/floor/plating,
/area/shuttle/escape)
"Jj" = (
/obj/structure/window/reinforced{
	dir = 8
	},
/obj/structure/bed,
/obj/item/bedsheet/random,
/obj/machinery/door/firedoor/border_only,
/turf/open/floor/mineral/bananium,
/area/shuttle/escape)
"LP" = (
/obj/machinery/light/small{
	dir = 4
	},
/obj/machinery/portable_atmospherics/canister/air,
/turf/open/floor/mineral/bananium,
/area/shuttle/escape)
"WL" = (
/obj/machinery/stasis{
	dir = 8
	},
/turf/open/floor/mineral/bananium,
/area/shuttle/escape)
"XS" = (
/obj/structure/window/reinforced{
	dir = 4
	},
/obj/structure/bed,
/obj/item/bedsheet/random,
/obj/machinery/door/firedoor/border_only{
	dir = 1
	},
/turf/open/floor/mineral/bananium,
/area/shuttle/escape)
"Zf" = (
/obj/structure/closet/emcloset,
/obj/item/toy/sword,
/turf/open/floor/mineral/bananium,
/area/shuttle/escape)

(1,1,1) = {"
aa
aa
aa
aa
ab
ab
ab
IP
ab
aI
ab
ib
ib
ib
ab
aQ
ab
aQ
ab
ab
ab
aa
"}
(2,1,1) = {"
aa
ab
ab
ab
ab
jn
tr
jn
ab
aJ
dp
aM
aM
aM
he
aR
ab
aV
aY
bc
ab
ab
"}
(3,1,1) = {"
ab
ad
ai
an
ab
jn
az
jn
ab
aw
Bq
ak
ak
ak
aB
aS
ab
aV
aV
bc
bf
bg
"}
(4,1,1) = {"
tc
ae
aj
ao
ab
jn
jn
jn
ab
ak
XS
aN
aN
aN
Dc
ak
aT
aV
aV
bd
bf
bg
"}
(5,1,1) = {"
tc
af
ak
ap
ab
ac
aA
ac
aF
dh
oE
aO
aO
aO
Jj
dh
ab
aW
LP
be
bf
bg
"}
(6,1,1) = {"
tc
ag
ak
hx
ab
av
ak
aC
aG
ak
Bq
ak
ak
ak
aB
aq
at
ab
ab
ab
bf
bg
"}
(7,1,1) = {"
tc
af
ak
ak
as
ak
ak
aD
aH
kl
XS
aN
aN
aN
Dc
kl
ac
Zf
aY
Zf
bf
bg
"}
(8,1,1) = {"
tc
ah
al
al
at
cx
kl
aE
rJ
ak
aP
aO
aO
aO
Jj
ak
aU
aV
aV
aV
bf
bg
"}
(9,1,1) = {"
ab
ad
am
ar
ab
Zf
aB
ak
ak
ak
Bq
ak
ak
ak
aB
ak
ac
aV
aV
aV
bf
bg
"}
(10,1,1) = {"
aa
ab
ab
ab
ab
ay
aZ
aV
aV
aL
dp
aM
aM
aM
he
aL
ac
WL
bb
WL
ab
ab
"}
(11,1,1) = {"
aa
aa
aa
aa
ab
Gc
ab
Gc
ab
ab
ab
Gc
Gc
Gc
ab
ab
ab
Gc
ab
Gc
ab
aa
"}
