// This map has been converted using maphash
"ala" = (/obj/structure/table,/obj/item/storage/firstaid/fire,/obj/item/storage/firstaid/regular{pixel_x = 2; pixel_y = 3},/obj/machinery/door/firedoor/border_only{dir = 8},/turf/open/floor/mineral/titanium/blue,/area/shuttle/escape)
"arG" = (/turf/template_noop,/area/template_noop)
"auV" = (/obj/machinery/door/airlock/titanium{name = "Emergency Shuttle Airlock"; req_access_txt = "2"},/obj/machinery/door/firedoor/border_only{dir = 1},/obj/machinery/door/firedoor/border_only,/turf/open/floor/mineral/plastitanium/red/brig,/area/shuttle/escape)
"aGi" = (/obj/machinery/door/airlock{name = "Emergency Shuttle Restroom"},/obj/machinery/door/firedoor/border_only{dir = 4},/obj/machinery/door/firedoor/border_only{dir = 8},/turf/open/floor/mineral/titanium/white,/area/shuttle/escape)
"aTv" = (/obj/machinery/door/airlock/medical/glass{name = "Escape Shuttle Infirmary"},/obj/machinery/door/firedoor/border_only{dir = 1},/obj/machinery/door/firedoor/border_only,/obj/machinery/door/firedoor/border_only{dir = 4},/obj/machinery/door/firedoor/border_only{dir = 8},/turf/open/floor/mineral/titanium/white,/area/shuttle/escape)
"aXc" = (/obj/machinery/status_display/ai,/turf/closed/wall/mineral/titanium,/area/shuttle/escape)
"cca" = (/obj/structure/chair/comfy/shuttle{dir = 1},/obj/machinery/door/firedoor/border_only{dir = 1},/turf/open/floor/mineral/titanium/blue,/area/shuttle/escape)
"cSF" = (/turf/closed/wall/mineral/titanium,/area/shuttle/escape)
"cXG" = (/obj/structure/table,/obj/item/retractor,/obj/item/hemostat,/obj/item/scalpel,/obj/item/surgicaldrill,/turf/open/floor/mineral/titanium/white,/area/shuttle/escape)
"dca" = (/obj/structure/table/optable,/turf/open/floor/mineral/titanium/white,/area/shuttle/escape)
"djI" = (/obj/machinery/door/airlock/command/glass{name = "Emergency Shuttle Cockpit"; req_access_txt = "19"},/obj/machinery/door/firedoor/border_only{dir = 4},/obj/machinery/door/firedoor/border_only{dir = 8},/turf/open/floor/mineral/titanium,/area/shuttle/escape)
"dxf" = (/obj/structure/chair/comfy/shuttle,/obj/machinery/door/firedoor/border_only,/turf/open/floor/mineral/titanium/blue,/area/shuttle/escape)
"dKs" = (/obj/machinery/door/firedoor/border_only{dir = 8},/turf/open/floor/mineral/titanium,/area/shuttle/escape)
"dTR" = (/obj/structure/table,/obj/item/extinguisher,/obj/item/crowbar,/obj/machinery/door/firedoor/border_only{dir = 4},/turf/open/floor/mineral/titanium/blue,/area/shuttle/escape)
"eNe" = (/obj/structure/table,/obj/item/folder/blue,/obj/item/pen,/obj/machinery/recharger,/turf/open/floor/mineral/titanium,/area/shuttle/escape)
"eQA" = (/obj/structure/chair/comfy/shuttle,/obj/machinery/door/firedoor/border_only{dir = 4},/obj/machinery/door/firedoor/border_only,/turf/open/floor/mineral/titanium/blue,/area/shuttle/escape)
"eTC" = (/obj/structure/chair/comfy/shuttle{dir = 8},/turf/open/floor/mineral/plastitanium/red/brig,/area/shuttle/escape)
"fcg" = (/obj/machinery/vending/wallmed{name = "Emergency NanoMed"; use_power = 0},/turf/closed/wall/mineral/titanium,/area/shuttle/escape)
"ffd" = (/obj/structure/bed,/turf/open/floor/mineral/titanium/white,/area/shuttle/escape)
"fFx" = (/obj/structure/closet/emcloset,/obj/item/radio/intercom{broadcasting = 0; name = "Station Intercom (General)"; pixel_y = 23},/turf/open/floor/mineral/titanium/blue,/area/shuttle/escape)
"fGv" = (/turf/open/floor/mineral/titanium/blue,/area/shuttle/escape)
"grW" = (/obj/machinery/door/airlock/titanium{name = "Emergency Shuttle Airlock"},/obj/machinery/door/firedoor/border_only{dir = 1},/obj/machinery/door/firedoor/border_only,/obj/machinery/door/firedoor/border_only{dir = 4},/obj/machinery/door/firedoor/border_only{dir = 8},/turf/open/floor/mineral/titanium/yellow,/area/shuttle/escape)
"hsg" = (/obj/structure/window/shuttle,/obj/structure/grille,/turf/open/floor/mineral/titanium/blue,/area/shuttle/escape)
"huz" = (/obj/structure/bed,/turf/open/floor/mineral/plastitanium/red/brig,/area/shuttle/escape)
"iiv" = (/obj/structure/chair/office/light{dir = 1; name = "Research Director"},/turf/open/floor/mineral/titanium/blue,/area/shuttle/escape)
"iPv" = (/turf/open/floor/mineral/titanium/yellow,/area/shuttle/escape)
"iRn" = (/obj/machinery/door/firedoor/border_only{dir = 4},/turf/open/floor/mineral/titanium,/area/shuttle/escape)
"jfH" = (/obj/structure/chair/office/light{name = "Head of Security"},/turf/open/floor/mineral/titanium/blue,/area/shuttle/escape)
"jme" = (/obj/machinery/door/airlock/security/glass{name = "Emergency Shuttle Brig"; req_access_txt = "2"},/obj/machinery/door/firedoor/border_only{dir = 1},/obj/machinery/door/firedoor/border_only{dir = 4},/obj/machinery/door/firedoor/border_only{dir = 8},/turf/open/floor/mineral/plastitanium/red/brig,/area/shuttle/escape)
"jsz" = (/obj/item/radio/intercom{broadcasting = 0; name = "Station Intercom (General)"; pixel_y = 23},/turf/open/floor/mineral/titanium,/area/shuttle/escape)
"jAa" = (/obj/machinery/light,/obj/machinery/door/firedoor/border_only{dir = 4},/turf/open/floor/mineral/titanium/blue,/area/shuttle/escape)
"jCp" = (/obj/structure/ore_box,/turf/open/floor/mineral/titanium/yellow,/area/shuttle/escape)
"jFJ" = (/obj/structure/chair/comfy/shuttle,/obj/machinery/door/firedoor/border_only{dir = 8},/obj/machinery/door/firedoor/border_only,/turf/open/floor/mineral/titanium/blue,/area/shuttle/escape)
"jIG" = (/obj/machinery/stasis,/turf/open/floor/mineral/titanium/white,/area/shuttle/escape)
"kjh" = (/obj/structure/extinguisher_cabinet{pixel_y = 30},/turf/open/floor/mineral/titanium,/area/shuttle/escape)
"kzB" = (/obj/structure/table,/obj/item/paper_bin{pixel_x = -1; pixel_y = 6},/turf/open/floor/mineral/titanium,/area/shuttle/escape)
"kKV" = (/obj/structure/chair/comfy/shuttle{dir = 4},/obj/machinery/door/firedoor/border_only{dir = 4},/obj/machinery/door/firedoor/border_only,/turf/open/floor/mineral/titanium/blue,/area/shuttle/escape)
"kLD" = (/obj/machinery/status_display/evac,/turf/closed/wall/mineral/titanium,/area/shuttle/escape)
"kMy" = (/obj/structure/chair/comfy/shuttle{dir = 1},/obj/machinery/door/firedoor/border_only{dir = 8},/obj/machinery/door/firedoor/border_only{dir = 1},/turf/open/floor/mineral/titanium/blue,/area/shuttle/escape)
"kPt" = (/obj/machinery/computer/security{dir = 4},/turf/open/floor/mineral/plastitanium/red/brig,/area/shuttle/escape)
"kYQ" = (/turf/open/floor/mineral/titanium/white,/area/shuttle/escape)
"lhz" = (/obj/machinery/door/airlock/security/glass{name = "Emergency Shuttle Brig"; req_access_txt = "2"},/obj/machinery/door/firedoor/border_only{dir = 1},/obj/machinery/door/firedoor/border_only,/obj/machinery/door/firedoor/border_only{dir = 4},/obj/machinery/door/firedoor/border_only{dir = 8},/turf/open/floor/mineral/plastitanium/red/brig,/area/shuttle/escape)
"lNe" = (/obj/structure/chair/office/light{dir = 1; name = "Head of Personnel"},/turf/open/floor/mineral/titanium/blue,/area/shuttle/escape)
"lXq" = (/obj/structure/shuttle/engine/propulsion{dir = 8},/turf/open/floor/plating/airless,/area/shuttle/escape)
"mfj" = (/obj/structure/table,/obj/item/circular_saw,/obj/item/cautery{pixel_x = 4},/obj/item/surgical_drapes,/turf/open/floor/mineral/titanium/white,/area/shuttle/escape)
"mhj" = (/obj/structure/closet/emcloset,/turf/open/floor/mineral/titanium/blue,/area/shuttle/escape)
"msu" = (/obj/structure/chair/comfy/shuttle{dir = 4},/obj/item/radio/intercom{dir = 8; name = "Station Intercom (General)"; pixel_x = -28},/turf/open/floor/mineral/plastitanium/red/brig,/area/shuttle/escape)
"myM" = (/obj/structure/chair/comfy/shuttle{dir = 8},/obj/machinery/door/firedoor/border_only{dir = 8},/obj/machinery/door/firedoor/border_only{dir = 1},/turf/open/floor/mineral/titanium/blue,/area/shuttle/escape)
"mZb" = (/obj/machinery/computer/crew{dir = 4},/turf/open/floor/mineral/titanium/white,/area/shuttle/escape)
"mZW" = (/turf/closed/wall/mineral/titanium/interior,/area/shuttle/escape)
"nhl" = (/obj/structure/shuttle/engine/heater{dir = 8},/turf/open/floor/plating/airless,/area/shuttle/escape)
"nhZ" = (/obj/machinery/door/airlock/titanium{name = "Emergency Shuttle Airlock"},/obj/docking_port/mobile/emergency{dir = 2; dwidth = 10; height = 13; name = "Asteroid emergency shuttle"; width = 28},/obj/machinery/door/firedoor/border_only{dir = 1},/obj/machinery/door/firedoor/border_only,/turf/open/floor/mineral/titanium,/area/shuttle/escape)
"ntI" = (/obj/structure/chair/office/light{name = "Captain"},/obj/machinery/light{dir = 1},/turf/open/floor/mineral/titanium/blue,/area/shuttle/escape)
"nAi" = (/obj/machinery/computer/emergency_shuttle,/turf/open/floor/mineral/titanium,/area/shuttle/escape)
"oeR" = (/obj/structure/chair/comfy/shuttle{dir = 1},/obj/structure/extinguisher_cabinet{pixel_y = -30},/obj/machinery/door/firedoor/border_only{dir = 1},/turf/open/floor/mineral/titanium/blue,/area/shuttle/escape)
"oxa" = (/obj/structure/chair/office/light{name = "Chief Engineer"},/turf/open/floor/mineral/titanium/blue,/area/shuttle/escape)
"oCE" = (/obj/machinery/door/airlock/medical/glass{name = "Escape Shuttle Infirmary"; req_access_txt = "5"},/obj/machinery/door/firedoor/border_only,/obj/machinery/door/firedoor/border_only{dir = 4},/obj/machinery/door/firedoor/border_only{dir = 8},/turf/open/floor/mineral/titanium/white,/area/shuttle/escape)
"oWt" = (/obj/machinery/light,/obj/machinery/door/firedoor/border_only{dir = 8},/turf/open/floor/mineral/titanium/blue,/area/shuttle/escape)
"pkm" = (/obj/structure/chair/comfy/shuttle{dir = 4},/turf/open/floor/mineral/plastitanium/red/brig,/area/shuttle/escape)
"pEL" = (/obj/structure/sink{dir = 8; pixel_x = -12; pixel_y = 2},/obj/structure/mirror{pixel_x = -30},/turf/open/floor/mineral/titanium/white,/area/shuttle/escape)
"pHQ" = (/obj/structure/extinguisher_cabinet{pixel_y = -30},/turf/open/floor/mineral/titanium,/area/shuttle/escape)
"qlD" = (/obj/machinery/suit_storage_unit,/turf/open/floor/mineral/titanium/yellow,/area/shuttle/escape)
"qoy" = (/obj/machinery/light,/turf/open/floor/mineral/titanium/yellow,/area/shuttle/escape)
"qGP" = (/obj/structure/table,/obj/item/extinguisher,/obj/item/crowbar,/obj/machinery/recharger,/turf/open/floor/mineral/titanium/blue,/area/shuttle/escape)
"raJ" = (/obj/structure/table,/obj/item/storage/firstaid/fire,/obj/item/storage/firstaid/regular{pixel_x = 2; pixel_y = 3},/turf/open/floor/mineral/titanium/blue,/area/shuttle/escape)
"rDo" = (/obj/structure/closet,/turf/open/floor/mineral/titanium/blue,/area/shuttle/escape)
"rIq" = (/obj/machinery/recharge_station,/turf/open/floor/mineral/titanium/yellow,/area/shuttle/escape)
"soY" = (/obj/structure/chair/comfy/shuttle{dir = 1},/obj/item/radio/intercom{name = "Station Intercom (General)"; pixel_y = -29},/obj/machinery/door/firedoor/border_only{dir = 1},/turf/open/floor/mineral/titanium/blue,/area/shuttle/escape)
"sRe" = (/obj/machinery/door/airlock/mining{name = "Emergency Shuttle Storage"},/obj/machinery/door/firedoor/border_only{dir = 4},/obj/machinery/door/firedoor/border_only{dir = 8},/turf/open/floor/mineral/titanium/yellow,/area/shuttle/escape)
"sYD" = (/obj/structure/window/shuttle,/obj/structure/grille,/turf/open/floor/plating,/area/shuttle/escape)
"sZl" = (/obj/structure/toilet{dir = 1},/obj/machinery/light/small{dir = 4},/turf/open/floor/mineral/titanium/white,/area/shuttle/escape)
"tuL" = (/obj/item/radio/intercom{dir = 8; name = "Station Intercom (General)"; pixel_x = -28},/turf/open/floor/mineral/titanium/white,/area/shuttle/escape)
"tSI" = (/obj/machinery/portable_atmospherics/canister/air,/turf/open/floor/mineral/titanium/yellow,/area/shuttle/escape)
"tVj" = (/obj/machinery/door/airlock{name = "Emergency Shuttle Restroom"},/obj/machinery/door/firedoor/border_only{dir = 1},/obj/machinery/door/firedoor/border_only,/turf/open/floor/mineral/titanium/white,/area/shuttle/escape)
"tZW" = (/obj/structure/chair/comfy/shuttle{dir = 8},/obj/machinery/door/firedoor/border_only{dir = 8},/turf/open/floor/mineral/titanium/blue,/area/shuttle/escape)
"uFd" = (/obj/structure/chair/comfy/shuttle{dir = 4},/obj/machinery/door/firedoor/border_only{dir = 4},/obj/machinery/door/firedoor/border_only{dir = 1},/turf/open/floor/mineral/titanium/blue,/area/shuttle/escape)
"uRM" = (/obj/effect/spawner/structure/window/shuttle,/turf/open/floor/plating,/area/shuttle/escape)
"uSD" = (/obj/structure/bed/roller,/turf/open/floor/mineral/titanium/blue,/area/shuttle/escape)
"vby" = (/turf/open/floor/mineral/titanium,/area/shuttle/escape)
"vcz" = (/obj/machinery/door/airlock/titanium{name = "Emergency Shuttle Airlock"},/obj/machinery/door/firedoor/border_only{dir = 1},/obj/machinery/door/firedoor/border_only,/turf/open/floor/mineral/titanium,/area/shuttle/escape)
"vim" = (/turf/closed/wall/mineral/titanium/nodiagonal,/area/shuttle/escape)
"vpE" = (/obj/structure/chair/comfy/shuttle{dir = 4},/obj/machinery/door/firedoor/border_only{dir = 4},/turf/open/floor/mineral/titanium/blue,/area/shuttle/escape)
"vqt" = (/obj/machinery/door/firedoor/border_only{dir = 1},/turf/open/floor/mineral/titanium,/area/shuttle/escape)
"vAA" = (/obj/machinery/ai_slipper,/turf/open/floor/mineral/titanium,/area/shuttle/escape)
"vIC" = (/obj/machinery/door/firedoor/border_only,/turf/open/floor/mineral/titanium,/area/shuttle/escape)
"vJF" = (/obj/structure/chair/comfy/shuttle,/obj/machinery/light{dir = 1},/obj/machinery/door/firedoor/border_only,/turf/open/floor/mineral/titanium/blue,/area/shuttle/escape)
"vKy" = (/obj/machinery/computer/station_alert{dir = 4},/turf/open/floor/mineral/titanium/blue,/area/shuttle/escape)
"vNC" = (/obj/machinery/light,/turf/open/floor/mineral/plastitanium/red/brig,/area/shuttle/escape)
"woz" = (/obj/structure/chair/comfy/shuttle{dir = 1},/obj/machinery/door/firedoor/border_only{dir = 4},/obj/machinery/door/firedoor/border_only{dir = 1},/turf/open/floor/mineral/titanium/blue,/area/shuttle/escape)
"wAy" = (/obj/structure/chair/office/light{dir = 1; name = "Chief Medical Officer"},/turf/open/floor/mineral/titanium/blue,/area/shuttle/escape)
"wTz" = (/obj/machinery/light{dir = 1},/turf/open/floor/mineral/titanium/white,/area/shuttle/escape)
"wTJ" = (/obj/machinery/computer/communications{dir = 4},/turf/open/floor/mineral/titanium/blue,/area/shuttle/escape)
"xsx" = (/obj/effect/spawner/structure/window/shuttle,/obj/machinery/door/firedoor/border_only{dir = 1},/turf/open/floor/plating,/area/shuttle/escape)
"xtc" = (/obj/structure/closet/secure_closet/medical2,/turf/open/floor/mineral/titanium/white,/area/shuttle/escape)
"xTD" = (/obj/structure/chair/comfy/shuttle{dir = 8},/obj/machinery/door/firedoor/border_only{dir = 8},/obj/machinery/door/firedoor/border_only,/turf/open/floor/mineral/titanium/blue,/area/shuttle/escape)
"xXh" = (/turf/open/floor/mineral/plastitanium/red/brig,/area/shuttle/escape)

(1,1,1) = {"
arG
arG
cSF
lXq
cSF
sYD
sYD
hsg
cSF
lXq
cSF
arG
arG
"}
(2,1,1) = {"
cSF
lXq
cSF
nhl
cSF
vKy
fGv
wTJ
cSF
nhl
cSF
lXq
cSF
"}
(3,1,1) = {"
cSF
nhl
cSF
cSF
cSF
vby
vby
vby
cSF
cSF
cSF
nhl
cSF
"}
(4,1,1) = {"
cSF
cSF
vim
qlD
cSF
oxa
kzB
iiv
cSF
pEL
vim
cSF
cSF
"}
(5,1,1) = {"
sYD
jCp
tSI
qoy
cSF
ntI
nAi
lNe
cSF
wTz
tVj
sZl
sYD
"}
(6,1,1) = {"
grW
iPv
iPv
iPv
cSF
jfH
eNe
wAy
cSF
kYQ
cSF
cSF
cSF
"}
(7,1,1) = {"
sYD
rIq
tSI
iPv
cSF
jsz
vAA
pHQ
cSF
kYQ
tVj
sZl
sYD
"}
(8,1,1) = {"
cSF
cSF
cSF
sRe
cSF
aXc
djI
kLD
vim
aGi
vim
cSF
cSF
"}
(9,1,1) = {"
arG
cSF
cSF
kjh
vby
vby
vby
vby
vby
vby
cSF
cSF
arG
"}
(10,1,1) = {"
arG
arG
cSF
rDo
vby
myM
tZW
xTD
vby
mhj
cSF
arG
arG
"}
(11,1,1) = {"
xsx
uRM
mZW
dTR
iRn
cca
uRM
dxf
vby
raJ
cSF
arG
arG
"}
(12,1,1) = {"
vcz
vby
vby
vIC
vby
cca
uRM
dxf
iRn
jAa
cSF
arG
arG
"}
(13,1,1) = {"
xsx
uRM
mZW
vJF
vby
cca
uRM
dxf
vby
soY
cSF
arG
arG
"}
(14,1,1) = {"
arG
arG
sYD
dxf
vby
woz
uRM
eQA
vby
cca
sYD
arG
arG
"}
(15,1,1) = {"
arG
arG
sYD
dxf
vby
vqt
vby
vIC
vby
cca
sYD
arG
arG
"}
(16,1,1) = {"
arG
arG
sYD
dxf
vby
kMy
uRM
jFJ
vby
cca
sYD
arG
arG
"}
(17,1,1) = {"
xsx
uRM
mZW
vJF
vby
cca
uRM
dxf
vby
oeR
cSF
arG
arG
"}
(18,1,1) = {"
nhZ
vby
vby
vIC
vby
cca
uRM
dxf
dKs
oWt
cSF
arG
arG
"}
(19,1,1) = {"
xsx
uRM
mZW
ala
dKs
cca
uRM
dxf
vby
qGP
cSF
arG
arG
"}
(20,1,1) = {"
arG
arG
cSF
fFx
vby
uFd
vpE
kKV
vby
rDo
cSF
arG
arG
"}
(21,1,1) = {"
arG
cSF
cSF
uSD
vby
vby
vby
vby
vby
uSD
cSF
cSF
arG
"}
(22,1,1) = {"
cSF
cSF
cSF
sYD
lhz
sYD
kLD
sYD
aTv
sYD
cSF
cSF
cSF
"}
(23,1,1) = {"
cSF
pkm
msu
pkm
xXh
kPt
cSF
mZb
kYQ
kYQ
tuL
cXG
cSF
"}
(24,1,1) = {"
auV
xXh
xXh
xXh
xXh
xXh
sYD
kYQ
kYQ
kYQ
kYQ
dca
sYD
"}
(25,1,1) = {"
cSF
eTC
eTC
eTC
xXh
vNC
cSF
wTz
kYQ
jIG
xtc
mfj
cSF
"}
(26,1,1) = {"
cSF
cSF
cSF
cSF
sYD
jme
cSF
oCE
sYD
fcg
cSF
cSF
cSF
"}
(27,1,1) = {"
arG
arG
cSF
cSF
huz
xXh
sYD
kYQ
ffd
cSF
cSF
arG
arG
"}
(28,1,1) = {"
arG
arG
arG
cSF
cSF
sYD
cSF
sYD
cSF
cSF
arG
arG
arG
"}
