//MAP CONVERTED BY dmm2tgm.py THIS HEADER COMMENT PREVENTS RECONVERSION, DO NOT REMOVE
"b" = (
/obj/machinery/light{
	dir = 8
	},
/obj/machinery/door/firedoor/border_only{
	dir = 1
	},
/obj/machinery/door/window/brigdoor/security/holding/northleft,
/turf/open/floor/mineral/plastitanium/red/brig,
/area/shuttle/escape/backup)
"c" = (
/obj/structure/shuttle/engine/propulsion/left{
	dir = 8
	},
/obj/effect/turf_decal/stripes/line{
	dir = 8
	},
/turf/open/floor/plating/airless,
/area/shuttle/escape/backup)
"d" = (
/obj/machinery/door/firedoor/border_only{
	dir = 8
	},
/turf/open/floor/mineral/titanium,
/area/shuttle/escape/backup)
"e" = (
/obj/machinery/status_display/evac{
	pixel_y = -32
	},
/obj/structure/chair/comfy/shuttle{
	dir = 1
	},
/turf/open/floor/mineral/plastitanium/red/brig,
/area/shuttle/escape/backup)
"f" = (
/obj/machinery/door/firedoor/border_only{
	dir = 4
	},
/turf/open/floor/mineral/titanium,
/area/shuttle/escape/backup)
"h" = (
/obj/structure/window/reinforced{
	dir = 4
	},
/obj/structure/chair/comfy/shuttle{
	dir = 8
	},
/turf/open/floor/mineral/plastitanium/red/brig,
/area/shuttle/escape/backup)
"j" = (
/obj/machinery/door/firedoor/border_only{
	dir = 8
	},
/obj/machinery/door/firedoor/border_only{
	dir = 1
	},
/obj/structure/chair/comfy/shuttle{
	dir = 4
	},
/turf/open/floor/mineral/titanium/blue,
/area/shuttle/escape/backup)
"k" = (
/obj/structure/table,
/obj/machinery/recharger,
/turf/open/floor/mineral/plastitanium/red/brig,
/area/shuttle/escape/backup)
"l" = (
/obj/machinery/door/firedoor/border_only,
/turf/open/floor/mineral/titanium/white,
/area/shuttle/escape/backup)
"m" = (
/turf/closed/wall/mineral/titanium,
/area/shuttle/escape/backup)
"o" = (
/obj/machinery/door/firedoor/border_only{
	dir = 1
	},
/obj/structure/window/reinforced{
	dir = 1
	},
/obj/structure/window/reinforced{
	dir = 4
	},
/obj/structure/chair/comfy/shuttle{
	dir = 8
	},
/turf/open/floor/mineral/plastitanium/red/brig,
/area/shuttle/escape/backup)
"q" = (
/obj/structure/window/reinforced{
	dir = 4
	},
/obj/structure/shuttle/engine/heater{
	dir = 8
	},
/obj/effect/turf_decal/stripes/line{
	dir = 8
	},
/turf/open/floor/plating/airless,
/area/shuttle/escape/backup)
"r" = (
/obj/machinery/door/airlock/titanium,
/obj/docking_port/mobile/emergency/backup,
/obj/machinery/door/firedoor/border_only{
	dir = 4
	},
/obj/machinery/door/firedoor/border_only{
	dir = 8
	},
/obj/effect/mapping_helpers/airlock/cyclelink_helper{
	dir = 4
	},
/obj/effect/turf_decal/stripes/line{
	dir = 4
	},
/obj/effect/turf_decal/stripes/line{
	dir = 8
	},
/turf/open/floor/plating,
/area/shuttle/escape/backup)
"s" = (
/obj/machinery/light{
	dir = 4
	},
/obj/machinery/computer/emergency_shuttle{
	dir = 8
	},
/turf/open/floor/carpet/blue,
/area/shuttle/escape/backup)
"t" = (
/obj/machinery/light/small{
	dir = 1
	},
/turf/open/floor/plating,
/area/shuttle/escape/backup)
"u" = (
/obj/machinery/door/firedoor/border_only{
	dir = 8
	},
/obj/machinery/door/firedoor/border_only,
/obj/structure/chair/comfy/shuttle{
	dir = 4
	},
/turf/open/floor/mineral/titanium/blue,
/area/shuttle/escape/backup)
"v" = (
/obj/structure/chair/comfy/shuttle{
	dir = 4
	},
/turf/open/floor/mineral/plastitanium/red/brig,
/area/shuttle/escape/backup)
"w" = (
/obj/structure/window/reinforced{
	dir = 8
	},
/obj/machinery/door/window/brigdoor{
	req_access_txt = "19"
	},
/obj/machinery/door/firedoor/border_only,
/turf/open/floor/carpet/blue,
/area/shuttle/escape/backup)
"x" = (
/obj/structure/table/glass,
/obj/item/storage/firstaid/fire{
	pixel_x = 5;
	pixel_y = 5
	},
/obj/item/storage/firstaid/toxin,
/turf/open/floor/mineral/titanium/white,
/area/shuttle/escape/backup)
"y" = (
/obj/structure/window/reinforced{
	dir = 8
	},
/obj/structure/table,
/obj/item/paper/fluff/stations/centcom/broken_evac,
/obj/machinery/status_display/evac{
	pixel_y = 32
	},
/turf/open/floor/carpet/blue,
/area/shuttle/escape/backup)
"z" = (
/obj/structure/closet/crate,
/obj/effect/turf_decal/delivery,
/obj/machinery/status_display/evac{
	pixel_y = -32
	},
/turf/open/floor/mineral/titanium,
/area/shuttle/escape/backup)
"A" = (
/obj/machinery/portable_atmospherics/canister/air,
/obj/effect/turf_decal/delivery,
/turf/open/floor/mineral/titanium,
/area/shuttle/escape/backup)
"B" = (
/obj/machinery/door/firedoor/border_only{
	dir = 8
	},
/obj/machinery/door/firedoor/border_only{
	dir = 4
	},
/obj/machinery/door/airlock/titanium,
/obj/effect/mapping_helpers/airlock/cyclelink_helper{
	dir = 8
	},
/obj/effect/turf_decal/stripes/line{
	dir = 8
	},
/obj/effect/turf_decal/stripes/line{
	dir = 4
	},
/turf/open/floor/plating,
/area/shuttle/escape/backup)
"C" = (
/obj/structure/window/reinforced,
/obj/machinery/door/firedoor/border_only,
/obj/machinery/computer/communications{
	dir = 8
	},
/turf/open/floor/carpet/blue,
/area/shuttle/escape/backup)
"E" = (
/turf/open/floor/mineral/titanium/white,
/area/shuttle/escape/backup)
"F" = (
/obj/machinery/door/firedoor/border_only{
	dir = 4
	},
/obj/machinery/door/firedoor/border_only,
/obj/structure/chair/comfy/shuttle{
	dir = 4
	},
/turf/open/floor/mineral/titanium/blue,
/area/shuttle/escape/backup)
"G" = (
/obj/structure/chair/office/light{
	dir = 4
	},
/obj/structure/window/reinforced{
	dir = 8
	},
/turf/open/floor/carpet/blue,
/area/shuttle/escape/backup)
"H" = (
/obj/machinery/door/firedoor/border_only{
	dir = 8
	},
/obj/structure/chair/comfy/shuttle{
	dir = 4
	},
/turf/open/floor/mineral/titanium/blue,
/area/shuttle/escape/backup)
"I" = (
/turf/closed/wall/mineral/titanium/nodiagonal,
/area/shuttle/escape/backup)
"J" = (
/obj/machinery/light{
	dir = 8
	},
/obj/machinery/door/firedoor/border_only,
/turf/open/floor/mineral/titanium/white,
/area/shuttle/escape/backup)
"K" = (
/obj/machinery/stasis{
	dir = 4
	},
/turf/open/floor/mineral/titanium/white,
/area/shuttle/escape/backup)
"L" = (
/obj/machinery/light{
	dir = 4
	},
/turf/open/floor/mineral/titanium,
/area/shuttle/escape/backup)
"M" = (
/turf/open/floor/mineral/titanium,
/area/shuttle/escape/backup)
"O" = (
/obj/structure/table,
/obj/item/book/random,
/turf/open/floor/carpet/blue,
/area/shuttle/escape/backup)
"P" = (
/obj/machinery/door/firedoor/border_only{
	dir = 4
	},
/obj/machinery/door/firedoor/border_only{
	dir = 1
	},
/obj/structure/chair/comfy/shuttle{
	dir = 4
	},
/turf/open/floor/mineral/titanium/blue,
/area/shuttle/escape/backup)
"Q" = (
/obj/machinery/door/firedoor/border_only{
	dir = 8
	},
/obj/structure/chair/comfy/shuttle{
	dir = 4
	},
/obj/structure/extinguisher_cabinet{
	pixel_y = 30
	},
/turf/open/floor/mineral/titanium/blue,
/area/shuttle/escape/backup)
"R" = (
/turf/open/floor/mineral/plastitanium/red/brig,
/area/shuttle/escape/backup)
"S" = (
/obj/structure/window/reinforced{
	dir = 4
	},
/obj/structure/table,
/obj/item/storage/box/handcuffs{
	pixel_y = 4
	},
/turf/open/floor/mineral/plastitanium/red/brig,
/area/shuttle/escape/backup)
"U" = (
/obj/structure/table/glass,
/obj/item/defibrillator/loaded,
/turf/open/floor/mineral/titanium/white,
/area/shuttle/escape/backup)
"V" = (
/obj/structure/shuttle/engine/propulsion/right{
	dir = 8
	},
/obj/effect/turf_decal/stripes/line{
	dir = 8
	},
/turf/open/floor/plating/airless,
/area/shuttle/escape/backup)
"W" = (
/obj/effect/spawner/structure/window/shuttle,
/obj/machinery/door/firedoor/border_only{
	dir = 4
	},
/turf/open/floor/plating,
/area/shuttle/escape/backup)
"X" = (
/obj/machinery/status_display/evac{
	pixel_y = 32
	},
/obj/structure/table/glass,
/obj/machinery/vending/wallmed{
	pixel_x = -32;
	pixel_y = 32
	},
/obj/item/storage/firstaid/brute{
	pixel_x = 5;
	pixel_y = 5
	},
/obj/item/storage/firstaid/brute,
/turf/open/floor/mineral/titanium/white,
/area/shuttle/escape/backup)
"Y" = (
/obj/machinery/door/firedoor/border_only{
	dir = 4
	},
/obj/structure/chair/comfy/shuttle{
	dir = 4
	},
/turf/open/floor/mineral/titanium/blue,
/area/shuttle/escape/backup)

(1,1,1) = {"
m
c
V
I
r
I
c
V
m
"}
(2,1,1) = {"
m
q
q
m
t
m
q
q
m
"}
(3,1,1) = {"
m
x
U
I
B
I
v
k
m
"}
(4,1,1) = {"
m
X
E
J
M
b
R
e
m
"}
(5,1,1) = {"
m
K
E
l
M
o
h
S
m
"}
(6,1,1) = {"
m
Q
H
u
d
j
H
H
m
"}
(7,1,1) = {"
m
Y
Y
F
f
P
Y
Y
m
"}
(8,1,1) = {"
m
y
G
w
M
M
M
z
m
"}
(9,1,1) = {"
m
O
s
C
M
M
L
A
m
"}
(10,1,1) = {"
m
m
m
W
W
W
m
m
m
"}
