// This map has been converted using maphash
"arG" = (/turf/template_noop,/area/template_noop)
"byh" = (/obj/structure/chair/comfy/shuttle{dir = 8},/turf/open/floor/mineral/titanium/blue,/area/shuttle/pod_1)
"eyK" = (/obj/structure/chair/comfy/shuttle{dir = 8},/obj/machinery/status_display/evac{pixel_x = 32},/turf/open/floor/mineral/titanium/blue,/area/shuttle/pod_1)
"hXy" = (/obj/structure/chair/comfy/shuttle{dir = 4},/turf/open/floor/mineral/titanium/blue,/area/shuttle/pod_1)
"jCK" = (/turf/closed/wall/mineral/titanium,/area/shuttle/pod_1)
"kPd" = (/obj/structure/shuttle/engine/propulsion/burst,/turf/closed/wall/mineral/titanium,/area/shuttle/pod_1)
"lMo" = (/obj/machinery/computer/shuttle/monastery_shuttle,/obj/machinery/light{dir = 1},/turf/open/floor/mineral/titanium/blue,/area/shuttle/pod_1)
"oVj" = (/obj/structure/chair/comfy/shuttle{dir = 4},/obj/item/storage/pod{pixel_x = -24},/turf/open/floor/mineral/titanium/blue,/area/shuttle/pod_1)
"oXT" = (/obj/structure/chair/comfy/shuttle{dir = 8},/obj/item/radio/intercom{pixel_x = 30},/turf/open/floor/mineral/titanium/blue,/area/shuttle/pod_1)
"pBc" = (/obj/structure/grille,/obj/structure/window/shuttle,/turf/open/floor/plating,/area/shuttle/pod_1)
"qVf" = (/obj/structure/chair/comfy/shuttle{dir = 4},/obj/machinery/status_display/evac{pixel_x = -32},/turf/open/floor/mineral/titanium/blue,/area/shuttle/pod_1)
"rKz" = (/turf/open/floor/mineral/titanium/blue,/area/shuttle/pod_1)
"uHk" = (/obj/machinery/door/airlock/titanium{name = "Shuttle Airlock"},/obj/docking_port/mobile/pod{dwidth = 2; height = 6; launch_status = 0; port_direction = 2; width = 5},/obj/machinery/door/firedoor/border_only{dir = 1},/obj/machinery/door/firedoor/border_only,/turf/open/floor/mineral/titanium/blue,/area/shuttle/pod_1)

(1,1,1) = {"
arG
jCK
jCK
pBc
jCK
kPd
"}
(2,1,1) = {"
jCK
jCK
qVf
hXy
oVj
kPd
"}
(3,1,1) = {"
pBc
lMo
rKz
rKz
rKz
uHk
"}
(4,1,1) = {"
jCK
jCK
eyK
byh
oXT
kPd
"}
(5,1,1) = {"
arG
jCK
jCK
pBc
jCK
kPd
"}
