//MAP CONVERTED BY dmm2tgm.py THIS HEADER COMMENT PREVENTS RECONVERSION, DO NOT REMOVE
"a" = (
/turf/template_noop,
/area/template_noop)
"b" = (
/obj/structure/shuttle/engine/propulsion{
	dir = 8
	},
/turf/closed/wall/mineral/titanium,
/area/shuttle/transport)
"o" = (
/obj/structure/chair/comfy/shuttle,
/turf/open/floor/plating/indoor/metal/plate,
/area/shuttle/transport)
"r" = (
/turf/open/floor/plating/indoor/metal/plate,
/area/shuttle/transport)
"v" = (
/obj/structure/chair/comfy/shuttle{
	dir = 1
	},
/turf/open/floor/plating/indoor/metal/plate,
/area/shuttle/transport)
"A" = (
/obj/structure/chair/comfy/shuttle{
	dir = 4
	},
/turf/open/floor/plating/indoor/metal/plate,
/area/shuttle/transport)
"B" = (
/obj/machinery/computer/shuttle/ferry/request{
	dir = 8
	},
/turf/open/floor/plating/indoor/metal/plate,
/area/shuttle/transport)
"I" = (
/obj/docking_port/mobile{
	dir = 8;
	dwidth = 2;
	height = 12;
	name = "ferry shuttle";
	port_direction = 2;
	shuttle_id = "ferry";
	width = 5
	},
/obj/structure/fans/tiny/invisible,
/obj/machinery/door/unpowered/halflife/metal{
	dir = 8
	},
/turf/open/floor/plating/indoor/metal/plate,
/area/shuttle/transport)
"M" = (
/obj/structure/closet/crate,
/turf/open/floor/plating/indoor/metal/plate,
/area/shuttle/transport)
"R" = (
/turf/closed/wall/halflife/metal,
/area/shuttle/transport)

(1,1,1) = {"
a
b
a
b
a
"}
(2,1,1) = {"
b
R
R
R
b
"}
(3,1,1) = {"
R
A
r
M
R
"}
(4,1,1) = {"
R
B
r
M
R
"}
(5,1,1) = {"
R
o
r
v
R
"}
(6,1,1) = {"
R
o
r
v
R
"}
(7,1,1) = {"
R
o
r
v
R
"}
(8,1,1) = {"
R
o
r
v
R
"}
(9,1,1) = {"
R
o
r
v
R
"}
(10,1,1) = {"
R
o
r
v
R
"}
(11,1,1) = {"
R
o
r
v
R
"}
(12,1,1) = {"
R
R
I
R
R
"}
