//MAP CONVERTED BY dmm2tgm.py THIS HEADER COMMENT PREVENTS RECONVERSION, DO NOT REMOVE
"a" = (
/turf/template_noop,
/area/template_noop)
"b" = (
/turf/closed/wall/mineral/titanium,
/area/shuttle/transport)
"c" = (
/obj/effect/spawner/structure/window/shuttle,
/obj/structure/cable{
	icon_state = "0-2"
	},
/obj/machinery/door/firedoor/window,
/obj/machinery/door/poddoor/shutters/preopen{
	id = "ntferrylockdown";
	name = "lockdown shutters"
	},
/turf/open/floor/plating,
/area/shuttle/transport)
"d" = (
/obj/machinery/door/airlock/external{
	name = "Emergency Escape Hatch";
	id_tag = "ferry_escape_doors"
	},
/obj/structure/fans/tiny,
/obj/machinery/door/poddoor/shutters/preopen{
	id = "ntferrylockdown";
	name = "lockdown shutters"
	},
/turf/open/floor/pod/dark,
/area/shuttle/transport)
"e" = (
/obj/structure/shuttle/engine/propulsion/left{
	dir = 8
	},
/turf/open/floor/plating/airless,
/area/shuttle/transport)
"f" = (
/obj/structure/cable{
	icon_state = "1-2"
	},
/obj/effect/decal/cleanable/dirt{
	pixel_x = 2
	},
/obj/machinery/photocopier/faxmachine{
	department = "Nanotrasen Representative's Office"
	},
/obj/structure/table/reinforced,
/turf/open/floor/pod/light,
/area/shuttle/transport)
"g" = (
/obj/structure/filingcabinet{
	density = 0;
	pixel_y = 24
	},
/obj/effect/turf_decal/siding/wood{
	dir = 4
	},
/obj/machinery/door/poddoor/shutters/preopen{
	id = "ntferrylockdown";
	name = "lockdown shutters"
	},
/obj/machinery/door/firedoor/border_only{
	dir = 4
	},
/turf/open/floor/carpet/executive,
/area/shuttle/transport)
"h" = (
/obj/effect/turf_decal/siding/wood/corner{
	dir = 4
	},
/obj/effect/turf_decal/siding/wood,
/obj/machinery/atmospherics/components/unary/vent_pump/on/layer2,
/turf/open/floor/wood,
/area/shuttle/transport)
"i" = (
/obj/structure/cable{
	icon_state = "2-8"
	},
/obj/structure/cable{
	icon_state = "1-8"
	},
/obj/effect/turf_decal/siding/wood/thin{
	dir = 1
	},
/obj/effect/turf_decal/siding/wood/thin,
/obj/machinery/atmospherics/pipe/simple/supply/hidden/layer2{
	dir = 10
	},
/turf/open/floor/carpet/blue,
/area/shuttle/transport)
"j" = (
/obj/structure/shuttle/engine/heater{
	dir = 8
	},
/obj/structure/window/reinforced{
	dir = 4
	},
/obj/structure/cable{
	icon_state = "0-4"
	},
/obj/structure/cable{
	icon_state = "2-4"
	},
/obj/structure/cable{
	icon_state = "1-4";
	tag = ""
	},
/obj/machinery/door/firedoor/border_only{
	dir = 4
	},
/turf/open/floor/plating/airless,
/area/shuttle/transport)
"k" = (
/obj/structure/cable{
	icon_state = "4-8"
	},
/obj/structure/cable{
	icon_state = "1-4";
	tag = ""
	},
/obj/effect/decal/cleanable/dirt{
	pixel_x = 2
	},
/obj/machinery/atmospherics/pipe/simple/green/visible{
	dir = 6
	},
/obj/machinery/atmospherics/pipe/simple/supply/hidden/layer2{
	dir = 4
	},
/obj/machinery/atmospherics/components/unary/vent_scrubber/on/layer4{
	dir = 1
	},
/turf/open/floor/pod/light,
/area/shuttle/transport)
"l" = (
/obj/machinery/door/airlock/centcom{
	name = "Maintenance";
	req_access_txt = "101"
	},
/obj/structure/cable{
	icon_state = "4-8"
	},
/obj/effect/decal/cleanable/dirt{
	pixel_x = 2
	},
/obj/machinery/door/firedoor/border_only{
	dir = 4
	},
/obj/machinery/door/firedoor/border_only{
	dir = 8
	},
/obj/machinery/atmospherics/pipe/layer_manifold{
	dir = 4
	},
/obj/machinery/button/door{
	req_access = list(109);
	id = "ntferrylockdown";
	pixel_y = 24;
	name = "Full Ship Lockdown"
	},
/turf/open/floor/pod/light,
/area/shuttle/transport)
"m" = (
/obj/structure/cable{
	icon_state = "4-8"
	},
/obj/effect/turf_decal/siding/wood/thin{
	dir = 1
	},
/obj/effect/turf_decal/siding/wood/thin,
/obj/machinery/atmospherics/pipe/simple/supply/hidden/layer2{
	dir = 4
	},
/obj/machinery/atmospherics/pipe/manifold/scrubbers/hidden/layer4{
	dir = 1
	},
/turf/open/floor/carpet/blue,
/area/shuttle/transport)
"n" = (
/obj/machinery/door/airlock/titanium{
	name = "Nanotrasen Representative Ferry"
	},
/obj/docking_port/mobile{
	dir = 8;
	dwidth = 2;
	height = 13;
	shuttle_id = "ferry";
	name = "ferry shuttle";
	port_direction = 1;
	preferred_direction = 4;
	width = 5
	},
/obj/structure/fans/tiny,
/obj/machinery/door/firedoor/heavy,
/obj/effect/turf_decal/siding/wood/end/thin{
	dir = 4
	},
/obj/machinery/door/poddoor/shutters/preopen{
	id = "ntferrylockdown";
	name = "lockdown shutters"
	},
/turf/open/floor/carpet/blue,
/area/shuttle/transport)
"o" = (
/obj/machinery/power/rtg/advanced,
/obj/structure/cable,
/obj/structure/cable{
	icon_state = "1-2"
	},
/obj/effect/decal/cleanable/dirt{
	pixel_x = 2
	},
/turf/open/floor/pod/light,
/area/shuttle/transport)
"p" = (
/obj/item/storage/firstaid/advanced,
/obj/machinery/firealarm{
	dir = 4;
	pixel_x = -26
	},
/obj/item/storage/firstaid/advanced,
/obj/structure/table/reinforced,
/obj/effect/turf_decal/siding/wood{
	dir = 1
	},
/obj/machinery/atmospherics/pipe/simple/scrubbers/hidden/layer4,
/turf/open/floor/wood,
/area/shuttle/transport)
"q" = (
/turf/closed/wall/mineral/titanium/nodiagonal,
/area/shuttle/transport)
"r" = (
/obj/machinery/door/airlock/external{
	name = "Emergency Escape Hatch";
	id_tag = "ferry_escape_doors"
	},
/obj/structure/fans/tiny,
/obj/machinery/atmospherics/pipe/simple/scrubbers/hidden/layer4{
	dir = 8
	},
/obj/machinery/door/poddoor/shutters/preopen{
	id = "ntferrylockdown";
	name = "lockdown shutters"
	},
/turf/open/floor/pod/light,
/area/shuttle/transport)
"s" = (
/obj/structure/sign/nanotrasen,
/turf/closed/wall/mineral/titanium/nodiagonal,
/area/shuttle/transport)
"u" = (
/obj/machinery/atmospherics/pipe/simple/scrubbers/hidden/layer4{
	dir = 9
	},
/turf/closed/wall/mineral/titanium,
/area/shuttle/transport)
"v" = (
/obj/structure/chair/comfy/shuttle{
	dir = 4
	},
/obj/machinery/light{
	dir = 8
	},
/obj/effect/turf_decal/siding/wood,
/obj/machinery/recharger/wallrecharger{
	pixel_x = -24;
	pixel_y = 4
	},
/obj/machinery/recharger/wallrecharger{
	pixel_x = -24;
	pixel_y = -8
	},
/obj/machinery/atmospherics/components/unary/vent_scrubber/on/layer4,
/obj/machinery/button/door{
	req_access = list(109);
	id = "ntferrylockdown";
	pixel_y = 24;
	name = "Full Ship Lockdown";
	pixel_x = -6
	},
/turf/open/floor/wood,
/area/shuttle/transport)
"w" = (
/obj/structure/shuttle/engine/propulsion/right{
	dir = 8
	},
/obj/machinery/atmospherics/pipe/simple/scrubbers/hidden/layer4{
	dir = 8
	},
/turf/open/floor/plating/airless,
/area/shuttle/transport)
"x" = (
/obj/structure/table/wood,
/obj/structure/cable{
	icon_state = "4-8"
	},
/obj/effect/turf_decal/siding/wood{
	dir = 4
	},
/obj/machinery/atmospherics/pipe/simple/supply/hidden/layer2{
	dir = 4
	},
/obj/machinery/atmospherics/pipe/simple/scrubbers/hidden/layer4{
	dir = 8
	},
/obj/machinery/door/poddoor/shutters/preopen{
	id = "ntferrylockdown";
	name = "lockdown shutters"
	},
/obj/machinery/door/firedoor/border_only{
	dir = 4
	},
/obj/machinery/button/door{
	req_access = list(109);
	id = "ntferrylockdown";
	pixel_y = 8;
	name = "Full Ship Lockdown"
	},
/turf/open/floor/carpet/executive,
/area/shuttle/transport)
"y" = (
/obj/structure/shuttle/engine/heater{
	dir = 8
	},
/obj/structure/window/reinforced{
	dir = 4
	},
/obj/structure/cable{
	icon_state = "0-2"
	},
/obj/machinery/door/firedoor/border_only{
	dir = 4
	},
/turf/open/floor/plating/airless,
/area/shuttle/transport)
"z" = (
/obj/structure/shuttle/engine/heater{
	dir = 8
	},
/obj/structure/window/reinforced{
	dir = 4
	},
/obj/structure/cable,
/obj/machinery/door/firedoor/border_only{
	dir = 4
	},
/turf/open/floor/plating/airless,
/area/shuttle/transport)
"A" = (
/obj/effect/turf_decal/siding/wood/corner,
/obj/effect/turf_decal/siding/wood{
	dir = 1
	},
/turf/open/floor/wood,
/area/shuttle/transport)
"B" = (
/obj/machinery/light{
	dir = 8
	},
/obj/structure/cable{
	icon_state = "1-2"
	},
/obj/machinery/atmospherics/pipe/simple/scrubbers/hidden/layer4{
	dir = 10
	},
/turf/open/floor/carpet/executive,
/area/shuttle/transport)
"C" = (
/obj/machinery/light/small{
	dir = 1
	},
/obj/structure/cable{
	icon_state = "0-2"
	},
/obj/machinery/computer/monitor/secret,
/obj/effect/decal/cleanable/dirt{
	pixel_x = 2
	},
/obj/machinery/atmospherics/pipe/simple/scrubbers/hidden/layer4{
	dir = 6
	},
/turf/open/floor/pod/light,
/area/shuttle/transport)
"D" = (
/obj/machinery/light/small,
/obj/effect/decal/cleanable/dirt{
	pixel_x = 2
	},
/obj/machinery/firealarm{
	dir = 8;
	pixel_x = 26
	},
/obj/machinery/atmospherics/components/unary/tank/air{
	dir = 1;
	startingvolume = 250
	},
/turf/open/floor/pod/light,
/area/shuttle/transport)
"E" = (
/obj/structure/cable{
	icon_state = "1-2"
	},
/obj/machinery/recharger/wallrecharger{
	pixel_x = -24;
	pixel_y = 4
	},
/turf/open/floor/carpet/executive,
/area/shuttle/transport)
"F" = (
/obj/machinery/atmospherics/pipe/simple/scrubbers/hidden/layer4{
	dir = 8
	},
/turf/closed/wall/mineral/titanium,
/area/shuttle/transport)
"G" = (
/obj/machinery/firealarm{
	dir = 8;
	pixel_x = 26
	},
/obj/effect/turf_decal/siding/wood{
	dir = 1
	},
/obj/effect/turf_decal/siding/wood,
/turf/open/floor/wood,
/area/shuttle/transport)
"H" = (
/obj/structure/chair/comfy/shuttle{
	dir = 4
	},
/obj/structure/cable{
	icon_state = "4-8"
	},
/obj/structure/cable{
	icon_state = "1-8"
	},
/obj/structure/cable{
	icon_state = "2-8"
	},
/obj/machinery/atmospherics/pipe/simple/supply/hidden/layer2{
	dir = 4
	},
/obj/machinery/atmospherics/pipe/simple/scrubbers/hidden/layer4{
	dir = 5
	},
/turf/open/floor/carpet/executive,
/area/shuttle/transport)
"I" = (
/obj/machinery/atmospherics/pipe/simple/scrubbers/hidden/layer4{
	dir = 4
	},
/turf/closed/wall/mineral/titanium/nodiagonal,
/area/shuttle/transport)
"J" = (
/obj/machinery/computer/shuttle/ferry/request{
	dir = 8
	},
/obj/structure/cable{
	icon_state = "2-4"
	},
/obj/structure/cable{
	icon_state = "1-2"
	},
/obj/effect/turf_decal/siding/wood,
/turf/open/floor/wood,
/area/shuttle/transport)
"K" = (
/obj/structure/table/wood,
/obj/item/paper_bin,
/obj/item/pen,
/obj/effect/turf_decal/siding/wood{
	dir = 4
	},
/obj/machinery/door/poddoor/shutters/preopen{
	id = "ntferrylockdown";
	name = "lockdown shutters"
	},
/obj/machinery/door/firedoor/border_only{
	dir = 4
	},
/turf/open/floor/carpet/executive,
/area/shuttle/transport)
"L" = (
/obj/effect/spawner/structure/window/shuttle,
/obj/structure/cable{
	icon_state = "0-8"
	},
/obj/machinery/door/firedoor/window,
/obj/machinery/door/poddoor/shutters/preopen{
	id = "ntferrylockdown";
	name = "lockdown shutters"
	},
/turf/open/floor/plating,
/area/shuttle/transport)
"M" = (
/obj/machinery/atmospherics/components/unary/outlet_injector/on/layer4{
	dir = 4
	},
/obj/structure/lattice/catwalk/over,
/turf/open/floor/plating/airless,
/area/shuttle/transport)
"N" = (
/obj/structure/cable{
	icon_state = "4-8"
	},
/obj/structure/chair/office/dark{
	dir = 8
	},
/obj/effect/turf_decal/siding/wood/end/thin{
	dir = 8
	},
/obj/machinery/atmospherics/pipe/manifold/supply/hidden/layer2,
/obj/machinery/atmospherics/pipe/simple/scrubbers/hidden/layer4{
	dir = 8
	},
/turf/open/floor/carpet/blue,
/area/shuttle/transport)
"O" = (
/obj/effect/spawner/structure/window/shuttle,
/obj/structure/cable,
/obj/machinery/door/firedoor/window,
/obj/machinery/door/poddoor/shutters/preopen{
	id = "ntferrylockdown";
	name = "lockdown shutters"
	},
/turf/open/floor/plating,
/area/shuttle/transport)
"P" = (
/obj/structure/chair/comfy/shuttle{
	dir = 1
	},
/obj/structure/cable{
	icon_state = "1-4"
	},
/obj/structure/cable{
	icon_state = "1-2"
	},
/obj/effect/turf_decal/siding/wood{
	dir = 1
	},
/obj/machinery/atmospherics/components/unary/vent_pump/on/layer2{
	dir = 1
	},
/turf/open/floor/wood,
/area/shuttle/transport)
"Q" = (
/obj/structure/cable{
	icon_state = "4-8"
	},
/obj/effect/turf_decal/siding/wood/thin{
	dir = 1
	},
/obj/effect/turf_decal/siding/wood/thin,
/obj/machinery/atmospherics/pipe/simple/supply/hidden/layer2{
	dir = 4
	},
/obj/machinery/atmospherics/pipe/manifold/scrubbers/hidden/layer4{
	dir = 4
	},
/turf/open/floor/carpet/blue,
/area/shuttle/transport)
"R" = (
/obj/machinery/light{
	dir = 4;
	light_color = "#e8eaff"
	},
/obj/effect/turf_decal/siding/wood,
/obj/effect/turf_decal/siding/wood{
	dir = 1
	},
/obj/machinery/atmospherics/components/unary/vent_scrubber/on/layer4{
	dir = 1
	},
/turf/open/floor/wood,
/area/shuttle/transport)
"S" = (
/obj/machinery/door/airlock/centcom{
	name = "Office";
	req_access_txt = "101"
	},
/obj/structure/cable{
	icon_state = "4-8"
	},
/obj/machinery/door/firedoor/border_only{
	dir = 8
	},
/obj/machinery/door/firedoor/border_only{
	dir = 4
	},
/obj/effect/turf_decal/siding/wood/thin{
	dir = 1
	},
/obj/effect/turf_decal/siding/wood/thin,
/obj/machinery/atmospherics/pipe/simple/supply/hidden/layer2{
	dir = 4
	},
/obj/machinery/atmospherics/pipe/simple/scrubbers/hidden/layer4{
	dir = 8
	},
/turf/open/floor/carpet/blue,
/area/shuttle/transport)
"T" = (
/obj/structure/shuttle/engine/heater{
	dir = 8
	},
/obj/structure/window/reinforced,
/obj/structure/cable{
	icon_state = "0-2"
	},
/obj/machinery/door/firedoor/border_only,
/turf/open/floor/plating/airless,
/area/shuttle/transport)
"U" = (
/obj/structure/shuttle/engine/propulsion/burst{
	dir = 8
	},
/turf/open/floor/plating/airless,
/area/shuttle/transport)
"V" = (
/obj/effect/spawner/structure/window/shuttle,
/obj/structure/cable,
/obj/machinery/door/firedoor/window,
/obj/machinery/atmospherics/pipe/simple/scrubbers/hidden/layer4{
	dir = 8
	},
/obj/machinery/door/poddoor/shutters/preopen{
	id = "ntferrylockdown";
	name = "lockdown shutters"
	},
/turf/open/floor/plating,
/area/shuttle/transport)
"X" = (
/obj/structure/shuttle/engine/heater{
	dir = 8
	},
/obj/structure/window/reinforced{
	dir = 1;
	pixel_y = 1
	},
/obj/structure/cable,
/obj/machinery/door/firedoor/border_only{
	dir = 1
	},
/obj/machinery/atmospherics/pipe/simple/scrubbers/hidden/layer4{
	dir = 8
	},
/turf/open/floor/plating/airless,
/area/shuttle/transport)
"Y" = (
/obj/structure/shuttle/engine/propulsion/right{
	dir = 8
	},
/turf/open/floor/plating/airless,
/area/shuttle/transport)
"Z" = (
/obj/structure/cable{
	icon_state = "2-4"
	},
/obj/structure/cable{
	icon_state = "2-8"
	},
/obj/structure/cable{
	icon_state = "1-4";
	tag = ""
	},
/obj/structure/cable{
	icon_state = "1-8"
	},
/obj/effect/decal/cleanable/dirt{
	pixel_x = 2
	},
/obj/machinery/atmospherics/components/unary/vent_pump/on/layer2{
	dir = 4
	},
/turf/open/floor/pod/light,
/area/shuttle/transport)

(1,1,1) = {"
a
e
U
Y
M
"}
(2,1,1) = {"
e
y
j
z
w
"}
(3,1,1) = {"
T
f
Z
o
X
"}
(4,1,1) = {"
b
C
k
D
F
"}
(5,1,1) = {"
b
I
l
q
F
"}
(6,1,1) = {"
c
B
H
E
V
"}
(7,1,1) = {"
b
g
x
K
F
"}
(8,1,1) = {"
b
h
N
A
F
"}
(9,1,1) = {"
d
G
m
R
r
"}
(10,1,1) = {"
b
q
S
q
F
"}
(11,1,1) = {"
b
v
Q
p
u
"}
(12,1,1) = {"
c
J
i
P
O
"}
(13,1,1) = {"
s
L
n
L
s
"}
