//MAP CONVERTED BY dmm2tgm.py THIS HEADER COMMENT PREVENTS RECONVERSION, DO NOT REMOVE
"a" = (
/turf/template_noop,
/area/template_noop)
"m" = (
/obj/machinery/computer/shuttle/ferry/request{
	dir = 8
	},
/turf/open/floor/plating/indoor/metal/plate,
/area/shuttle/transport)
"q" = (
/obj/structure/fans/tiny/invisible,
/obj/machinery/door/unpowered/halflife/metal{
	dir = 8
	},
/obj/docking_port/mobile{
	dir = 8;
	dwidth = 2;
	height = 13;
	name = "ferry shuttle";
	port_direction = 1;
	preferred_direction = 4;
	shuttle_id = "ferry";
	width = 5
	},
/turf/open/floor/plating/indoor/metal/plate,
/area/shuttle/transport)
"t" = (
/obj/structure/shuttle/engine/propulsion{
	dir = 8
	},
/turf/closed/wall/mineral/titanium,
/area/shuttle/transport)
"u" = (
/obj/structure/chair/comfy/halflife/captain{
	dir = 1
	},
/turf/open/floor/plating/indoor/metal/plate,
/area/shuttle/transport)
"A" = (
/turf/open/floor/plating/indoor/metal/plate,
/area/shuttle/transport)
"J" = (
/obj/structure/chair/comfy/halflife/captain,
/turf/open/floor/plating/indoor/metal/plate,
/area/shuttle/transport)
"K" = (
/turf/closed/wall/halflife/metal,
/area/shuttle/transport)
"P" = (
/obj/structure/table/halflife/no_smooth/large/metal,
/turf/open/floor/plating/indoor/metal/plate,
/area/shuttle/transport)
"Z" = (
/obj/structure/chair/comfy/halflife/captain{
	dir = 4
	},
/turf/open/floor/plating/indoor/metal/plate,
/area/shuttle/transport)

(1,1,1) = {"
a
a
a
a
a
"}
(2,1,1) = {"
a
t
a
t
a
"}
(3,1,1) = {"
t
K
K
K
t
"}
(4,1,1) = {"
K
Z
A
P
K
"}
(5,1,1) = {"
K
m
A
A
K
"}
(6,1,1) = {"
K
J
A
u
K
"}
(7,1,1) = {"
K
J
A
u
K
"}
(8,1,1) = {"
K
J
A
u
K
"}
(9,1,1) = {"
K
J
A
u
K
"}
(10,1,1) = {"
K
J
A
u
K
"}
(11,1,1) = {"
K
J
A
u
K
"}
(12,1,1) = {"
K
J
A
u
K
"}
(13,1,1) = {"
K
K
q
K
K
"}
