// This map has been converted using maphash
"arG" = (/turf/template_noop,/area/template_noop)
"aFp" = (/obj/structure/chair/comfy/shuttle,/turf/open/floor/mineral/titanium/blue,/area/shuttle/hunter)
"aUa" = (/obj/effect/spawner/structure/window/shuttle,/obj/machinery/door/firedoor/border_only{dir = 4},/turf/open/floor/plating,/area/shuttle/hunter)
"baw" = (/obj/effect/spawner/structure/window/shuttle,/turf/open/floor/plating,/area/shuttle/hunter)
"bxF" = (/turf/open/floor/mineral/titanium/blue,/area/shuttle/hunter)
"cIX" = (/obj/structure/chair/comfy/shuttle{dir = 1; icon_state = "shuttle_chair"},/obj/effect/mob_spawn/human/fugitive/spacepol{dir = 1; icon_state = "sleeper"},/turf/open/floor/mineral/titanium/blue,/area/shuttle/hunter)
"diU" = (/obj/structure/fans/tiny,/obj/machinery/door/poddoor/shutters{id = "Interpolship"},/obj/machinery/door/firedoor/border_only{dir = 4},/obj/machinery/door/firedoor/border_only{dir = 8},/turf/open/floor/mineral/titanium/blue,/area/shuttle/hunter)
"dns" = (/obj/structure/shuttle/engine/propulsion{dir = 8},/turf/closed/wall/mineral/titanium,/area/shuttle/hunter)
"dxG" = (/obj/structure/window/shuttle,/obj/structure/grille,/turf/open/floor/plating,/area/shuttle/hunter)
"fEx" = (/obj/effect/turf_decal/loading_area{dir = 4; icon_state = "loadingarea"},/turf/open/floor/mineral/titanium/blue,/area/shuttle/hunter)
"fQZ" = (/obj/effect/turf_decal/stripes{dir = 8; icon_state = "warningline"},/turf/open/floor/mineral/titanium/blue,/area/shuttle/hunter)
"gvb" = (/obj/machinery/computer/shuttle/hunter{dir = 8},/turf/open/floor/mineral/titanium/blue,/area/shuttle/hunter)
"icF" = (/obj/machinery/fugitive_capture,/turf/open/floor/mineral/titanium/blue,/area/shuttle/hunter)
"jAM" = (/obj/machinery/computer/camera_advanced/shuttle_docker/syndicate/hunter{dir = 8; jumpto_ports = list("huntership_home" = 1); view_range = 7; x_offset = 6},/turf/open/floor/mineral/titanium/blue,/area/shuttle/hunter)
"myO" = (/obj/machinery/button/door{id = "Interpolship"; pixel_y = 26},/obj/effect/turf_decal/stripes{dir = 8; icon_state = "warningline"},/turf/open/floor/mineral/titanium/blue,/area/shuttle/hunter)
"oiv" = (/turf/closed/wall/mineral/titanium,/area/shuttle/hunter)
"qel" = (/obj/structure/table,/obj/effect/mob_spawn/human/fugitive/spacepol{dir = 8; icon_state = "sleeper"},/turf/open/floor/mineral/titanium/blue,/area/shuttle/hunter)
"rJW" = (/obj/structure/chair/comfy/shuttle{dir = 4},/turf/open/floor/mineral/titanium/blue,/area/shuttle/hunter)
"shi" = (/obj/machinery/door/airlock/titanium,/obj/machinery/door/firedoor/border_only{dir = 4},/obj/machinery/door/firedoor/border_only{dir = 8},/turf/open/floor/mineral/titanium/blue,/area/shuttle/hunter)
"tEI" = (/obj/effect/turf_decal/delivery,/turf/open/floor/mineral/titanium/blue,/area/shuttle/hunter)
"tYd" = (/obj/structure/closet/crate,/obj/effect/turf_decal/box,/turf/open/floor/mineral/titanium/blue,/area/shuttle/hunter)
"uTx" = (/obj/effect/turf_decal/stripes{dir = 8; icon_state = "warningline"},/obj/effect/turf_decal/caution{dir = 4; icon_state = "caution"},/turf/open/floor/mineral/titanium/blue,/area/shuttle/hunter)
"yhU" = (/obj/structure/fans/tiny,/obj/docking_port/stationary{dir = 4; dwidth = 3; height = 12; id = "pirateship_home"; name = "Deep Space"; width = 7},/obj/docking_port/mobile{dheight = 0; dir = 4; dwidth = 3; height = 12; id = "huntership"; name = "hunter shuttle"; rechargeTime = 1800; width = 7},/obj/machinery/door/poddoor/shutters{id = "Interpolship"},/obj/machinery/door/firedoor/border_only{dir = 4},/obj/machinery/door/firedoor/border_only{dir = 8},/turf/open/floor/mineral/titanium/blue,/area/shuttle/hunter)

(1,1,1) = {"
arG
oiv
diU
yhU
diU
oiv
arG
"}
(2,1,1) = {"
arG
oiv
myO
uTx
fQZ
oiv
arG
"}
(3,1,1) = {"
arG
oiv
aFp
bxF
cIX
oiv
arG
"}
(4,1,1) = {"
dns
oiv
aFp
bxF
cIX
oiv
dns
"}
(5,1,1) = {"
oiv
oiv
aFp
bxF
cIX
oiv
oiv
"}
(6,1,1) = {"
arG
dxG
tEI
bxF
bxF
dxG
arG
"}
(7,1,1) = {"
arG
dxG
fEx
bxF
tYd
dxG
arG
"}
(8,1,1) = {"
arG
oiv
icF
bxF
tYd
oiv
arG
"}
(9,1,1) = {"
dns
oiv
oiv
shi
oiv
oiv
dns
"}
(10,1,1) = {"
oiv
oiv
bxF
rJW
bxF
oiv
oiv
"}
(11,1,1) = {"
arG
baw
jAM
qel
gvb
baw
arG
"}
(12,1,1) = {"
arG
oiv
aUa
aUa
aUa
oiv
arG
"}
