// This map has been converted using maphash
"arG" = (/turf/template_noop,/area/template_noop)
"aCI" = (/obj/structure/window/reinforced{dir = 1},/obj/structure/table/reinforced,/obj/item/aicard,/obj/effect/turf_decal/tile/neutral,/obj/effect/turf_decal/tile/neutral{dir = 8},/turf/open/floor/plasteel/dark,/area/shuttle/syndicate/armory)
"aKQ" = (/obj/structure/shuttle/engine/propulsion,/obj/effect/turf_decal/stripes/line,/turf/open/floor/plating/airless,/area/shuttle/syndicate/hallway)
"aPg" = (/obj/machinery/porta_turret/syndicate/shuttle{dir = 6},/turf/closed/wall/r_wall/syndicate,/area/shuttle/syndicate/hallway)
"aUw" = (/obj/machinery/nuclearbomb/syndicate{anchored = 1},/obj/machinery/door/window{dir = 1},/turf/open/floor/circuit/red,/area/shuttle/syndicate/hallway)
"bqP" = (/obj/effect/turf_decal/stripes/line{dir = 5},/turf/open/floor/mineral/plastitanium/red,/area/shuttle/syndicate/armory)
"bJW" = (/obj/structure/table/reinforced,/obj/item/reagent_containers/glass/beaker/large,/obj/item/reagent_containers/glass/beaker,/obj/item/reagent_containers/dropper,/obj/effect/turf_decal/tile/neutral,/obj/effect/turf_decal/tile/neutral{dir = 8},/turf/open/floor/plasteel/dark,/area/shuttle/syndicate/medical)
"cfu" = (/obj/machinery/light{dir = 8},/obj/effect/turf_decal/tile/neutral{dir = 1},/obj/effect/turf_decal/tile/neutral,/obj/effect/turf_decal/tile/neutral{dir = 4},/obj/effect/turf_decal/tile/neutral{dir = 8},/turf/open/floor/plasteel/dark,/area/shuttle/syndicate/hallway)
"coj" = (/obj/machinery/status_display/evac,/turf/closed/wall/r_wall/syndicate,/area/shuttle/syndicate/armory)
"cvY" = (/obj/machinery/door/airlock/hatch{req_access_txt = "150"},/obj/effect/turf_decal/stripes/line{dir = 1},/obj/machinery/door/firedoor/border_only{dir = 1},/obj/machinery/door/firedoor/border_only,/obj/machinery/door/firedoor/border_only{dir = 4},/obj/machinery/door/firedoor/border_only{dir = 8},/turf/open/floor/mineral/plastitanium/red,/area/shuttle/syndicate/armory)
"cHm" = (/obj/effect/turf_decal/tile/neutral,/obj/effect/turf_decal/tile/neutral{dir = 8},/turf/open/floor/plasteel/dark,/area/shuttle/syndicate/medical)
"cMR" = (/obj/structure/table/reinforced,/obj/machinery/status_display/evac{pixel_x = -32},/obj/item/clipboard,/obj/machinery/light{dir = 8},/obj/item/folder/red,/obj/item/toy/figure/syndie,/obj/effect/turf_decal/tile/neutral{dir = 1},/obj/effect/turf_decal/tile/neutral,/obj/effect/turf_decal/tile/neutral{dir = 4},/obj/effect/turf_decal/tile/neutral{dir = 8},/turf/open/floor/plasteel/dark,/area/shuttle/syndicate/bridge)
"cRP" = (/obj/item/retractor,/obj/item/hemostat,/obj/structure/table/reinforced,/obj/effect/turf_decal/tile/neutral{dir = 1},/obj/effect/turf_decal/tile/neutral,/obj/effect/turf_decal/tile/neutral{dir = 4},/obj/effect/turf_decal/tile/neutral{dir = 8},/turf/open/floor/plasteel/dark,/area/shuttle/syndicate/medical)
"cZk" = (/obj/effect/turf_decal/stripes/line{dir = 1},/turf/open/floor/mineral/plastitanium/red,/area/shuttle/syndicate/armory)
"ddb" = (/turf/closed/wall/r_wall/syndicate,/area/shuttle/syndicate/hallway)
"dxA" = (/obj/structure/sign/warning/vacuum/external{layer = 4},/turf/closed/wall/r_wall/syndicate,/area/shuttle/syndicate/airlock)
"dEQ" = (/obj/machinery/porta_turret/syndicate/shuttle{dir = 5},/turf/closed/wall/r_wall/syndicate,/area/shuttle/syndicate/armory)
"dHS" = (/obj/machinery/light{dir = 4},/obj/effect/turf_decal/tile/neutral{dir = 1},/obj/effect/turf_decal/tile/neutral,/obj/effect/turf_decal/tile/neutral{dir = 4},/obj/effect/turf_decal/tile/neutral{dir = 8},/turf/open/floor/plasteel/dark,/area/shuttle/syndicate/armory)
"dUC" = (/obj/structure/window/reinforced{dir = 8},/obj/item/storage/firstaid/regular{pixel_x = 3; pixel_y = 3},/obj/item/storage/firstaid/brute,/obj/item/storage/firstaid/regular{pixel_x = -3; pixel_y = -3},/obj/structure/table/reinforced,/obj/effect/turf_decal/tile/neutral,/obj/effect/turf_decal/tile/neutral{dir = 8},/turf/open/floor/plasteel/dark,/area/shuttle/syndicate/medical)
"dVX" = (/obj/effect/turf_decal/stripes/line{dir = 9},/turf/open/floor/mineral/plastitanium/red,/area/shuttle/syndicate/medical)
"ecl" = (/turf/open/floor/plasteel/dark,/area/shuttle/syndicate/airlock)
"eeJ" = (/obj/structure/chair/comfy/shuttle{dir = 8; name = "tactical chair"},/obj/machinery/light{dir = 4},/obj/effect/turf_decal/tile/neutral{dir = 1},/obj/effect/turf_decal/tile/neutral,/obj/effect/turf_decal/tile/neutral{dir = 4},/obj/effect/turf_decal/tile/neutral{dir = 8},/turf/open/floor/plasteel/dark,/area/shuttle/syndicate/hallway)
"elR" = (/obj/machinery/computer/camera_advanced/shuttle_docker/syndicate,/obj/effect/turf_decal/bot_white,/turf/open/floor/plasteel/dark,/area/shuttle/syndicate/bridge)
"enk" = (/obj/machinery/computer/crew/syndie,/obj/effect/turf_decal/bot_white,/turf/open/floor/plasteel/dark,/area/shuttle/syndicate/bridge)
"eAS" = (/obj/machinery/porta_turret/syndicate/shuttle{dir = 9},/turf/closed/wall/r_wall/syndicate,/area/shuttle/syndicate/bridge)
"eIH" = (/obj/structure/shuttle/engine/heater,/obj/structure/window/reinforced{dir = 1},/obj/effect/turf_decal/stripes/line,/turf/open/floor/plating/airless,/area/shuttle/syndicate/hallway)
"feZ" = (/obj/structure/table/reinforced,/obj/item/storage/box/handcuffs{pixel_x = 3; pixel_y = 3},/obj/item/storage/box/zipties,/obj/effect/turf_decal/tile/neutral{dir = 1},/obj/effect/turf_decal/tile/neutral,/obj/effect/turf_decal/tile/neutral{dir = 4},/obj/effect/turf_decal/tile/neutral{dir = 8},/turf/open/floor/plasteel/dark,/area/shuttle/syndicate/hallway)
"fmC" = (/obj/machinery/door/window{dir = 1; name = "Surgery"; req_access_txt = "150"},/obj/effect/turf_decal/tile/neutral,/obj/effect/turf_decal/tile/neutral{dir = 8},/turf/open/floor/plasteel/dark,/area/shuttle/syndicate/medical)
"fsM" = (/obj/structure/bed/roller,/obj/machinery/iv_drip,/obj/effect/turf_decal/bot_white,/turf/open/floor/plasteel/dark,/area/shuttle/syndicate/medical)
"fvy" = (/obj/structure/table/reinforced,/obj/item/stack/cable_coil/white,/obj/item/stack/cable_coil/white,/obj/item/crowbar/red,/obj/effect/turf_decal/tile/neutral{dir = 1},/obj/effect/turf_decal/tile/neutral,/obj/effect/turf_decal/tile/neutral{dir = 4},/obj/effect/turf_decal/tile/neutral{dir = 8},/turf/open/floor/plasteel/dark,/area/shuttle/syndicate/hallway)
"fAj" = (/obj/machinery/light{dir = 4},/obj/effect/turf_decal/tile/neutral{dir = 1},/obj/effect/turf_decal/tile/neutral,/obj/effect/turf_decal/tile/neutral{dir = 4},/obj/effect/turf_decal/tile/neutral{dir = 8},/turf/open/floor/plasteel/dark,/area/shuttle/syndicate/hallway)
"gaI" = (/obj/structure/shuttle/engine/propulsion/right,/obj/effect/turf_decal/stripes/line,/turf/open/floor/plating/airless,/area/shuttle/syndicate/medical)
"gEA" = (/obj/machinery/suit_storage_unit/syndicate,/obj/effect/turf_decal/stripes/line{dir = 6},/turf/open/floor/mineral/plastitanium,/area/shuttle/syndicate/eva)
"gIG" = (/obj/machinery/door/airlock/hatch{req_access_txt = "150"},/obj/effect/turf_decal/stripes/line{dir = 1},/obj/machinery/door/firedoor/border_only{dir = 1},/obj/machinery/door/firedoor/border_only,/obj/machinery/door/firedoor/border_only{dir = 4},/obj/machinery/door/firedoor/border_only{dir = 8},/turf/open/floor/mineral/plastitanium/red,/area/shuttle/syndicate/medical)
"gYk" = (/obj/machinery/porta_turret/syndicate/shuttle{dir = 9},/turf/closed/wall/r_wall/syndicate,/area/shuttle/syndicate/medical)
"hgT" = (/obj/structure/shuttle/engine/heater,/obj/structure/window/reinforced{dir = 1},/obj/effect/turf_decal/stripes/line,/turf/open/floor/plating/airless,/area/shuttle/syndicate/medical)
"hig" = (/obj/machinery/door/airlock/hatch{name = "Cockpit"; req_access_txt = "150"},/obj/effect/turf_decal/tile/neutral{dir = 1},/obj/effect/turf_decal/tile/neutral,/obj/effect/turf_decal/tile/neutral{dir = 4},/obj/effect/turf_decal/tile/neutral{dir = 8},/obj/machinery/door/firedoor/border_only{dir = 1},/obj/machinery/door/firedoor/border_only,/turf/open/floor/plasteel/dark,/area/shuttle/syndicate/bridge)
"hwV" = (/obj/structure/closet/syndicate/personal,/obj/effect/turf_decal/bot_white,/turf/open/floor/plasteel/dark,/area/shuttle/syndicate/armory)
"hBc" = (/turf/closed/wall/r_wall/syndicate/nodiagonal,/area/shuttle/syndicate/armory)
"hBT" = (/obj/structure/grille,/obj/structure/window/plastitanium,/turf/open/floor/plating,/area/shuttle/syndicate/eva)
"hIl" = (/obj/effect/turf_decal/stripes/line,/turf/open/floor/mineral/plastitanium/red,/area/shuttle/syndicate/hallway)
"hJA" = (/obj/structure/table/reinforced,/turf/open/floor/plasteel/dark,/area/shuttle/syndicate/bridge)
"hLx" = (/obj/item/cautery,/obj/item/scalpel,/obj/structure/table/reinforced,/obj/effect/turf_decal/tile/neutral{dir = 1},/obj/effect/turf_decal/tile/neutral,/obj/effect/turf_decal/tile/neutral{dir = 4},/obj/effect/turf_decal/tile/neutral{dir = 8},/turf/open/floor/plasteel/dark,/area/shuttle/syndicate/medical)
"hUM" = (/obj/structure/shuttle/engine/propulsion,/obj/effect/turf_decal/stripes/line,/turf/open/floor/plating/airless,/area/shuttle/syndicate/medical)
"hVV" = (/obj/structure/grille,/obj/structure/window/plastitanium,/turf/open/floor/plating,/area/shuttle/syndicate/hallway)
"hXZ" = (/obj/effect/turf_decal/tile/neutral{dir = 1},/obj/effect/turf_decal/tile/neutral,/obj/effect/turf_decal/tile/neutral{dir = 4},/obj/effect/turf_decal/tile/neutral{dir = 8},/turf/open/floor/plasteel/dark,/area/shuttle/syndicate/medical)
"idT" = (/obj/item/wrench,/obj/item/assembly/infra,/obj/structure/table/reinforced,/obj/machinery/light{dir = 1},/turf/open/floor/plasteel/dark,/area/shuttle/syndicate/armory)
"isd" = (/obj/structure/table/reinforced,/obj/item/storage/toolbox/syndicate,/obj/item/crowbar/red,/obj/effect/turf_decal/stripes/line{dir = 9},/turf/open/floor/mineral/plastitanium/red,/area/shuttle/syndicate/airlock)
"ivG" = (/obj/machinery/door/window{dir = 1; name = "Technological Storage"; req_access_txt = "150"},/obj/effect/turf_decal/tile/neutral,/obj/effect/turf_decal/tile/neutral{dir = 8},/turf/open/floor/plasteel/dark,/area/shuttle/syndicate/armory)
"iBE" = (/obj/effect/turf_decal/tile/neutral,/obj/effect/turf_decal/tile/neutral{dir = 8},/turf/open/floor/plasteel/dark,/area/shuttle/syndicate/armory)
"iDg" = (/obj/structure/shuttle/engine/heater,/obj/structure/window/reinforced{dir = 1},/obj/effect/turf_decal/stripes/line,/turf/open/floor/plating/airless,/area/shuttle/syndicate/armory)
"iOu" = (/obj/structure/shuttle/engine/propulsion/right,/obj/effect/turf_decal/stripes/line,/turf/open/floor/plating/airless,/area/shuttle/syndicate/hallway)
"iRR" = (/obj/machinery/recharge_station,/turf/open/floor/circuit/red,/area/shuttle/syndicate/armory)
"jem" = (/obj/structure/chair/office/dark{dir = 1; name = "tactical swivel chair"},/obj/machinery/button/door{id = "syndieshutters"; name = "Cockpit View Control"; pixel_x = 32; pixel_y = 32; req_access_txt = "150"},/turf/open/floor/plasteel/dark,/area/shuttle/syndicate/bridge)
"jfN" = (/obj/effect/turf_decal/stripes/line,/turf/open/floor/mineral/plastitanium/red,/area/shuttle/syndicate/medical)
"jgz" = (/obj/machinery/computer/secure_data/syndie,/obj/effect/turf_decal/bot_white,/turf/open/floor/plasteel/dark,/area/shuttle/syndicate/bridge)
"jjx" = (/obj/structure/table/reinforced,/obj/item/stack/medical/gauze,/obj/item/stack/medical/bruise_pack,/obj/item/stack/medical/ointment,/obj/effect/turf_decal/bot_white,/turf/open/floor/plasteel/dark,/area/shuttle/syndicate/medical)
"jlp" = (/obj/structure/shuttle/engine/propulsion/left,/obj/effect/turf_decal/stripes/line,/turf/open/floor/plating/airless,/area/shuttle/syndicate/medical)
"jxf" = (/obj/effect/turf_decal/tile/neutral{dir = 1},/obj/effect/turf_decal/tile/neutral,/obj/effect/turf_decal/tile/neutral{dir = 4},/obj/effect/turf_decal/tile/neutral{dir = 8},/turf/open/floor/plasteel/dark,/area/shuttle/syndicate/airlock)
"jMo" = (/obj/structure/shuttle/engine/propulsion/right,/obj/effect/turf_decal/stripes/line,/turf/open/floor/plating/airless,/area/shuttle/syndicate/armory)
"jPh" = (/obj/effect/turf_decal/stripes/line{dir = 6},/turf/open/floor/mineral/plastitanium/red,/area/shuttle/syndicate/armory)
"jQZ" = (/obj/machinery/porta_turret/syndicate/shuttle{dir = 5},/turf/closed/wall/r_wall/syndicate,/area/shuttle/syndicate/bridge)
"kxO" = (/obj/structure/window/reinforced{dir = 1},/obj/effect/turf_decal/tile/neutral,/obj/effect/turf_decal/tile/neutral{dir = 8},/turf/open/floor/plasteel/dark,/area/shuttle/syndicate/medical)
"kTe" = (/obj/effect/turf_decal/stripes/line{dir = 1},/turf/open/floor/mineral/plastitanium/red,/area/shuttle/syndicate/medical)
"kUH" = (/turf/open/floor/plasteel/dark,/area/shuttle/syndicate/bridge)
"kXZ" = (/turf/open/floor/plasteel/dark,/area/shuttle/syndicate/eva)
"kYQ" = (/obj/item/weldingtool/largetank{pixel_y = 3},/obj/item/multitool,/obj/structure/table/reinforced,/turf/open/floor/plasteel/dark,/area/shuttle/syndicate/armory)
"laH" = (/obj/structure/closet/syndicate/nuclear,/obj/effect/turf_decal/bot_white,/turf/open/floor/plasteel/dark,/area/shuttle/syndicate/armory)
"lmL" = (/obj/effect/turf_decal/tile/neutral{dir = 1},/obj/effect/turf_decal/tile/neutral,/obj/effect/turf_decal/tile/neutral{dir = 4},/obj/effect/turf_decal/tile/neutral{dir = 8},/turf/open/floor/plasteel/dark,/area/shuttle/syndicate/armory)
"lrF" = (/obj/structure/chair/comfy/shuttle{dir = 4; name = "tactical chair"},/obj/machinery/light{dir = 8},/obj/effect/turf_decal/tile/neutral{dir = 1},/obj/effect/turf_decal/tile/neutral,/obj/effect/turf_decal/tile/neutral{dir = 4},/obj/effect/turf_decal/tile/neutral{dir = 8},/turf/open/floor/plasteel/dark,/area/shuttle/syndicate/hallway)
"ltC" = (/obj/structure/table/reinforced,/obj/machinery/status_display/ai{pixel_x = 32},/obj/item/storage/fancy/donut_box,/obj/machinery/light{dir = 4},/obj/effect/turf_decal/tile/neutral{dir = 1},/obj/effect/turf_decal/tile/neutral,/obj/effect/turf_decal/tile/neutral{dir = 4},/obj/effect/turf_decal/tile/neutral{dir = 8},/turf/open/floor/plasteel/dark,/area/shuttle/syndicate/bridge)
"luN" = (/obj/structure/chair/comfy/shuttle{dir = 8; name = "tactical chair"},/obj/effect/turf_decal/tile/neutral{dir = 1},/obj/effect/turf_decal/tile/neutral,/obj/effect/turf_decal/tile/neutral{dir = 4},/obj/effect/turf_decal/tile/neutral{dir = 8},/turf/open/floor/plasteel/dark,/area/shuttle/syndicate/hallway)
"lBM" = (/turf/open/floor/plasteel/dark,/area/shuttle/syndicate/medical)
"lEk" = (/obj/structure/rack,/obj/effect/turf_decal/bot_white,/obj/effect/turf_decal/stripes/line{dir = 10},/obj/item/clothing/suit/space/syndicate,/obj/item/clothing/head/helmet/space/syndicate,/turf/open/floor/mineral/plastitanium/red,/area/shuttle/syndicate/airlock)
"lHu" = (/obj/machinery/porta_turret/syndicate/shuttle{dir = 10},/turf/closed/wall/r_wall/syndicate,/area/shuttle/syndicate/armory)
"lSI" = (/obj/structure/chair/comfy/shuttle{dir = 4; name = "tactical chair"},/obj/effect/turf_decal/tile/neutral{dir = 1},/obj/effect/turf_decal/tile/neutral,/obj/effect/turf_decal/tile/neutral{dir = 4},/obj/effect/turf_decal/tile/neutral{dir = 8},/turf/open/floor/plasteel/dark,/area/shuttle/syndicate/hallway)
"lSV" = (/obj/structure/shuttle/engine/propulsion/left,/obj/effect/turf_decal/stripes/line,/turf/open/floor/plating/airless,/area/shuttle/syndicate/armory)
"mhb" = (/obj/structure/window/reinforced{dir = 1},/obj/effect/turf_decal/tile/neutral,/obj/effect/turf_decal/tile/neutral{dir = 8},/turf/open/floor/plasteel/dark,/area/shuttle/syndicate/armory)
"mvP" = (/obj/machinery/door/airlock/external{req_access_txt = "150"},/obj/effect/turf_decal/tile/neutral{dir = 1},/obj/effect/turf_decal/tile/neutral,/obj/effect/turf_decal/tile/neutral{dir = 4},/obj/effect/turf_decal/tile/neutral{dir = 8},/obj/machinery/door/firedoor/border_only,/obj/machinery/door/firedoor/border_only{dir = 4},/obj/machinery/door/firedoor/border_only{dir = 8},/turf/open/floor/plasteel/dark,/area/shuttle/syndicate/airlock)
"mCI" = (/obj/machinery/computer/shuttle/syndicate,/obj/effect/turf_decal/bot_white,/turf/open/floor/plasteel/dark,/area/shuttle/syndicate/bridge)
"mEh" = (/turf/closed/wall/r_wall/syndicate,/area/shuttle/syndicate/airlock)
"mHd" = (/obj/machinery/computer/med_data/syndie,/obj/effect/turf_decal/bot_white,/turf/open/floor/plasteel/dark,/area/shuttle/syndicate/bridge)
"mLJ" = (/obj/effect/turf_decal/tile/neutral{dir = 1},/obj/effect/turf_decal/tile/neutral,/obj/effect/turf_decal/tile/neutral{dir = 4},/obj/effect/turf_decal/tile/neutral{dir = 8},/turf/open/floor/plasteel/dark,/area/shuttle/syndicate/hallway)
"mPa" = (/obj/effect/turf_decal/tile/neutral{dir = 1},/obj/effect/turf_decal/tile/neutral,/obj/effect/turf_decal/tile/neutral{dir = 4},/obj/effect/turf_decal/tile/neutral{dir = 8},/turf/open/floor/plasteel/dark,/area/shuttle/syndicate/eva)
"mYf" = (/obj/effect/turf_decal/stripes/line,/turf/open/floor/mineral/plastitanium/red,/area/shuttle/syndicate/armory)
"nvg" = (/obj/machinery/portable_atmospherics/canister/oxygen,/obj/effect/turf_decal/bot_white,/turf/open/floor/plasteel/dark,/area/shuttle/syndicate/eva)
"nyG" = (/obj/machinery/porta_turret/syndicate/shuttle{dir = 9},/turf/closed/wall/r_wall/syndicate,/area/shuttle/syndicate/eva)
"nBx" = (/obj/machinery/sleeper/syndie{dir = 4},/obj/effect/turf_decal/bot_white,/turf/open/floor/plasteel/dark,/area/shuttle/syndicate/medical)
"nKe" = (/obj/machinery/portable_atmospherics/canister/oxygen,/obj/machinery/light{dir = 4},/obj/effect/turf_decal/bot_white,/turf/open/floor/plasteel/dark,/area/shuttle/syndicate/eva)
"odR" = (/obj/machinery/suit_storage_unit/syndicate,/obj/effect/turf_decal/stripes/line{dir = 4},/turf/open/floor/mineral/plastitanium,/area/shuttle/syndicate/eva)
"oDh" = (/turf/closed/wall/r_wall/syndicate,/area/shuttle/syndicate/eva)
"oEi" = (/obj/effect/turf_decal/tile/neutral,/obj/effect/turf_decal/tile/neutral{dir = 8},/turf/open/floor/plasteel/dark,/area/shuttle/syndicate/bridge)
"oEK" = (/obj/effect/turf_decal/stripes/line{dir = 1},/turf/open/floor/mineral/plastitanium/red,/area/shuttle/syndicate/hallway)
"oKa" = (/turf/closed/wall/r_wall/syndicate,/area/shuttle/syndicate/armory)
"oXE" = (/obj/machinery/door/airlock/external{name = "Ready Room"; req_access_txt = "150"},/obj/effect/turf_decal/tile/neutral{dir = 1},/obj/effect/turf_decal/tile/neutral,/obj/effect/turf_decal/tile/neutral{dir = 4},/obj/effect/turf_decal/tile/neutral{dir = 8},/obj/machinery/door/firedoor/border_only{dir = 1},/obj/machinery/door/firedoor/border_only,/obj/machinery/door/firedoor/border_only{dir = 4},/obj/machinery/door/firedoor/border_only{dir = 8},/turf/open/floor/plasteel/dark,/area/shuttle/syndicate/hallway)
"pHj" = (/obj/item/screwdriver{pixel_y = 9},/obj/item/assembly/voice{pixel_y = 3},/obj/structure/table/reinforced,/turf/open/floor/plasteel/dark,/area/shuttle/syndicate/armory)
"pRj" = (/obj/machinery/porta_turret/syndicate/shuttle{dir = 6},/turf/closed/wall/r_wall/syndicate,/area/shuttle/syndicate/medical)
"qoA" = (/obj/structure/grille,/obj/structure/window/plastitanium,/turf/open/floor/plating,/area/shuttle/syndicate/airlock)
"qVk" = (/obj/structure/sink{dir = 4; pixel_x = 11},/obj/structure/mirror{pixel_x = 30},/obj/effect/turf_decal/tile/neutral{dir = 1},/obj/effect/turf_decal/tile/neutral,/obj/effect/turf_decal/tile/neutral{dir = 4},/obj/effect/turf_decal/tile/neutral{dir = 8},/turf/open/floor/plasteel/dark,/area/shuttle/syndicate/medical)
"rai" = (/obj/machinery/computer/camera_advanced/syndie,/obj/effect/turf_decal/bot_white,/turf/open/floor/plasteel/dark,/area/shuttle/syndicate/bridge)
"rep" = (/turf/open/floor/plasteel/dark,/area/shuttle/syndicate/hallway)
"rgp" = (/obj/structure/window/reinforced{dir = 1},/obj/item/bodypart/r_arm/robot,/obj/item/bodypart/l_arm/robot,/obj/structure/table/reinforced,/obj/item/toy/plush/nukeplushie,/obj/effect/turf_decal/tile/neutral,/obj/effect/turf_decal/tile/neutral{dir = 8},/turf/open/floor/plasteel/dark,/area/shuttle/syndicate/medical)
"rgs" = (/obj/structure/shuttle/engine/propulsion/left,/obj/effect/turf_decal/stripes/line,/turf/open/floor/plating/airless,/area/shuttle/syndicate/hallway)
"roE" = (/obj/machinery/door/poddoor{id = "smindicate"; name = "outer blast door"},/obj/machinery/button/door{id = "smindicate"; name = "external door control"; pixel_y = 26; req_access_txt = "150"},/obj/docking_port/mobile{dheight = 1; dir = 8; dwidth = 12; height = 17; hidden = 1; id = "syndicate"; movement_force = list("KNOCKDOWN" = 0, "THROW" = 0); name = "syndicate infiltrator"; port_direction = 4; width = 23},/obj/structure/fans/tiny,/obj/effect/turf_decal/stripes/line{dir = 1},/obj/machinery/door/firedoor/border_only{dir = 8},/turf/open/floor/plating,/area/shuttle/syndicate/airlock)
"rBu" = (/obj/structure/chair/comfy/shuttle{dir = 4; name = "tactical chair"},/obj/effect/turf_decal/bot_white,/obj/machinery/light{dir = 8},/turf/open/floor/plasteel/dark,/area/shuttle/syndicate/airlock)
"rQH" = (/obj/effect/turf_decal/stripes/line{dir = 10},/turf/open/floor/mineral/plastitanium/red,/area/shuttle/syndicate/medical)
"scm" = (/obj/structure/tank_dispenser/oxygen,/obj/effect/turf_decal/bot_white,/turf/open/floor/plasteel/dark,/area/shuttle/syndicate/eva)
"srQ" = (/obj/item/reagent_containers/glass/bottle/epinephrine{pixel_x = 6},/obj/item/reagent_containers/glass/bottle/charcoal{pixel_x = -3},/obj/item/reagent_containers/glass/bottle/epinephrine{pixel_x = -3; pixel_y = 8},/obj/item/reagent_containers/glass/bottle/charcoal{pixel_x = 6; pixel_y = 8},/obj/item/reagent_containers/syringe/epinephrine{pixel_x = 3; pixel_y = -2},/obj/item/reagent_containers/syringe/epinephrine{pixel_x = 4; pixel_y = 1},/obj/item/reagent_containers/syringe/epinephrine{pixel_x = -2; pixel_y = 5},/obj/item/reagent_containers/syringe/epinephrine{pixel_x = 2; pixel_y = 8},/obj/structure/table/reinforced,/obj/effect/turf_decal/bot_white,/turf/open/floor/plasteel/dark,/area/shuttle/syndicate/medical)
"sAB" = (/obj/machinery/status_display/ai,/turf/closed/wall/r_wall/syndicate,/area/shuttle/syndicate/medical)
"sNl" = (/obj/structure/table/optable,/obj/item/surgical_drapes,/obj/effect/turf_decal/bot_white,/turf/open/floor/plasteel/dark,/area/shuttle/syndicate/medical)
"tbv" = (/obj/machinery/porta_turret/syndicate/shuttle{dir = 10},/turf/closed/wall/r_wall/syndicate,/area/shuttle/syndicate/hallway)
"tkD" = (/obj/machinery/telecomms/allinone{intercept = 1},/turf/open/floor/circuit/red,/area/shuttle/syndicate/armory)
"tuh" = (/obj/structure/window/plastitanium,/obj/machinery/door/poddoor/shutters{id = "syndieshutters"; name = "blast shutters"},/obj/structure/grille,/obj/machinery/door/firedoor/border_only{dir = 1},/obj/machinery/door/firedoor/border_only,/turf/open/floor/plating,/area/shuttle/syndicate/bridge)
"tvy" = (/obj/item/assembly/signaler,/obj/item/assembly/signaler,/obj/item/assembly/prox_sensor{pixel_x = -8; pixel_y = 4},/obj/item/assembly/prox_sensor{pixel_x = -8; pixel_y = 4},/obj/structure/table/reinforced,/turf/open/floor/plasteel/dark,/area/shuttle/syndicate/armory)
"tDa" = (/obj/machinery/light{dir = 1},/turf/open/floor/plasteel/dark,/area/shuttle/syndicate/medical)
"tEf" = (/obj/structure/chair/comfy/shuttle{dir = 4; name = "tactical chair"},/obj/effect/turf_decal/bot_white,/turf/open/floor/plasteel/dark,/area/shuttle/syndicate/airlock)
"tLo" = (/obj/structure/chair/office/dark{dir = 8; name = "tactical swivel chair"},/turf/open/floor/plasteel/dark,/area/shuttle/syndicate/bridge)
"ufl" = (/obj/structure/shuttle/engine/propulsion,/obj/effect/turf_decal/stripes/line,/turf/open/floor/plating/airless,/area/shuttle/syndicate/armory)
"uBC" = (/obj/structure/grille,/obj/structure/window/plastitanium,/turf/open/floor/plating,/area/shuttle/syndicate/medical)
"uOi" = (/turf/closed/wall/r_wall/syndicate,/area/shuttle/syndicate/medical)
"uWl" = (/obj/machinery/suit_storage_unit/syndicate,/obj/effect/turf_decal/stripes/line{dir = 5},/turf/open/floor/mineral/plastitanium,/area/shuttle/syndicate/eva)
"vew" = (/obj/effect/spawner/structure/window/reinforced,/turf/open/floor/plating,/area/shuttle/syndicate/hallway)
"veR" = (/obj/effect/turf_decal/stripes/line{dir = 8},/turf/open/floor/mineral/plastitanium/red,/area/shuttle/syndicate/airlock)
"vJW" = (/obj/item/storage/firstaid/regular{pixel_x = 3; pixel_y = 3},/obj/item/storage/firstaid/fire,/obj/item/storage/firstaid/regular{pixel_x = -3; pixel_y = -3},/obj/structure/table/reinforced,/obj/effect/turf_decal/tile/neutral,/obj/effect/turf_decal/tile/neutral{dir = 8},/turf/open/floor/plasteel/dark,/area/shuttle/syndicate/medical)
"vLi" = (/obj/structure/grille,/obj/structure/window/plastitanium,/turf/open/floor/plating,/area/shuttle/syndicate/armory)
"wlp" = (/obj/structure/chair/office/dark{dir = 4; name = "tactical swivel chair"},/turf/open/floor/plasteel/dark,/area/shuttle/syndicate/bridge)
"wpb" = (/obj/item/sbeacondrop/bomb{pixel_y = 5},/obj/item/sbeacondrop/bomb,/obj/structure/table/reinforced,/obj/effect/turf_decal/tile/neutral,/obj/effect/turf_decal/tile/neutral{dir = 8},/turf/open/floor/plasteel/dark,/area/shuttle/syndicate/armory)
"wCY" = (/obj/item/grenade/syndieminibomb{pixel_x = 4; pixel_y = 2},/obj/item/grenade/syndieminibomb{pixel_x = -1},/obj/structure/table/reinforced,/obj/structure/window/reinforced{dir = 4},/obj/item/grenade/plastic/c4,/obj/item/grenade/plastic/c4,/obj/item/grenade/plastic/c4,/obj/item/grenade/plastic/c4,/obj/item/grenade/plastic/c4,/obj/effect/turf_decal/tile/neutral,/obj/effect/turf_decal/tile/neutral{dir = 8},/turf/open/floor/plasteel/dark,/area/shuttle/syndicate/armory)
"wKk" = (/obj/item/surgicaldrill,/obj/item/circular_saw,/obj/structure/table/reinforced,/obj/machinery/light{dir = 8},/obj/effect/turf_decal/tile/neutral{dir = 1},/obj/effect/turf_decal/tile/neutral,/obj/effect/turf_decal/tile/neutral{dir = 4},/obj/effect/turf_decal/tile/neutral{dir = 8},/turf/open/floor/plasteel/dark,/area/shuttle/syndicate/medical)
"wRz" = (/turf/closed/wall/r_wall/syndicate,/area/shuttle/syndicate/bridge)
"xhf" = (/obj/item/stock_parts/cell/high{pixel_x = -3; pixel_y = 3},/obj/item/stock_parts/cell/high,/obj/structure/table/reinforced,/turf/open/floor/plasteel/dark,/area/shuttle/syndicate/armory)
"xKm" = (/obj/machinery/door/airlock/external{name = "E.V.A. Gear Storage"; req_access_txt = "150"},/obj/effect/turf_decal/tile/neutral{dir = 1},/obj/effect/turf_decal/tile/neutral,/obj/effect/turf_decal/tile/neutral{dir = 4},/obj/effect/turf_decal/tile/neutral{dir = 8},/obj/machinery/door/firedoor/border_only,/obj/machinery/door/firedoor/border_only{dir = 4},/obj/machinery/door/firedoor/border_only{dir = 8},/turf/open/floor/plasteel/dark,/area/shuttle/syndicate/eva)
"xRX" = (/obj/machinery/status_display/evac,/turf/closed/wall/r_wall/syndicate,/area/shuttle/syndicate/bridge)
"yfV" = (/turf/closed/wall/r_wall/syndicate/nodiagonal,/area/shuttle/syndicate/medical)
"yhe" = (/obj/structure/reagent_dispensers/fueltank,/obj/effect/turf_decal/bot_white,/turf/open/floor/plasteel/dark,/area/shuttle/syndicate/eva)

(1,1,1) = {"
arG
arG
arG
arG
arG
arG
arG
arG
arG
arG
arG
arG
arG
gYk
uOi
uOi
uOi
uOi
uOi
uOi
uOi
uOi
uOi
"}
(2,1,1) = {"
arG
arG
arG
arG
arG
arG
arG
nyG
oDh
oDh
oDh
oDh
oDh
uOi
nBx
fsM
nBx
bJW
rgp
wKk
hLx
hgT
jlp
"}
(3,1,1) = {"
arG
arG
arG
arG
arG
arG
arG
oDh
uWl
odR
odR
odR
gEA
uOi
lBM
cHm
hXZ
hXZ
fmC
hXZ
sNl
hgT
hUM
"}
(4,1,1) = {"
arG
arG
arG
arG
arG
arG
arG
oDh
mPa
mPa
mPa
mPa
mPa
sAB
tDa
cHm
dVX
rQH
kxO
qVk
cRP
hgT
gaI
"}
(5,1,1) = {"
eAS
wRz
wRz
wRz
wRz
arG
arG
oDh
mPa
mPa
mPa
mPa
mPa
uOi
srQ
cHm
kTe
jfN
dUC
yfV
uOi
uOi
pRj
"}
(6,1,1) = {"
wRz
mHd
cMR
oEi
wRz
tbv
arG
oDh
nvg
scm
nKe
kXZ
yhe
uOi
jjx
cHm
kTe
jfN
vJW
uOi
arG
arG
arG
"}
(7,1,1) = {"
tuh
enk
tLo
oEi
wRz
ddb
ddb
oDh
oDh
oDh
oDh
xKm
hBT
yfV
uBC
uBC
gIG
uBC
uOi
uOi
ddb
ddb
arG
"}
(8,1,1) = {"
tuh
elR
kUH
oEi
xRX
fvy
lSI
lrF
lSI
lSI
hVV
mLJ
mLJ
mLJ
mLJ
cfu
oEK
hIl
mLJ
vew
eIH
rgs
arG
"}
(9,1,1) = {"
tuh
mCI
jem
oEi
hig
mLJ
rep
rep
rep
mLJ
oXE
mLJ
rep
rep
rep
rep
oEK
hIl
mLJ
aUw
eIH
aKQ
arG
"}
(10,1,1) = {"
tuh
hJA
kUH
oEi
wRz
feZ
luN
eeJ
luN
luN
hVV
mLJ
mLJ
mLJ
mLJ
fAj
oEK
hIl
mLJ
vew
eIH
iOu
arG
"}
(11,1,1) = {"
tuh
rai
wlp
oEi
wRz
ddb
ddb
ddb
ddb
mEh
mEh
mvP
qoA
hBc
vLi
vLi
cvY
vLi
oKa
oKa
ddb
ddb
arG
"}
(12,1,1) = {"
wRz
jgz
ltC
oEi
wRz
aPg
arG
mEh
tEf
tEf
rBu
ecl
tEf
oKa
xhf
iBE
cZk
mYf
wpb
oKa
arG
arG
arG
"}
(13,1,1) = {"
jQZ
wRz
wRz
wRz
wRz
arG
arG
mEh
jxf
jxf
jxf
jxf
jxf
oKa
pHj
iBE
cZk
mYf
wCY
hBc
oKa
oKa
lHu
"}
(14,1,1) = {"
arG
arG
arG
arG
arG
arG
arG
mEh
jxf
jxf
jxf
jxf
jxf
coj
idT
iBE
bqP
jPh
mhb
lmL
iRR
iDg
lSV
"}
(15,1,1) = {"
arG
arG
arG
arG
arG
arG
arG
mEh
isd
veR
veR
veR
lEk
oKa
tvy
iBE
lmL
lmL
ivG
lmL
tkD
iDg
ufl
"}
(16,1,1) = {"
arG
arG
arG
arG
arG
arG
arG
dEQ
mEh
mEh
roE
dxA
mEh
oKa
kYQ
iBE
hwV
laH
aCI
dHS
iRR
iDg
jMo
"}
(17,1,1) = {"
arG
arG
arG
arG
arG
arG
arG
arG
arG
arG
arG
arG
arG
dEQ
oKa
oKa
oKa
oKa
oKa
oKa
oKa
oKa
oKa
"}
