//MAP CONVERTED BY dmm2tgm.py THIS HEADER COMMENT PREVENTS RECONVERSION, DO NOT REMOVE
"a" = (
/turf/closed/wall/mineral/titanium,
/area/shuttle/labor)
"b" = (
/obj/effect/spawner/structure/window/shuttle,
/obj/machinery/door/firedoor/border_only{
	dir = 1
	},
/turf/open/floor/plating,
/area/shuttle/labor)
"c" = (
/obj/machinery/computer/shuttle/labor{
	dir = 4
	},
/obj/structure/reagent_dispensers/peppertank{
	pixel_x = -31
	},
/turf/open/floor/mineral/plastitanium/red,
/area/shuttle/labor)
"d" = (
/obj/structure/chair/comfy/shuttle{
	dir = 8
	},
/turf/open/floor/mineral/plastitanium/red,
/area/shuttle/labor)
"e" = (
/obj/structure/table,
/obj/item/folder/red,
/obj/item/restraints/handcuffs,
/turf/open/floor/mineral/plastitanium/red,
/area/shuttle/labor)
"f" = (
/turf/open/floor/mineral/plastitanium/red,
/area/shuttle/labor)
"h" = (
/obj/machinery/mineral/stacking_unit_console{
	machinedir = 2;
	pixel_x = 30;
	pixel_y = 30
	},
/turf/open/floor/mineral/plastitanium/red,
/area/shuttle/labor)
"k" = (
/obj/machinery/mineral/stacking_machine/laborstacker{
	input_dir = 2;
	output_dir = 1
	},
/turf/open/floor/plasteel/dark,
/area/shuttle/labor)
"l" = (
/turf/open/floor/mineral/titanium,
/area/shuttle/labor)
"n" = (
/obj/machinery/mineral/labor_claim_console{
	machinedir = 1;
	pixel_x = 30
	},
/turf/open/floor/mineral/titanium,
/area/shuttle/labor)
"p" = (
/obj/structure/closet/crate,
/turf/open/floor/mineral/titanium,
/area/shuttle/labor)
"x" = (
/obj/machinery/flasher{
	id = "gulagshuttleflasher";
	pixel_x = -24;
	pixel_y = 1
	},
/obj/structure/chair/comfy/shuttle{
	dir = 4
	},
/turf/open/floor/mineral/titanium,
/area/shuttle/labor)
"y" = (
/obj/machinery/door/firedoor/border_only{
	dir = 8
	},
/obj/machinery/door/airlock/titanium{
	name = "Labor Shuttle Airlock";
	req_access_txt = "2"
	},
/obj/machinery/door/firedoor/border_only{
	dir = 4
	},
/obj/docking_port/mobile{
	dir = 4;
	dwidth = 2;
	height = 5;
	id = "laborcamp";
	name = "labor camp shuttle";
	port_direction = 4;
	width = 9
	},
/turf/open/floor/plating,
/area/shuttle/labor)
"H" = (
/obj/machinery/door/airlock/titanium{
	id_tag = "prisonshuttle";
	name = "Labor Shuttle Airlock"
	},
/obj/machinery/door/firedoor/border_only{
	dir = 4
	},
/obj/machinery/door/firedoor/border_only{
	dir = 8
	},
/turf/open/floor/plating,
/area/shuttle/labor)
"J" = (
/obj/machinery/light,
/turf/open/floor/mineral/titanium,
/area/shuttle/labor)
"O" = (
/obj/structure/shuttle/engine/propulsion{
	dir = 1
	},
/turf/open/floor/plating/airless,
/area/shuttle/labor)
"T" = (
/obj/machinery/button/flasher{
	id = "gulagshuttleflasher";
	name = "Flash Control";
	pixel_y = 26;
	req_access_txt = "1"
	},
/obj/machinery/light{
	dir = 1
	},
/turf/open/floor/mineral/plastitanium/red,
/area/shuttle/labor)
"U" = (
/obj/machinery/door/airlock/titanium{
	name = "Labor Shuttle Airlock";
	req_access_txt = "2"
	},
/obj/machinery/door/firedoor/border_only,
/obj/machinery/door/firedoor/border_only{
	dir = 1
	},
/turf/open/floor/mineral/plastitanium/red,
/area/shuttle/labor)
"V" = (
/obj/structure/shuttle/engine/heater{
	dir = 1
	},
/obj/structure/window/reinforced,
/turf/open/floor/plating/airless,
/area/shuttle/labor)
"Z" = (
/obj/machinery/door/firedoor/border_only{
	dir = 4
	},
/obj/effect/spawner/structure/window/shuttle,
/turf/open/floor/plating,
/area/shuttle/labor)

(1,1,1) = {"
a
a
y
a
a
a
H
a
a
"}
(2,1,1) = {"
O
V
l
x
l
k
f
c
b
"}
(3,1,1) = {"
O
V
l
l
J
a
T
d
b
"}
(4,1,1) = {"
O
V
p
l
n
U
h
e
b
"}
(5,1,1) = {"
a
a
a
Z
a
a
Z
a
a
"}
