// This map has been converted using maphash
"bMn" = (/obj/machinery/mineral/labor_claim_console{machinedir = 1; pixel_x = 30},/turf/open/floor/mineral/titanium,/area/shuttle/labor)
"coM" = (/obj/machinery/mineral/stacking_machine/laborstacker{input_dir = 2; output_dir = 1},/turf/open/floor/plasteel/dark,/area/shuttle/labor)
"dOQ" = (/obj/structure/table,/obj/item/folder/red,/obj/item/restraints/handcuffs,/turf/open/floor/mineral/plastitanium/red,/area/shuttle/labor)
"exm" = (/obj/machinery/door/airlock/titanium{name = "Labor Shuttle Airlock"; req_access_txt = "2"},/obj/machinery/door/firedoor/border_only{dir = 4},/obj/machinery/door/firedoor/border_only{dir = 8},/turf/open/floor/plating,/area/shuttle/labor)
"fpw" = (/obj/machinery/button/flasher{id = "gulagshuttleflasher"; name = "Flash Control"; pixel_y = -26; req_access_txt = "1"},/obj/machinery/light,/turf/open/floor/mineral/plastitanium/red,/area/shuttle/labor)
"hRD" = (/obj/machinery/door/airlock/titanium{name = "Labor Shuttle Airlock"; req_access_txt = "2"},/obj/machinery/door/firedoor/border_only{dir = 1},/obj/machinery/door/firedoor/border_only,/turf/open/floor/mineral/plastitanium/red,/area/shuttle/labor)
"jBm" = (/obj/machinery/computer/shuttle/labor{dir = 4},/obj/structure/reagent_dispensers/peppertank{pixel_x = -31},/turf/open/floor/mineral/plastitanium/red,/area/shuttle/labor)
"msY" = (/obj/structure/chair/comfy/shuttle{dir = 8},/obj/machinery/flasher{id = "gulagshuttleflasher"; pixel_x = 25},/turf/open/floor/mineral/titanium,/area/shuttle/labor)
"muX" = (/turf/open/floor/mineral/plastitanium/red,/area/shuttle/labor)
"nxY" = (/obj/machinery/light{dir = 1},/turf/open/floor/mineral/titanium,/area/shuttle/labor)
"qnY" = (/obj/machinery/door/airlock/titanium{id_tag = "prisonshuttle"; name = "Labor Shuttle Airlock"},/obj/docking_port/mobile{dir = 8; dwidth = 2; height = 5; id = "laborcamp"; name = "labor camp shuttle"; port_direction = 4; width = 9},/obj/machinery/door/firedoor/border_only{dir = 4},/obj/machinery/door/firedoor/border_only{dir = 8},/turf/open/floor/plating,/area/shuttle/labor)
"rrw" = (/turf/closed/wall/mineral/titanium,/area/shuttle/labor)
"rwa" = (/obj/structure/shuttle/engine/propulsion,/turf/open/floor/plating/airless,/area/shuttle/labor)
"sfs" = (/obj/structure/shuttle/engine/heater,/obj/structure/window/reinforced{dir = 1; layer = 2.9},/turf/open/floor/plating/airless,/area/shuttle/labor)
"thM" = (/obj/structure/chair/comfy/shuttle{dir = 8},/turf/open/floor/mineral/plastitanium/red,/area/shuttle/labor)
"unj" = (/obj/effect/spawner/structure/window/shuttle,/obj/machinery/door/firedoor/border_only{dir = 1},/turf/open/floor/plating,/area/shuttle/labor)
"uGj" = (/obj/effect/spawner/structure/window/shuttle,/obj/machinery/door/firedoor/border_only{dir = 8},/turf/open/floor/plating,/area/shuttle/labor)
"vwF" = (/obj/structure/closet/crate,/turf/open/floor/mineral/titanium,/area/shuttle/labor)
"wak" = (/obj/machinery/mineral/stacking_unit_console{machinedir = 2; pixel_x = 30; pixel_y = 30},/turf/open/floor/mineral/plastitanium/red,/area/shuttle/labor)
"xgK" = (/turf/open/floor/mineral/titanium,/area/shuttle/labor)

(1,1,1) = {"
rrw
rrw
uGj
rrw
rrw
uGj
rrw
rrw
rrw
"}
(2,1,1) = {"
unj
jBm
muX
hRD
xgK
xgK
vwF
sfs
rwa
"}
(3,1,1) = {"
unj
thM
fpw
rrw
nxY
xgK
xgK
sfs
rwa
"}
(4,1,1) = {"
unj
dOQ
wak
coM
bMn
msY
xgK
sfs
rwa
"}
(5,1,1) = {"
rrw
rrw
exm
rrw
rrw
rrw
qnY
rrw
rrw
"}
