//MAP CONVERTED BY dmm2tgm.py THIS HEADER COMMENT PREVENTS RECONVERSION, DO NOT REMOVE
"a" = (
/turf/closed/wall/mineral/titanium,
/area/shuttle/mining)
"b" = (
/obj/effect/spawner/structure/window/shuttle,
/obj/machinery/door/firedoor/border_only{
	dir = 1
	},
/turf/open/floor/plating,
/area/shuttle/mining)
"d" = (
/obj/machinery/computer/shuttle/mining,
/turf/open/floor/mineral/titanium/blue,
/area/shuttle/mining)
"e" = (
/turf/open/floor/mineral/titanium,
/area/shuttle/mining)
"f" = (
/obj/structure/chair/comfy/shuttle{
	dir = 1
	},
/turf/open/floor/mineral/titanium/blue,
/area/shuttle/mining)
"g" = (
/obj/structure/chair/comfy/shuttle,
/turf/open/floor/mineral/titanium/blue,
/area/shuttle/mining)
"h" = (
/obj/machinery/door/airlock/titanium{
	name = "Mining Shuttle Airlock"
	},
/obj/docking_port/mobile{
	dir = 8;
	dwidth = 3;
	height = 5;
	shuttle_id = "mining";
	name = "mining shuttle";
	port_direction = 4;
	width = 7
	},
/obj/machinery/door/firedoor/border_only{
	dir = 4
	},
/obj/machinery/door/firedoor/border_only{
	dir = 8
	},
/turf/open/floor/plating,
/area/shuttle/mining)
"j" = (
/obj/machinery/door/airlock/titanium{
	name = "Mining Shuttle Airlock"
	},
/obj/machinery/door/firedoor/border_only{
	dir = 4
	},
/obj/machinery/door/firedoor/border_only{
	dir = 8
	},
/turf/open/floor/plating,
/area/shuttle/mining)
"k" = (
/obj/effect/turf_decal/bot,
/obj/structure/ore_box,
/turf/open/floor/mineral/titanium/blue,
/area/shuttle/mining)
"l" = (
/obj/machinery/door/airlock/titanium{
	name = "Mining Shuttle Airlock"
	},
/obj/machinery/door/firedoor/border_only,
/obj/machinery/door/firedoor/border_only{
	dir = 1
	},
/turf/open/floor/plating,
/area/shuttle/mining)
"x" = (
/obj/structure/shuttle/engine/heater,
/obj/structure/window/reinforced{
	dir = 1;
	layer = 2.9
	},
/obj/structure/window/reinforced{
	dir = 8
	},
/obj/structure/window/reinforced{
	dir = 4
	},
/turf/open/floor/plating/airless,
/area/shuttle/mining)
"E" = (
/obj/effect/spawner/structure/window/shuttle,
/obj/machinery/door/firedoor/border_only{
	dir = 4
	},
/turf/open/floor/plating,
/area/shuttle/mining)
"G" = (
/obj/effect/spawner/structure/window/shuttle,
/obj/machinery/door/firedoor/border_only,
/turf/open/floor/plating,
/area/shuttle/mining)
"Q" = (
/obj/structure/chair/comfy/shuttle{
	dir = 1
	},
/turf/open/floor/mineral/titanium,
/area/shuttle/mining)
"S" = (
/obj/effect/turf_decal/bot,
/obj/machinery/light{
	dir = 1
	},
/obj/machinery/newscaster{
	pixel_y = 32
	},
/obj/structure/table/reinforced,
/turf/open/floor/mineral/titanium/blue,
/area/shuttle/mining)
"T" = (
/obj/effect/spawner/structure/window/shuttle,
/obj/machinery/door/firedoor/border_only{
	dir = 8
	},
/turf/open/floor/plating,
/area/shuttle/mining)
"U" = (
/obj/structure/shuttle/engine/propulsion/burst,
/turf/open/floor/plating/airless,
/area/shuttle/mining)
"Z" = (
/obj/effect/turf_decal/bot,
/obj/machinery/light{
	dir = 1
	},
/obj/structure/table/reinforced,
/obj/structure/sign/poster/official/random{
	pixel_y = 32
	},
/turf/open/floor/mineral/titanium/blue,
/area/shuttle/mining)

(1,1,1) = {"
a
a
T
j
T
x
U
"}
(2,1,1) = {"
a
S
g
e
f
k
G
"}
(3,1,1) = {"
b
d
Q
e
e
e
l
"}
(4,1,1) = {"
a
Z
g
e
f
k
G
"}
(5,1,1) = {"
a
a
E
h
T
x
U
"}
