// This map has been converted using maphash
"aYM" = (/obj/effect/decal/cleanable/dirt,/obj/effect/turf_decal/stripes/line{dir = 8},/turf/open/floor/plasteel,/area/shuttle/mining)
"dJq" = (/obj/effect/turf_decal/tile/neutral{dir = 1},/obj/effect/turf_decal/tile/neutral,/obj/effect/turf_decal/tile/neutral{dir = 4},/obj/effect/turf_decal/tile/neutral{dir = 8},/turf/open/floor/plasteel,/area/shuttle/mining)
"fyn" = (/obj/structure/chair/comfy/shuttle{dir = 1},/obj/effect/decal/cleanable/dirt,/obj/effect/turf_decal/stripes/end{dir = 8},/turf/open/floor/plasteel,/area/shuttle/mining)
"hOD" = (/obj/structure/shuttle/engine/heater,/obj/structure/window/reinforced{dir = 4},/obj/structure/window/reinforced{dir = 1},/obj/structure/window/reinforced{dir = 8},/obj/effect/turf_decal/stripes/line,/turf/open/floor/plating/airless,/area/shuttle/mining)
"iMW" = (/obj/machinery/door/airlock/shuttle{name = "Mining Shuttle Airlock"},/obj/effect/turf_decal/stripes/line{dir = 8},/obj/effect/turf_decal/stripes/line{dir = 4},/obj/docking_port/mobile{dir = 4; dwidth = 3; height = 5; id = "mining"; name = "mining shuttle"; port_direction = 8; width = 7},/obj/effect/mapping_helpers/airlock/cyclelink_helper{dir = 4},/obj/machinery/door/firedoor/border_only{dir = 4},/obj/machinery/door/firedoor/border_only{dir = 8},/turf/open/floor/plasteel/white,/area/shuttle/mining)
"jnO" = (/obj/structure/chair/comfy/shuttle{dir = 1},/obj/effect/turf_decal/tile/neutral{dir = 1},/obj/effect/turf_decal/tile/neutral,/obj/effect/turf_decal/tile/neutral{dir = 4},/obj/effect/turf_decal/tile/neutral{dir = 8},/turf/open/floor/plasteel,/area/shuttle/mining)
"krG" = (/obj/machinery/computer/shuttle/mining,/obj/effect/decal/cleanable/dirt,/obj/effect/turf_decal/stripes/line{dir = 1},/turf/open/floor/plasteel,/area/shuttle/mining)
"lSV" = (/obj/effect/spawner/structure/window/shuttle,/obj/machinery/door/firedoor/border_only{dir = 1},/turf/open/floor/plating,/area/shuttle/mining)
"nzW" = (/obj/item/clothing/suit/hazardvest{desc = "A high-visibility lifejacket complete with whistle and slot for oxygen tanks."; name = "emergency lifejacket"},/obj/item/clothing/suit/hazardvest{desc = "A high-visibility lifejacket complete with whistle and slot for oxygen tanks."; name = "emergency lifejacket"},/obj/item/clothing/suit/hazardvest{desc = "A high-visibility lifejacket complete with whistle and slot for oxygen tanks."; name = "emergency lifejacket"},/obj/item/clothing/suit/hazardvest{desc = "A high-visibility lifejacket complete with whistle and slot for oxygen tanks."; name = "emergency lifejacket"},/obj/item/clothing/suit/hazardvest{desc = "A high-visibility lifejacket complete with whistle and slot for oxygen tanks."; name = "emergency lifejacket"},/obj/item/tank/internals/emergency_oxygen{pixel_x = 3},/obj/item/tank/internals/emergency_oxygen{pixel_x = 3},/obj/item/tank/internals/emergency_oxygen{pixel_x = 3},/obj/item/tank/internals/emergency_oxygen{pixel_x = 3},/obj/item/tank/internals/emergency_oxygen{pixel_x = 3},/obj/item/clothing/mask/breath{pixel_x = -3; pixel_y = -3},/obj/item/clothing/mask/breath{pixel_x = -3; pixel_y = -3},/obj/item/clothing/mask/breath{pixel_x = -3; pixel_y = -3},/obj/item/clothing/mask/breath{pixel_x = -3; pixel_y = -3},/obj/item/clothing/mask/breath{pixel_x = -3; pixel_y = -3},/obj/item/clothing/head/hardhat/orange{name = "protective hat"; pixel_y = 9},/obj/item/clothing/head/hardhat/orange{name = "protective hat"; pixel_y = 9},/obj/item/clothing/head/hardhat/orange{name = "protective hat"; pixel_y = 9},/obj/item/clothing/head/hardhat/orange{name = "protective hat"; pixel_y = 9},/obj/item/clothing/head/hardhat/orange{name = "protective hat"; pixel_y = 9},/obj/structure/closet/crate/internals,/obj/effect/decal/cleanable/dirt,/obj/item/pickaxe/emergency,/obj/item/pickaxe/emergency,/obj/effect/turf_decal/delivery,/obj/machinery/light/small{dir = 8},/turf/open/floor/plasteel,/area/shuttle/mining)
"nMF" = (/turf/closed/wall/mineral/titanium,/area/shuttle/mining)
"opZ" = (/obj/structure/shuttle/engine/propulsion/burst,/obj/structure/window/reinforced{dir = 1; layer = 2.9},/obj/effect/turf_decal/stripes/line,/turf/open/floor/plating/airless,/area/shuttle/mining)
"oFs" = (/obj/effect/spawner/structure/window/shuttle,/obj/machinery/door/firedoor/border_only{dir = 8},/turf/open/floor/plating,/area/shuttle/mining)
"pDQ" = (/obj/effect/spawner/structure/window/shuttle,/obj/machinery/door/firedoor/border_only{dir = 4},/turf/open/floor/plating,/area/shuttle/mining)
"pYN" = (/obj/structure/table/reinforced,/obj/effect/decal/cleanable/dirt,/obj/item/crowbar/red,/obj/item/wrench,/obj/item/tank/internals/emergency_oxygen,/obj/item/clothing/mask/gas,/obj/effect/turf_decal/stripes/line{dir = 5},/obj/machinery/light/small{dir = 4},/turf/open/floor/plasteel,/area/shuttle/mining)
"qdG" = (/obj/machinery/door/airlock/shuttle{name = "Mining Shuttle Airlock"},/obj/effect/turf_decal/stripes/line{dir = 8},/obj/effect/turf_decal/stripes/line{dir = 4},/obj/effect/mapping_helpers/airlock/cyclelink_helper{dir = 8},/obj/machinery/door/firedoor/border_only{dir = 4},/obj/machinery/door/firedoor/border_only{dir = 8},/turf/open/floor/plasteel/white,/area/shuttle/mining)
"qZv" = (/obj/structure/chair/comfy/shuttle{dir = 1},/obj/effect/decal/cleanable/dirt,/obj/effect/turf_decal/stripes/line{dir = 2},/obj/effect/turf_decal/stripes/line{dir = 1},/turf/open/floor/plasteel,/area/shuttle/mining)
"sVR" = (/obj/effect/decal/cleanable/dirt,/obj/effect/decal/cleanable/blood/old,/obj/effect/turf_decal/stripes/line{dir = 4},/turf/open/floor/plasteel,/area/shuttle/mining)
"sYR" = (/obj/structure/chair/comfy/shuttle{dir = 1},/obj/effect/decal/cleanable/dirt,/obj/effect/turf_decal/stripes/end{dir = 4},/turf/open/floor/plasteel,/area/shuttle/mining)
"tnM" = (/obj/effect/turf_decal/stripes/line{dir = 8},/turf/open/floor/plasteel,/area/shuttle/mining)
"ujZ" = (/obj/effect/turf_decal/stripes/line{dir = 4},/turf/open/floor/plasteel,/area/shuttle/mining)
"xen" = (/obj/structure/ore_box,/obj/effect/decal/cleanable/dirt,/obj/effect/turf_decal/delivery,/obj/machinery/light/small{dir = 4},/turf/open/floor/plasteel,/area/shuttle/mining)
"xTR" = (/obj/structure/table/reinforced,/obj/item/storage/toolbox/emergency,/obj/effect/turf_decal/stripes/line{dir = 9},/obj/machinery/light/small{dir = 8},/turf/open/floor/plasteel,/area/shuttle/mining)

(1,1,1) = {"
nMF
nMF
oFs
iMW
oFs
nMF
nMF
"}
(2,1,1) = {"
nMF
xTR
tnM
aYM
fyn
nzW
nMF
"}
(3,1,1) = {"
lSV
krG
jnO
dJq
qZv
hOD
opZ
"}
(4,1,1) = {"
nMF
pYN
sVR
ujZ
sYR
xen
nMF
"}
(5,1,1) = {"
nMF
nMF
pDQ
qdG
pDQ
nMF
nMF
"}
