//MAP CONVERTED BY dmm2tgm.py THIS HEADER COMMENT PREVENTS RECONVERSION, DO NOT REMOVE
"a" = (
/turf/closed/wall/mineral/titanium,
/area/shuttle/mining)
"c" = (
/obj/structure/table,
/obj/item/storage/toolbox/emergency,
/obj/machinery/light/small{
	dir = 8
	},
/turf/open/floor/mineral/plastitanium,
/area/shuttle/mining)
"d" = (
/obj/effect/turf_decal/bot,
/obj/machinery/computer/shuttle/mining,
/turf/open/floor/mineral/plastitanium,
/area/shuttle/mining)
"e" = (
/obj/structure/table,
/obj/item/crowbar/red,
/obj/item/radio/intercom{
	pixel_y = 22
	},
/obj/machinery/light/small{
	dir = 4
	},
/turf/open/floor/mineral/plastitanium,
/area/shuttle/mining)
"f" = (
/obj/effect/turf_decal/tile/brown,
/obj/effect/turf_decal/tile/brown{
	dir = 1
	},
/obj/effect/turf_decal/stripes/line{
	dir = 9
	},
/turf/open/floor/mineral/titanium/yellow,
/area/shuttle/mining)
"g" = (
/obj/effect/turf_decal/bot,
/obj/structure/chair/comfy/shuttle{
	dir = 1
	},
/turf/open/floor/mineral/plastitanium,
/area/shuttle/mining)
"h" = (
/obj/effect/turf_decal/tile/brown,
/obj/effect/turf_decal/tile/brown{
	dir = 1
	},
/obj/machinery/status_display/evac{
	pixel_x = -32
	},
/obj/effect/turf_decal/stripes/line{
	dir = 10
	},
/turf/open/floor/mineral/titanium/yellow,
/area/shuttle/mining)
"i" = (
/obj/machinery/door/airlock/shuttle{
	name = "Mining Shuttle Airlock"
	},
/obj/effect/turf_decal/stripes/line{
	dir = 8
	},
/obj/effect/turf_decal/stripes/line{
	dir = 4
	},
/obj/docking_port/mobile{
	dir = 8;
	dwidth = 3;
	height = 5;
	shuttle_id = "mining";
	name = "mining shuttle";
	port_direction = 4;
	width = 7
	},
/turf/open/floor/mineral/plastitanium,
/area/shuttle/mining)
"k" = (
/obj/item/clothing/suit/hazardvest{
	desc = "A high-visibility lifejacket complete with whistle and slot for oxygen tanks.";
	name = "emergency lifejacket"
	},
/obj/item/clothing/suit/hazardvest{
	desc = "A high-visibility lifejacket complete with whistle and slot for oxygen tanks.";
	name = "emergency lifejacket"
	},
/obj/item/tank/internals/emergency_oxygen{
	pixel_x = 3
	},
/obj/item/tank/internals/emergency_oxygen{
	pixel_x = 3
	},
/obj/item/clothing/mask/breath{
	pixel_x = -3;
	pixel_y = -3
	},
/obj/item/clothing/mask/breath{
	pixel_x = -3;
	pixel_y = -3
	},
/obj/item/clothing/head/hardhat/orange{
	name = "protective hat";
	pixel_y = 9
	},
/obj/item/clothing/head/hardhat/orange{
	name = "protective hat";
	pixel_y = 9
	},
/obj/structure/closet/crate/internals,
/obj/machinery/airalarm{
	dir = 4;
	pixel_x = -24
	},
/obj/machinery/light/small,
/obj/effect/turf_decal/box,
/turf/open/floor/mineral/plastitanium,
/area/shuttle/mining)
"m" = (
/obj/structure/ore_box,
/obj/machinery/light/small,
/obj/effect/turf_decal/box,
/turf/open/floor/mineral/plastitanium,
/area/shuttle/mining)
"n" = (
/obj/structure/sign/warning/fire,
/turf/closed/wall/mineral/titanium,
/area/shuttle/mining)
"o" = (
/obj/structure/shuttle/engine/propulsion,
/obj/effect/turf_decal/stripes/line,
/turf/open/floor/plating/airless,
/area/shuttle/mining)
"s" = (
/obj/effect/turf_decal/tile/brown,
/obj/effect/turf_decal/tile/brown{
	dir = 1
	},
/obj/effect/turf_decal/stripes/line{
	dir = 5
	},
/turf/open/floor/mineral/titanium/yellow,
/area/shuttle/mining)
"t" = (
/obj/effect/turf_decal/tile/brown,
/obj/effect/turf_decal/tile/brown{
	dir = 1
	},
/obj/effect/turf_decal/stripes/line{
	dir = 1
	},
/obj/structure/chair/comfy/shuttle{
	dir = 1
	},
/turf/open/floor/mineral/titanium/yellow,
/area/shuttle/mining)
"v" = (
/obj/effect/turf_decal/tile/brown,
/obj/effect/turf_decal/tile/brown{
	dir = 1
	},
/obj/effect/turf_decal/stripes/line,
/turf/open/floor/mineral/titanium/yellow,
/area/shuttle/mining)
"G" = (
/obj/effect/spawner/structure/window/shuttle,
/obj/machinery/door/firedoor/border_only{
	dir = 8
	},
/turf/open/floor/plating,
/area/shuttle/mining)
"I" = (
/obj/structure/shuttle/engine/heater,
/obj/structure/window/reinforced{
	dir = 1;
	layer = 2.9
	},
/obj/structure/window/reinforced{
	dir = 4
	},
/obj/structure/window/reinforced{
	dir = 8
	},
/turf/open/floor/plating/airless,
/area/shuttle/mining)
"T" = (
/obj/effect/spawner/structure/window/shuttle,
/obj/machinery/door/firedoor/border_only{
	dir = 4
	},
/turf/open/floor/plating,
/area/shuttle/mining)
"V" = (
/obj/effect/spawner/structure/window/shuttle,
/obj/machinery/door/firedoor/border_only{
	dir = 1
	},
/turf/open/floor/plating,
/area/shuttle/mining)
"W" = (
/obj/effect/turf_decal/tile/brown,
/obj/effect/turf_decal/tile/brown{
	dir = 1
	},
/obj/effect/turf_decal/stripes/line,
/obj/effect/turf_decal/stripes/corner{
	dir = 4
	},
/turf/open/floor/mineral/titanium/yellow,
/area/shuttle/mining)

(1,1,1) = {"
a
a
G
a
G
a
a
"}
(2,1,1) = {"
a
c
f
h
g
k
n
"}
(3,1,1) = {"
V
d
t
v
g
I
o
"}
(4,1,1) = {"
a
e
s
W
g
m
n
"}
(5,1,1) = {"
a
a
T
i
T
a
a
"}
