// This map has been converted using maphash
"acc" = (/obj/effect/turf_decal/tile/neutral{dir = 1},/obj/effect/turf_decal/tile/neutral,/obj/effect/turf_decal/tile/neutral{dir = 4},/obj/effect/turf_decal/tile/neutral{dir = 8},/turf/open/floor/plasteel/dark,/area/shuttle/caravan/pirate)
"arG" = (/turf/template_noop,/area/template_noop)
"aAv" = (/obj/machinery/atmospherics/pipe/simple/supply/hidden{dir = 4},/obj/machinery/door/firedoor,/obj/machinery/door/airlock/medical/glass{name = "Medbay"},/obj/effect/decal/cleanable/dirt,/obj/machinery/door/firedoor/border_only{dir = 4},/obj/machinery/door/firedoor/border_only{dir = 8},/turf/open/floor/plasteel,/area/shuttle/caravan/pirate)
"aFk" = (/obj/machinery/light/small{dir = 4},/obj/machinery/atmospherics/pipe/simple/supply/hidden,/turf/open/floor/plating,/area/shuttle/caravan/pirate)
"aZA" = (/obj/structure/grille,/obj/structure/window/plastitanium,/obj/machinery/door/poddoor{id = "caravanpirate_bridge"},/obj/machinery/door/firedoor/border_only,/turf/open/floor/plating,/area/shuttle/caravan/pirate)
"bln" = (/obj/machinery/atmospherics/components/unary/vent_pump/on{dir = 4},/obj/machinery/space_heater,/obj/effect/turf_decal/stripes/line{dir = 6},/turf/open/floor/plating,/area/shuttle/caravan/pirate)
"bmO" = (/obj/machinery/atmospherics/pipe/simple/supply/hidden{dir = 10},/obj/effect/turf_decal/tile/neutral{dir = 1},/obj/effect/turf_decal/tile/neutral,/obj/effect/turf_decal/tile/neutral{dir = 4},/obj/effect/turf_decal/tile/neutral{dir = 8},/turf/open/floor/plasteel/dark,/area/shuttle/caravan/pirate)
"bGP" = (/obj/machinery/light/small{dir = 8},/obj/structure/sign/warning/vacuum{pixel_x = -32},/turf/open/floor/plating,/area/shuttle/caravan/pirate)
"cco" = (/obj/machinery/computer/shuttle/caravan/pirate{dir = 8},/obj/effect/turf_decal/tile/red{dir = 1},/obj/effect/turf_decal/tile/red{dir = 8},/turf/open/floor/plasteel/dark,/area/shuttle/caravan/pirate)
"ccZ" = (/obj/machinery/light/small{dir = 1},/obj/structure/bed,/obj/item/bedsheet/brown,/turf/open/floor/plasteel/dark,/area/shuttle/caravan/pirate)
"cmh" = (/obj/machinery/porta_turret/syndicate/pod{dir = 6; faction = list("pirate")},/turf/closed/wall/mineral/plastitanium,/area/shuttle/caravan/pirate)
"ctI" = (/obj/effect/mapping_helpers/airlock/cyclelink_helper{dir = 2},/obj/effect/mapping_helpers/airlock/locked,/obj/machinery/door/airlock/external{id_tag = "caravanpirate_bolt_port"},/obj/docking_port/mobile{callTime = 150; dir = 2; dwidth = 14; height = 13; id = "caravanpirate"; movement_force = list("KNOCKDOWN" = 0, "THROW" = 0); name = "Pirate Cutter"; port_direction = 8; preferred_direction = 4; width = 22},/obj/machinery/door/firedoor/border_only{dir = 1},/obj/machinery/door/firedoor/border_only,/turf/open/floor/plating,/area/shuttle/caravan/pirate)
"cud" = (/obj/machinery/atmospherics/pipe/simple/supply/hidden{dir = 9},/obj/machinery/firealarm{dir = 1; pixel_y = -24},/turf/open/floor/plasteel/dark,/area/shuttle/caravan/pirate)
"cRP" = (/obj/structure/table,/obj/item/reagent_containers/food/drinks/bottle/rum{pixel_x = 3; pixel_y = 6},/obj/item/reagent_containers/food/drinks/bottle/rum,/turf/open/floor/plasteel/dark,/area/shuttle/caravan/pirate)
"cUd" = (/obj/structure/table/reinforced,/obj/machinery/button/door{id = "caravanpirate_bridge"; name = "Bridge Blast Door Control"; pixel_x = -16},/obj/effect/turf_decal/tile/red,/obj/effect/turf_decal/tile/red{dir = 8},/turf/open/floor/plasteel/dark,/area/shuttle/caravan/pirate)
"dHu" = (/obj/structure/cable,/obj/machinery/power/port_gen/pacman{anchored = 1},/obj/item/wrench,/obj/effect/turf_decal/stripes/line{dir = 6},/turf/open/floor/plating,/area/shuttle/caravan/pirate)
"dNP" = (/obj/structure/closet/crate/secure/loot,/obj/machinery/airalarm/all_access{pixel_y = 24},/turf/open/floor/plasteel/dark,/area/shuttle/caravan/pirate)
"dQg" = (/obj/structure/grille,/obj/structure/window/plastitanium,/obj/machinery/door/poddoor{id = "caravanpirate_bridge"},/obj/machinery/door/firedoor/border_only{dir = 1},/obj/machinery/door/firedoor/border_only{dir = 8},/turf/open/floor/plating,/area/shuttle/caravan/pirate)
"ere" = (/obj/machinery/atmospherics/pipe/simple/supply/hidden{dir = 5},/turf/open/floor/plating,/area/shuttle/caravan/pirate)
"eDU" = (/obj/structure/rack,/obj/item/storage/toolbox/emergency,/obj/item/weldingtool,/obj/effect/turf_decal/tile/red{dir = 4},/turf/open/floor/plasteel/dark,/area/shuttle/caravan/pirate)
"eGJ" = (/obj/machinery/atmospherics/components/unary/tank/air,/obj/effect/turf_decal/bot,/turf/open/floor/plating,/area/shuttle/caravan/pirate)
"eVW" = (/obj/structure/sign/departments/medbay/alt,/turf/closed/wall/mineral/plastitanium/nodiagonal,/area/shuttle/caravan/pirate)
"fOZ" = (/mob/living/simple_animal/hostile/pirate{environment_smash = 0},/turf/open/floor/plasteel,/area/shuttle/caravan/pirate)
"gSN" = (/obj/structure/table/reinforced,/obj/machinery/recharger,/obj/item/melee/classic_baton,/obj/effect/turf_decal/tile/red,/turf/open/floor/plasteel/dark,/area/shuttle/caravan/pirate)
"gSV" = (/obj/machinery/atmospherics/pipe/simple/supply/hidden{dir = 4},/obj/effect/turf_decal/tile/red{dir = 1},/obj/effect/turf_decal/tile/red,/obj/effect/turf_decal/tile/red{dir = 8},/turf/open/floor/plasteel,/area/shuttle/caravan/pirate)
"gTK" = (/obj/structure/table,/obj/machinery/door/window/southleft{base_state = "right"; icon_state = "right"; name = "Weapon Storage"},/obj/item/gun/energy/laser,/obj/effect/turf_decal/tile/neutral{dir = 1},/obj/effect/turf_decal/tile/neutral,/obj/effect/turf_decal/tile/neutral{dir = 4},/obj/effect/turf_decal/tile/neutral{dir = 8},/turf/open/floor/plasteel/dark,/area/shuttle/caravan/pirate)
"hcd" = (/obj/machinery/atmospherics/pipe/simple/supply/hidden,/obj/effect/turf_decal/tile/neutral{dir = 1},/obj/effect/turf_decal/tile/neutral,/obj/effect/turf_decal/tile/neutral{dir = 4},/obj/effect/turf_decal/tile/neutral{dir = 8},/turf/open/floor/plasteel/dark,/area/shuttle/caravan/pirate)
"hgp" = (/obj/machinery/sleeper{dir = 1},/obj/effect/turf_decal/delivery,/obj/machinery/airalarm/all_access{dir = 1; pixel_y = -24},/turf/open/floor/plasteel/white,/area/shuttle/caravan/pirate)
"hqg" = (/obj/structure/closet{name = "pirate outfits"},/obj/item/clothing/head/collectable/pirate,/obj/item/clothing/suit/pirate,/obj/item/clothing/under/pirate,/obj/item/clothing/shoes/jackboots,/obj/item/clothing/head/bandana,/obj/effect/turf_decal/tile/red{dir = 1},/turf/open/floor/plasteel/dark,/area/shuttle/caravan/pirate)
"hBC" = (/obj/machinery/atmospherics/components/unary/vent_pump/on,/obj/effect/decal/cleanable/dirt,/turf/open/floor/plasteel,/area/shuttle/caravan/pirate)
"hDS" = (/obj/machinery/button/door{id = "caravanpirate_bolt_port"; name = "External Bolt Control"; normaldoorcontrol = 1; pixel_x = -4; pixel_y = 25; specialfunctions = 4},/obj/machinery/atmospherics/pipe/simple/supply/hidden{dir = 4},/turf/open/floor/plasteel/white/side{dir = 1},/area/shuttle/caravan/pirate)
"hTK" = (/obj/structure/grille,/obj/structure/window/plastitanium,/obj/machinery/door/poddoor{id = "caravanpirate_bridge"},/turf/open/floor/plating,/area/shuttle/caravan/pirate)
"ibw" = (/obj/machinery/button/door{id = "caravanpirate_bolt_starboard"; name = "External Bolt Control"; normaldoorcontrol = 1; pixel_x = -4; pixel_y = -25; specialfunctions = 4},/obj/machinery/atmospherics/pipe/simple/supply/hidden{dir = 4},/obj/effect/turf_decal/tile/red,/obj/effect/turf_decal/tile/red{dir = 8},/turf/open/floor/plasteel,/area/shuttle/caravan/pirate)
"ifF" = (/obj/structure/closet{name = "pirate outfits"},/obj/item/clothing/head/collectable/pirate,/obj/item/clothing/suit/pirate,/obj/item/clothing/under/pirate,/obj/item/clothing/shoes/jackboots,/obj/item/clothing/head/bandana,/turf/open/floor/plasteel/dark/side{dir = 5},/area/shuttle/caravan/pirate)
"ipr" = (/obj/structure/table,/obj/item/storage/fancy/donut_box{pixel_y = 18},/obj/item/storage/box/donkpockets{pixel_x = -3; pixel_y = 7},/obj/item/storage/box/donkpockets{pixel_x = -6},/obj/item/reagent_containers/food/drinks/bottle/rum{pixel_x = 8; pixel_y = 3},/obj/structure/sign/poster/contraband/red_rum{pixel_x = 32},/turf/open/floor/plasteel/dark,/area/shuttle/caravan/pirate)
"iul" = (/obj/structure/grille,/obj/structure/window/plastitanium,/obj/machinery/door/poddoor{id = "caravanpirate_bridge"},/obj/machinery/door/firedoor/border_only{dir = 4},/turf/open/floor/plating,/area/shuttle/caravan/pirate)
"iva" = (/obj/structure/shuttle/engine/propulsion/burst{dir = 8},/turf/open/floor/plating/airless,/area/shuttle/caravan/pirate)
"iFC" = (/obj/item/stack/sheet/mineral/gold{amount = 25},/obj/item/stack/sheet/mineral/bananium{amount = 5},/obj/item/stack/sheet/mineral/silver{amount = 25},/obj/item/stack/sheet/mineral/uranium{amount = 10},/obj/item/stack/sheet/mineral/diamond{amount = 5},/obj/structure/closet/crate,/obj/item/coin/silver,/obj/item/coin/silver,/obj/item/coin/silver,/obj/item/coin/gold,/obj/item/coin/gold,/obj/effect/turf_decal/tile/blue,/turf/open/floor/plasteel/dark,/area/shuttle/caravan/pirate)
"iIP" = (/obj/structure/table,/obj/item/circular_saw,/obj/item/scalpel{pixel_y = 12},/obj/item/cautery{pixel_x = 4},/obj/machinery/light/small{dir = 8},/turf/open/floor/plasteel/white/side{dir = 8},/area/shuttle/caravan/pirate)
"jpH" = (/obj/machinery/atmospherics/pipe/simple/supply/hidden{dir = 4},/obj/effect/turf_decal/tile/red{dir = 1},/obj/effect/turf_decal/tile/red{dir = 8},/turf/open/floor/plasteel/dark,/area/shuttle/caravan/pirate)
"jra" = (/turf/closed/wall/mineral/plastitanium,/area/shuttle/caravan/pirate)
"jrq" = (/obj/machinery/atmospherics/pipe/simple/supply/hidden{dir = 4},/turf/open/floor/plasteel/white/side{dir = 1},/area/shuttle/caravan/pirate)
"jwY" = (/obj/structure/table,/obj/machinery/light/small{brightness = 3; dir = 8},/obj/item/stack/spacecash/c200,/turf/open/floor/plasteel/dark,/area/shuttle/caravan/pirate)
"jLx" = (/obj/structure/cable/yellow{icon_state = "1-8"},/obj/machinery/atmospherics/pipe/simple/supply/hidden,/turf/open/floor/plating,/area/shuttle/caravan/pirate)
"kbu" = (/obj/structure/shuttle/engine/propulsion/burst/left{dir = 8},/turf/open/floor/plating/airless,/area/shuttle/caravan/pirate)
"kcw" = (/obj/structure/reagent_dispensers/watertank,/obj/item/reagent_containers/glass/bucket,/obj/item/mop,/obj/effect/turf_decal/stripes/line{dir = 5},/turf/open/floor/plating,/area/shuttle/caravan/pirate)
"kfF" = (/obj/machinery/atmospherics/pipe/simple/supply/hidden{dir = 4},/obj/effect/turf_decal/tile/blue,/obj/effect/turf_decal/tile/blue{dir = 4},/turf/open/floor/plasteel/dark,/area/shuttle/caravan/pirate)
"kor" = (/obj/machinery/porta_turret/syndicate/pod{dir = 5; faction = list("pirate")},/turf/closed/wall/mineral/plastitanium,/area/shuttle/caravan/pirate)
"ktJ" = (/obj/machinery/atmospherics/pipe/simple/supply/hidden{dir = 9},/obj/effect/turf_decal/tile/neutral{dir = 1},/obj/effect/turf_decal/tile/neutral,/obj/effect/turf_decal/tile/neutral{dir = 4},/obj/effect/turf_decal/tile/neutral{dir = 8},/turf/open/floor/plasteel/dark,/area/shuttle/caravan/pirate)
"lbp" = (/obj/machinery/atmospherics/pipe/manifold/supply/hidden{dir = 1},/turf/open/floor/plasteel/white/side{dir = 1},/area/shuttle/caravan/pirate)
"ldd" = (/obj/structure/grille,/obj/structure/window/plastitanium,/obj/machinery/door/poddoor{id = "caravanpirate_bridge"},/obj/machinery/door/firedoor/border_only{dir = 4},/obj/machinery/door/firedoor/border_only{dir = 8},/turf/open/floor/plating,/area/shuttle/caravan/pirate)
"lwG" = (/obj/structure/closet/crate/freezer/surplus_limbs,/obj/effect/turf_decal/bot,/turf/open/floor/plasteel/white,/area/shuttle/caravan/pirate)
"lBq" = (/obj/effect/mapping_helpers/airlock/cyclelink_helper{dir = 1},/obj/effect/mapping_helpers/airlock/locked,/obj/machinery/door/airlock/external{id_tag = "caravanpirate_bolt_starboard"},/obj/machinery/door/firedoor/border_only{dir = 1},/obj/machinery/door/firedoor/border_only,/turf/open/floor/plating,/area/shuttle/caravan/pirate)
"lKQ" = (/obj/machinery/light/small{dir = 4},/obj/machinery/atmospherics/pipe/simple/supply/hidden{dir = 9},/obj/effect/turf_decal/tile/red,/obj/effect/turf_decal/tile/red{dir = 8},/turf/open/floor/plasteel,/area/shuttle/caravan/pirate)
"lNo" = (/obj/structure/table,/obj/machinery/airalarm/all_access{pixel_y = 24},/obj/item/ammo_box/a40mm,/obj/effect/turf_decal/tile/neutral{dir = 1},/obj/effect/turf_decal/tile/neutral,/obj/effect/turf_decal/tile/neutral{dir = 4},/obj/effect/turf_decal/tile/neutral{dir = 8},/turf/open/floor/plasteel/dark,/area/shuttle/caravan/pirate)
"lXS" = (/obj/machinery/porta_turret/syndicate/pod{dir = 10; faction = list("pirate")},/turf/closed/wall/mineral/plastitanium,/area/shuttle/caravan/pirate)
"mcc" = (/obj/structure/table,/obj/item/retractor,/obj/item/hemostat,/turf/open/floor/plasteel/white,/area/shuttle/caravan/pirate)
"mlv" = (/obj/machinery/light/small{dir = 4},/obj/machinery/atmospherics/pipe/simple/supply/hidden{dir = 10},/turf/open/floor/plasteel/white/side{dir = 1},/area/shuttle/caravan/pirate)
"muO" = (/obj/machinery/atmospherics/pipe/manifold/supply/hidden{dir = 4},/turf/open/floor/plating,/area/shuttle/caravan/pirate)
"muZ" = (/obj/structure/bed,/obj/item/bedsheet/brown,/obj/machinery/firealarm{dir = 8; pixel_x = -26},/turf/open/floor/plasteel/dark/side{dir = 6},/area/shuttle/caravan/pirate)
"mRG" = (/obj/machinery/atmospherics/components/unary/vent_pump/on{dir = 1},/turf/open/floor/plasteel,/area/shuttle/caravan/pirate)
"njR" = (/obj/machinery/power/smes{charge = 5e+006},/obj/structure/cable/yellow{icon_state = "0-4"},/obj/effect/turf_decal/stripes/line{dir = 5},/turf/open/floor/plating,/area/shuttle/caravan/pirate)
"nOv" = (/obj/structure/reagent_dispensers/fueltank,/obj/effect/turf_decal/stripes/line{dir = 4},/turf/open/floor/plating,/area/shuttle/caravan/pirate)
"nPD" = (/obj/structure/table,/obj/machinery/cell_charger,/obj/item/stack/cable_coil/yellow,/obj/item/stock_parts/cell/high,/obj/effect/turf_decal/bot,/turf/open/floor/plating,/area/shuttle/caravan/pirate)
"nRY" = (/obj/machinery/atmospherics/pipe/simple/supply/hidden{dir = 5},/obj/effect/decal/cleanable/dirt,/turf/open/floor/plasteel,/area/shuttle/caravan/pirate)
"nTe" = (/turf/closed/wall/mineral/plastitanium/nodiagonal,/area/shuttle/caravan/pirate)
"odL" = (/obj/structure/table/optable,/obj/effect/turf_decal/bot,/turf/open/floor/plasteel/white,/area/shuttle/caravan/pirate)
"ohi" = (/obj/machinery/suit_storage_unit/open,/obj/effect/turf_decal/tile/neutral{dir = 1},/obj/effect/turf_decal/tile/neutral,/obj/effect/turf_decal/tile/neutral{dir = 4},/obj/effect/turf_decal/tile/neutral{dir = 8},/turf/open/floor/plasteel/dark,/area/shuttle/caravan/pirate)
"osh" = (/obj/effect/decal/cleanable/dirt,/turf/open/floor/plasteel,/area/shuttle/caravan/pirate)
"osS" = (/obj/structure/cable/yellow{icon_state = "0-2"},/obj/machinery/power/apc{dir = 8; name = "Pirate Cutter APC"; pixel_x = -25; req_access = null},/obj/machinery/atmospherics/pipe/simple/supply/hidden,/obj/machinery/airalarm/all_access{dir = 8; pixel_x = 24},/turf/open/floor/plating,/area/shuttle/caravan/pirate)
"oGo" = (/obj/machinery/porta_turret/syndicate/pod{dir = 9; faction = list("pirate")},/turf/closed/wall/mineral/plastitanium,/area/shuttle/caravan/pirate)
"oYN" = (/obj/machinery/light/small,/obj/structure/bed,/obj/item/bedsheet/brown,/turf/open/floor/plasteel/dark,/area/shuttle/caravan/pirate)
"pkY" = (/obj/machinery/computer/camera_advanced/shuttle_docker/caravan/pirate,/obj/effect/turf_decal/tile/red{dir = 1},/obj/effect/turf_decal/tile/red{dir = 4},/turf/open/floor/plasteel/dark,/area/shuttle/caravan/pirate)
"pnj" = (/obj/machinery/atmospherics/pipe/simple/supply/hidden{dir = 4},/turf/open/floor/plasteel/white/side{dir = 9},/area/shuttle/caravan/pirate)
"pAO" = (/obj/machinery/atmospherics/pipe/simple/supply/hidden{dir = 4},/obj/machinery/door/firedoor,/obj/machinery/door/airlock/engineering{name = "Engineering"},/obj/machinery/door/firedoor/border_only{dir = 4},/obj/machinery/door/firedoor/border_only{dir = 8},/turf/open/floor/plating,/area/shuttle/caravan/pirate)
"pBC" = (/obj/structure/grille,/obj/structure/window/plastitanium,/obj/machinery/door/poddoor{id = "caravanpirate_bridge"},/obj/machinery/door/firedoor/border_only,/obj/machinery/door/firedoor/border_only{dir = 8},/turf/open/floor/plating,/area/shuttle/caravan/pirate)
"pEX" = (/obj/machinery/atmospherics/components/unary/vent_pump/on,/obj/effect/turf_decal/tile/neutral{dir = 1},/obj/effect/turf_decal/tile/neutral,/obj/effect/turf_decal/tile/neutral{dir = 4},/obj/effect/turf_decal/tile/neutral{dir = 8},/turf/open/floor/plasteel/dark,/area/shuttle/caravan/pirate)
"pHk" = (/obj/structure/table,/obj/item/storage/box/lethalshot,/obj/effect/turf_decal/tile/neutral{dir = 1},/obj/effect/turf_decal/tile/neutral,/obj/effect/turf_decal/tile/neutral{dir = 4},/obj/effect/turf_decal/tile/neutral{dir = 8},/turf/open/floor/plasteel/dark,/area/shuttle/caravan/pirate)
"pOJ" = (/obj/structure/sign/departments/engineering,/turf/closed/wall/mineral/plastitanium/nodiagonal,/area/shuttle/caravan/pirate)
"pWh" = (/obj/machinery/atmospherics/pipe/simple/supply/hidden{dir = 4},/obj/machinery/door/firedoor,/obj/machinery/door/airlock/command{name = "Bridge"},/obj/effect/turf_decal/tile/neutral{dir = 1},/obj/effect/turf_decal/tile/neutral,/obj/effect/turf_decal/tile/neutral{dir = 4},/obj/effect/turf_decal/tile/neutral{dir = 8},/obj/machinery/door/firedoor/border_only{dir = 4},/obj/machinery/door/firedoor/border_only{dir = 8},/turf/open/floor/plasteel/dark,/area/shuttle/caravan/pirate)
"pWC" = (/obj/machinery/power/terminal{dir = 1},/obj/structure/cable{icon_state = "0-2"},/obj/structure/closet/crate,/obj/item/stack/sheet/metal/twenty,/obj/item/stack/sheet/glass{amount = 10},/obj/item/storage/toolbox/mechanical,/obj/item/flashlight{pixel_x = 3; pixel_y = 3},/obj/item/stack/sheet/mineral/plasma{amount = 20},/obj/effect/turf_decal/stripes/line{dir = 4},/turf/open/floor/plating,/area/shuttle/caravan/pirate)
"pZc" = (/obj/structure/grille,/obj/structure/window/plastitanium,/obj/machinery/door/poddoor{id = "caravanpirate_bridge"},/obj/machinery/door/firedoor/border_only{dir = 1},/turf/open/floor/plating,/area/shuttle/caravan/pirate)
"qfC" = (/obj/machinery/light/small{dir = 8},/obj/structure/closet/crate/secure/loot,/obj/machinery/atmospherics/components/unary/vent_pump/on{dir = 4},/obj/structure/extinguisher_cabinet{pixel_x = -27},/turf/open/floor/plasteel/dark,/area/shuttle/caravan/pirate)
"qPZ" = (/obj/structure/table,/obj/item/coin/gold,/obj/item/coin/silver,/obj/item/coin/silver,/turf/open/floor/plasteel/dark,/area/shuttle/caravan/pirate)
"rcV" = (/obj/structure/bed,/obj/item/bedsheet/brown,/obj/machinery/airalarm/all_access{dir = 4; pixel_x = -24},/obj/effect/turf_decal/tile/red{dir = 8},/turf/open/floor/plasteel/dark,/area/shuttle/caravan/pirate)
"rgd" = (/obj/structure/tank_dispenser/oxygen,/obj/machinery/firealarm{dir = 2; pixel_y = 24},/obj/effect/turf_decal/tile/neutral{dir = 1},/obj/effect/turf_decal/tile/neutral,/obj/effect/turf_decal/tile/neutral{dir = 4},/obj/effect/turf_decal/tile/neutral{dir = 8},/turf/open/floor/plasteel/dark,/area/shuttle/caravan/pirate)
"rCv" = (/obj/machinery/atmospherics/pipe/simple/supply/hidden{dir = 4},/obj/effect/turf_decal/tile/red,/obj/effect/turf_decal/tile/red{dir = 8},/turf/open/floor/plasteel,/area/shuttle/caravan/pirate)
"rNX" = (/obj/structure/table,/obj/machinery/microwave{pixel_y = 5},/turf/open/floor/plasteel/dark,/area/shuttle/caravan/pirate)
"sfK" = (/obj/machinery/atmospherics/pipe/simple/supply/hidden{dir = 6},/obj/effect/decal/cleanable/dirt,/turf/open/floor/plasteel,/area/shuttle/caravan/pirate)
"sVG" = (/obj/structure/chair/office/dark{dir = 4},/obj/machinery/turretid{icon_state = "control_kill"; lethal = 1; locked = 0; pixel_y = -30; req_access = null},/mob/living/simple_animal/hostile/pirate/ranged{environment_smash = 0},/obj/effect/turf_decal/tile/neutral{dir = 1},/obj/effect/turf_decal/tile/neutral,/obj/effect/turf_decal/tile/neutral{dir = 4},/obj/effect/turf_decal/tile/neutral{dir = 8},/turf/open/floor/plasteel/dark,/area/shuttle/caravan/pirate)
"taU" = (/obj/structure/table,/obj/item/storage/firstaid/brute{pixel_x = 3; pixel_y = 3},/obj/item/storage/firstaid/fire,/obj/machinery/firealarm{dir = 1; pixel_y = -24},/turf/open/floor/plasteel/white,/area/shuttle/caravan/pirate)
"tis" = (/obj/effect/mapping_helpers/airlock/cyclelink_helper{dir = 1},/obj/effect/mapping_helpers/airlock/locked,/obj/machinery/door/airlock/external{id_tag = "caravanpirate_bolt_port"},/obj/machinery/door/firedoor/border_only{dir = 1},/obj/machinery/door/firedoor/border_only,/turf/open/floor/plating,/area/shuttle/caravan/pirate)
"tLJ" = (/obj/structure/rack,/obj/item/storage/bag/money/vault,/mob/living/simple_animal/parrot{faction = list("pirate"); name = "Pegwing"},/obj/effect/turf_decal/tile/blue{dir = 4},/turf/open/floor/plasteel/dark,/area/shuttle/caravan/pirate)
"ucW" = (/obj/machinery/atmospherics/pipe/manifold/supply/hidden,/obj/effect/turf_decal/tile/red,/obj/effect/turf_decal/tile/red{dir = 8},/turf/open/floor/plasteel,/area/shuttle/caravan/pirate)
"ujb" = (/obj/structure/chair/office/dark{dir = 8},/obj/effect/turf_decal/tile/neutral{dir = 1},/obj/effect/turf_decal/tile/neutral,/obj/effect/turf_decal/tile/neutral{dir = 4},/obj/effect/turf_decal/tile/neutral{dir = 8},/turf/open/floor/plasteel/dark,/area/shuttle/caravan/pirate)
"uxx" = (/obj/structure/shuttle/engine/propulsion/burst/right{dir = 8},/turf/open/floor/plating/airless,/area/shuttle/caravan/pirate)
"uHy" = (/obj/machinery/atmospherics/pipe/simple/supply/hidden{dir = 4},/turf/open/floor/plasteel/dark/side{dir = 4},/area/shuttle/caravan/pirate)
"uJK" = (/obj/effect/mapping_helpers/airlock/cyclelink_helper{dir = 2},/obj/effect/mapping_helpers/airlock/locked,/obj/machinery/door/airlock/external{id_tag = "caravanpirate_bolt_starboard"},/obj/machinery/door/firedoor/border_only{dir = 1},/obj/machinery/door/firedoor/border_only,/turf/open/floor/plating,/area/shuttle/caravan/pirate)
"uQB" = (/obj/machinery/atmospherics/pipe/simple/supply/hidden{dir = 4},/obj/machinery/door/firedoor,/obj/machinery/door/airlock/security{name = "Armory"},/obj/effect/decal/cleanable/dirt,/obj/machinery/door/firedoor/border_only{dir = 4},/obj/machinery/door/firedoor/border_only{dir = 8},/turf/open/floor/plasteel,/area/shuttle/caravan/pirate)
"vUF" = (/obj/machinery/atmospherics/pipe/manifold/supply/hidden{dir = 4},/obj/effect/turf_decal/tile/neutral{dir = 1},/obj/effect/turf_decal/tile/neutral,/obj/effect/turf_decal/tile/neutral{dir = 4},/obj/effect/turf_decal/tile/neutral{dir = 8},/turf/open/floor/plasteel/dark,/area/shuttle/caravan/pirate)
"wpo" = (/mob/living/simple_animal/hostile/pirate/ranged{environment_smash = 0},/obj/effect/decal/cleanable/dirt,/turf/open/floor/plasteel,/area/shuttle/caravan/pirate)
"wML" = (/obj/machinery/atmospherics/pipe/simple/supply/hidden{dir = 4},/turf/open/floor/plasteel/dark,/area/shuttle/caravan/pirate)
"wYb" = (/obj/machinery/atmospherics/pipe/manifold/supply/hidden{dir = 8},/obj/effect/turf_decal/tile/neutral{dir = 1},/obj/effect/turf_decal/tile/neutral,/obj/effect/turf_decal/tile/neutral{dir = 4},/obj/effect/turf_decal/tile/neutral{dir = 8},/turf/open/floor/plasteel/dark,/area/shuttle/caravan/pirate)
"xeP" = (/obj/structure/shuttle/engine/heater{dir = 8},/obj/structure/window/reinforced{dir = 4},/turf/open/floor/plating/airless,/area/shuttle/caravan/pirate)
"xfj" = (/obj/machinery/atmospherics/pipe/manifold/supply/hidden{dir = 8},/obj/machinery/meter,/turf/open/floor/plating,/area/shuttle/caravan/pirate)
"xCZ" = (/obj/structure/table,/obj/structure/window/reinforced{dir = 8},/obj/machinery/door/window/southleft{name = "Weapon Storage"},/obj/item/grenade/smokebomb{pixel_x = -4},/obj/item/grenade/smokebomb{pixel_x = 2},/obj/effect/turf_decal/tile/neutral{dir = 1},/obj/effect/turf_decal/tile/neutral,/obj/effect/turf_decal/tile/neutral{dir = 4},/obj/effect/turf_decal/tile/neutral{dir = 8},/turf/open/floor/plasteel/dark,/area/shuttle/caravan/pirate)
"xDU" = (/obj/machinery/light/small{dir = 8},/obj/effect/turf_decal/tile/red{dir = 1},/obj/effect/turf_decal/tile/red{dir = 8},/turf/open/floor/plasteel,/area/shuttle/caravan/pirate)

(1,1,1) = {"
arG
arG
arG
kbu
iva
uxx
arG
kbu
iva
uxx
arG
arG
arG
"}
(2,1,1) = {"
arG
arG
jra
xeP
xeP
xeP
nTe
xeP
xeP
xeP
jra
arG
arG
"}
(3,1,1) = {"
arG
oGo
nTe
kcw
nOv
bln
nTe
njR
pWC
dHu
nTe
lXS
arG
"}
(4,1,1) = {"
arG
nTe
eGJ
xfj
aFk
muO
osS
jLx
aFk
ere
nPD
nTe
arG
"}
(5,1,1) = {"
arG
nTe
nTe
pAO
pOJ
nTe
nTe
nTe
pOJ
pAO
nTe
nTe
arG
"}
(6,1,1) = {"
arG
nTe
ohi
pnj
iIP
mcc
nTe
pHk
xDU
gSV
ohi
nTe
arG
"}
(7,1,1) = {"
jra
nTe
nTe
jrq
osh
odL
nTe
lNo
wpo
rCv
nTe
nTe
jra
"}
(8,1,1) = {"
ctI
bGP
tis
lbp
mRG
taU
nTe
rgd
hBC
ucW
uJK
bGP
lBq
"}
(9,1,1) = {"
jra
nTe
nTe
hDS
osh
hgp
nTe
xCZ
fOZ
ibw
nTe
nTe
jra
"}
(10,1,1) = {"
arG
aZA
ohi
mlv
nRY
lwG
nTe
gTK
sfK
lKQ
ohi
pZc
arG
"}
(11,1,1) = {"
arG
jra
nTe
eVW
aAv
nTe
nTe
nTe
uQB
nTe
nTe
jra
arG
"}
(12,1,1) = {"
arG
arG
nTe
ifF
uHy
muZ
qfC
rcV
jpH
hqg
nTe
arG
arG
"}
(13,1,1) = {"
arG
arG
nTe
ccZ
bmO
hcd
vUF
wYb
ktJ
oYN
nTe
arG
arG
"}
(14,1,1) = {"
arG
arG
kor
nTe
rNX
ipr
iFC
kfF
tLJ
nTe
cmh
arG
arG
"}
(15,1,1) = {"
arG
arG
arG
jra
nTe
nTe
nTe
pWh
nTe
jra
arG
arG
arG
"}
(16,1,1) = {"
arG
arG
arG
arG
nTe
cRP
jwY
wML
nTe
arG
arG
arG
arG
"}
(17,1,1) = {"
arG
arG
arG
arG
nTe
qPZ
ujb
wML
nTe
arG
arG
arG
arG
"}
(18,1,1) = {"
arG
arG
arG
arG
nTe
dNP
pEX
cud
nTe
arG
arG
arG
arG
"}
(19,1,1) = {"
arG
arG
arG
arG
nTe
eDU
acc
gSN
nTe
arG
arG
arG
arG
"}
(20,1,1) = {"
arG
arG
arG
arG
aZA
pkY
sVG
cUd
pZc
arG
arG
arG
arG
"}
(21,1,1) = {"
arG
arG
arG
arG
hTK
pBC
cco
dQg
hTK
arG
arG
arG
arG
"}
(22,1,1) = {"
arG
arG
arG
arG
arG
iul
ldd
iul
arG
arG
arG
arG
arG
"}
