//MAP CONVERTED BY dmm2tgm.py THIS HEADER COMMENT PREVENTS RECONVERSION, DO NOT REMOVE
"a" = (
/obj/effect/spawner/structure/window/ice,
/obj/machinery/door/firedoor/border_only{
	dir = 1
	},
/turf/open/floor/plating,
/area/shuttle/snowdin/elevator1)
"b" = (
/obj/machinery/door/airlock/public/glass{
	name = "Elevator Access"
	},
/obj/machinery/door/firedoor/border_only{
	dir = 1
	},
/obj/machinery/door/firedoor/border_only,
/turf/open/floor/plating,
/area/shuttle/snowdin/elevator1)
"c" = (
/obj/effect/spawner/structure/window/ice,
/obj/machinery/door/firedoor/border_only{
	dir = 8
	},
/turf/open/floor/plating,
/area/shuttle/snowdin/elevator1)
"d" = (
/turf/closed/wall/ice,
/area/shuttle/snowdin/elevator1)
"e" = (
/turf/open/floor/engine,
/area/shuttle/snowdin/elevator1)
"f" = (
/obj/machinery/computer/shuttle/snowdin/mining{
	dir = 2;
	name = "Excavation Elevator Console";
	possible_destinations = "snowdin_excavation_top;snowdin_excavation_down";
	shuttleId = "snowdin_excavation"
	},
/turf/open/floor/engine,
/area/shuttle/snowdin/elevator1)
"g" = (
/obj/effect/spawner/structure/window/ice,
/obj/machinery/door/firedoor/border_only{
	dir = 4
	},
/turf/open/floor/plating,
/area/shuttle/snowdin/elevator1)
"h" = (
/obj/machinery/door/airlock/public/glass{
	name = "Elevator Access"
	},
/obj/machinery/door/firedoor/border_only{
	dir = 4
	},
/obj/machinery/door/firedoor/border_only{
	dir = 8
	},
/turf/open/floor/plating,
/area/shuttle/snowdin/elevator1)
"i" = (
/obj/machinery/door/airlock/public/glass{
	name = "Elevator Access"
	},
/obj/docking_port/mobile/elevator{
	dir = 4;
	height = 6;
	shuttle_id = "snowdin_excavation";
	name = "excavation elevator";
	width = 6
	},
/obj/machinery/door/firedoor/border_only{
	dir = 4
	},
/obj/machinery/door/firedoor/border_only{
	dir = 8
	},
/turf/open/floor/plating,
/area/shuttle/snowdin/elevator1)
"j" = (
/obj/effect/spawner/structure/window/ice,
/obj/machinery/door/firedoor/border_only,
/turf/open/floor/plating,
/area/shuttle/snowdin/elevator1)

(1,1,1) = {"
d
c
h
i
c
d
"}
(2,1,1) = {"
a
e
e
e
e
j
"}
(3,1,1) = {"
b
e
e
e
e
b
"}
(4,1,1) = {"
b
e
e
e
e
b
"}
(5,1,1) = {"
a
f
e
e
e
j
"}
(6,1,1) = {"
d
g
h
h
g
d
"}
