//MAP CONVERTED BY dmm2tgm.py THIS HEADER COMMENT PREVENTS RECONVERSION, DO NOT REMOVE
"a" = (
/obj/machinery/door/airlock/public/glass{
	name = "Elevator Access"
	},
/obj/docking_port/mobile/elevator{
	dir = 4;
	dwidth = 2;
	height = 5;
	shuttle_id = "snowdin_mining";
	name = "mining elevator";
	width = 5
	},
/obj/machinery/door/firedoor/border_only{
	dir = 4
	},
/obj/machinery/door/firedoor/border_only{
	dir = 8
	},
/turf/open/floor/plating,
/area/shuttle/snowdin/elevator2)
"b" = (
/obj/effect/spawner/structure/window/reinforced,
/obj/machinery/door/firedoor/border_only{
	dir = 1
	},
/turf/open/floor/plating,
/area/shuttle/snowdin/elevator2)
"c" = (
/obj/machinery/door/airlock/public/glass{
	name = "Elevator Access"
	},
/obj/machinery/door/firedoor/border_only{
	dir = 1
	},
/obj/machinery/door/firedoor/border_only,
/turf/open/floor/plating,
/area/shuttle/snowdin/elevator2)
"d" = (
/turf/closed/wall,
/area/shuttle/snowdin/elevator2)
"e" = (
/obj/machinery/computer/shuttle/snowdin/mining,
/turf/open/floor/engine,
/area/shuttle/snowdin/elevator2)
"f" = (
/turf/open/floor/engine,
/area/shuttle/snowdin/elevator2)
"g" = (
/obj/machinery/light/small{
	dir = 1
	},
/turf/open/floor/engine,
/area/shuttle/snowdin/elevator2)
"h" = (
/obj/effect/spawner/structure/window/reinforced,
/obj/machinery/door/firedoor/border_only{
	dir = 8
	},
/turf/open/floor/plating,
/area/shuttle/snowdin/elevator2)
"i" = (
/obj/machinery/light/small,
/turf/open/floor/engine,
/area/shuttle/snowdin/elevator2)
"j" = (
/turf/closed/wall/rust,
/area/shuttle/snowdin/elevator2)
"k" = (
/obj/effect/spawner/structure/window/reinforced,
/obj/machinery/door/firedoor/border_only{
	dir = 4
	},
/turf/open/floor/plating,
/area/shuttle/snowdin/elevator2)
"l" = (
/obj/effect/spawner/structure/window/reinforced,
/obj/machinery/door/firedoor/border_only,
/turf/open/floor/plating,
/area/shuttle/snowdin/elevator2)
"q" = (
/obj/machinery/door/airlock/public/glass{
	name = "Elevator Access"
	},
/obj/machinery/door/firedoor/border_only{
	dir = 4
	},
/obj/machinery/door/firedoor/border_only{
	dir = 8
	},
/turf/open/floor/plating,
/area/shuttle/snowdin/elevator2)

(1,1,1) = {"
j
h
a
h
d
"}
(2,1,1) = {"
b
e
f
i
l
"}
(3,1,1) = {"
c
f
f
f
c
"}
(4,1,1) = {"
b
g
f
f
l
"}
(5,1,1) = {"
d
k
q
k
j
"}
