// This map has been converted using maphash
"arG" = (/turf/template_noop,/area/template_noop)
"aXu" = (/turf/closed/wall/mineral/titanium,/area/shuttle/abandoned)
"bzj" = (/obj/structure/chair/comfy/shuttle{dir = 8},/turf/open/floor/plating/abductor,/area/shuttle/abandoned)
"guh" = (/obj/structure/shuttle/engine/propulsion/burst{dir = 1},/turf/closed/wall/mineral/titanium,/area/shuttle/abandoned)
"gQx" = (/obj/structure/chair/comfy/shuttle{dir = 4},/turf/open/floor/plating/abductor,/area/shuttle/abandoned)
"gRx" = (/obj/machinery/door/airlock/public/glass{name = "Shuttle Airlock"},/obj/machinery/door/firedoor/border_only{dir = 4},/obj/machinery/door/firedoor/border_only{dir = 8},/turf/open/floor/plasteel/dark,/area/shuttle/abandoned)
"hYr" = (/obj/structure/window/reinforced{dir = 8},/obj/structure/window/reinforced,/obj/structure/table/glass,/obj/item/tank/internals/oxygen,/obj/item/clothing/mask/breath,/obj/item/clothing/suit/space/hardsuit/engine/elite,/turf/open/floor/plating/abductor,/area/shuttle/abandoned)
"iuT" = (/obj/structure/chair/comfy/shuttle,/turf/open/floor/plating/abductor,/area/shuttle/abandoned)
"kcm" = (/obj/structure/shuttle/engine/propulsion/burst{dir = 4},/turf/closed/wall/mineral/titanium,/area/shuttle/abandoned)
"kly" = (/obj/structure/window/reinforced{dir = 4},/obj/structure/window/reinforced,/obj/structure/table/glass,/obj/item/clothing/shoes/magboots,/turf/open/floor/plating/abductor,/area/shuttle/abandoned)
"mpc" = (/obj/structure/chair/comfy/shuttle{dir = 1},/turf/open/floor/plating/abductor,/area/shuttle/abandoned)
"mBF" = (/obj/structure/shuttle/engine/propulsion/burst{dir = 8},/turf/closed/wall/mineral/titanium,/area/shuttle/abandoned)
"nsL" = (/obj/machinery/door/airlock/public/glass{name = "Shuttle Airlock"},/obj/machinery/door/firedoor/border_only{dir = 1},/obj/machinery/door/firedoor/border_only,/turf/open/floor/plasteel/dark,/area/shuttle/abandoned)
"prH" = (/turf/open/floor/plasteel,/area/shuttle/abandoned)
"qga" = (/obj/structure/window/reinforced{dir = 1; layer = 2.9},/obj/structure/window/reinforced{dir = 4},/obj/structure/table/glass,/obj/machinery/recharger,/obj/item/gun/energy/laser/retro,/turf/open/floor/plating/abductor,/area/shuttle/abandoned)
"rQE" = (/obj/machinery/door/airlock/public/glass{name = "Shuttle Airlock"},/obj/docking_port/mobile{dheight = 0; dir = 8; dwidth = 4; height = 9; id = "whiteship"; launch_status = 0; name = "White Ship"; port_direction = 4; preferred_direction = 1; width = 9},/obj/machinery/door/firedoor/border_only{dir = 4},/obj/machinery/door/firedoor/border_only{dir = 8},/turf/open/floor/plasteel/dark,/area/shuttle/abandoned)
"vEI" = (/turf/open/floor/plasteel/dark,/area/shuttle/abandoned)
"vTX" = (/obj/machinery/computer/shuttle/white_ship,/turf/open/floor/plating/abductor,/area/shuttle/abandoned)
"vXc" = (/obj/structure/shuttle/engine/propulsion/burst,/turf/closed/wall/mineral/titanium,/area/shuttle/abandoned)
"xQk" = (/obj/structure/window/reinforced{dir = 1; layer = 2.9},/obj/structure/window/reinforced{dir = 8},/obj/structure/table/glass,/obj/item/gun/medbeam,/turf/open/floor/plating/abductor,/area/shuttle/abandoned)

(1,1,1) = {"
arG
arG
aXu
mBF
gRx
mBF
aXu
arG
arG
"}
(2,1,1) = {"
arG
aXu
aXu
vEI
prH
vEI
aXu
aXu
arG
"}
(3,1,1) = {"
aXu
aXu
vEI
vEI
prH
vEI
vEI
aXu
aXu
"}
(4,1,1) = {"
guh
vEI
vEI
xQk
gQx
hYr
vEI
vEI
vXc
"}
(5,1,1) = {"
nsL
prH
prH
iuT
vTX
mpc
prH
prH
nsL
"}
(6,1,1) = {"
guh
vEI
vEI
qga
bzj
kly
vEI
vEI
vXc
"}
(7,1,1) = {"
aXu
aXu
vEI
vEI
prH
vEI
vEI
aXu
aXu
"}
(8,1,1) = {"
arG
aXu
aXu
vEI
prH
vEI
aXu
aXu
arG
"}
(9,1,1) = {"
arG
arG
aXu
kcm
rQE
kcm
aXu
arG
arG
"}
