//MAP CONVERTED BY dmm2tgm.py THIS HEADER COMMENT PREVENTS RECONVERSION, DO NOT REMOVE
"a" = (
/turf/template_noop,
/area/template_noop)
"b" = (
/obj/machinery/power/solar,
/turf/open/floor/plasteel/airless/solarpanel,
/area/template_noop)
"c" = (
/turf/template_noop,
/area/ruin/space/has_grav/syndiederelict/medbay)
"d" = (
/turf/open/floor/plating/airless,
/area/template_noop)
"e" = (
/turf/template_noop,
/area/ruin/space/has_grav/syndiederelict/kitchen)
"f" = (
/obj/machinery/atmospherics/pipe/simple/scrubbers/hidden/layer4{
	dir = 10
	},
/obj/machinery/atmospherics/pipe/simple/supply/hidden/layer2{
	dir = 10
	},
/obj/structure/cable{
	icon_state = "1-2"
	},
/obj/item/stack/cable_coil/cut/red,
/obj/item/stack/sheet/mineral/uranium,
/turf/open/floor/plating,
/area/ruin/space/has_grav/syndiederelict/engineering)
"g" = (
/obj/item/stack/cable_coil/cut/red,
/turf/open/floor/plating,
/area/ruin/space/has_grav/syndiederelict/engineering)
"h" = (
/obj/structure/window/reinforced/spawner/north,
/obj/structure/window/reinforced/spawner,
/obj/machinery/atmospherics/pipe/simple/scrubbers/hidden/layer4{
	dir = 4
	},
/obj/machinery/atmospherics/pipe/simple/supply/hidden/layer2{
	dir = 4
	},
/turf/open/floor/plating,
/area/ruin/space/has_grav/syndiederelict/engineering)
"i" = (
/obj/item/solar_assembly,
/turf/open/floor/plasteel/airless/solarpanel,
/area/template_noop)
"j" = (
/obj/structure/lattice/catwalk,
/turf/template_noop,
/area/template_noop)
"l" = (
/turf/template_noop,
/area/ruin/space/has_grav/syndiederelict/cargo)
"m" = (
/obj/machinery/atmospherics/pipe/simple/scrubbers/hidden/layer4{
	dir = 4
	},
/obj/machinery/atmospherics/pipe/simple/supply/hidden/layer2{
	dir = 4
	},
/obj/item/circuitboard/machine/rtg,
/obj/item/stack/cable_coil/cut/red,
/obj/item/stock_parts/capacitor,
/turf/open/floor/plating,
/area/ruin/space/has_grav/syndiederelict/engineering)
"n" = (
/obj/effect/spawner/structure/solars/solar_96,
/turf/open/floor/plasteel/airless/solarpanel,
/area/template_noop)
"o" = (
/obj/machinery/advanced_airlock_controller{
	req_access = list(150);
	pixel_x = 24
	},
/obj/machinery/atmospherics/components/binary/dp_vent_pump/layer2,
/obj/machinery/atmospherics/pipe/simple/scrubbers/hidden/layer4,
/obj/structure/cable{
	icon_state = "1-2"
	},
/turf/open/floor/plating,
/area/ruin/space/has_grav/syndiederelict/engineering)
"p" = (
/obj/machinery/power/tracker,
/turf/open/floor/plasteel/airless/solarpanel,
/area/template_noop)
"q" = (
/obj/machinery/atmospherics/pipe/simple/scrubbers/hidden/layer4,
/obj/machinery/atmospherics/pipe/simple/supply/hidden/layer2,
/obj/machinery/power/terminal{
	dir = 8
	},
/obj/structure/cable{
	icon_state = "0-2"
	},
/obj/structure/cable{
	icon_state = "2-4"
	},
/obj/structure/cable{
	icon_state = "1-2"
	},
/obj/item/circuitboard/machine/rtg,
/obj/item/stack/cable_coil/cut/red,
/obj/item/stock_parts/capacitor,
/turf/open/floor/plating,
/area/ruin/space/has_grav/syndiederelict/engineering)
"r" = (
/obj/structure/cable{
	icon_state = "0-8"
	},
/obj/machinery/power/rtg,
/turf/open/floor/plating,
/area/ruin/space/has_grav/syndiederelict/engineering)
"s" = (
/obj/structure/lattice/catwalk,
/obj/structure/cable{
	icon_state = "4-8"
	},
/turf/template_noop,
/area/template_noop)
"t" = (
/obj/effect/spawner/structure/solars/solar_96,
/obj/structure/cable,
/turf/open/floor/plasteel/airless/solarpanel,
/area/template_noop)
"u" = (
/obj/structure/lattice/catwalk,
/obj/structure/cable{
	icon_state = "2-8"
	},
/obj/structure/cable{
	icon_state = "1-8"
	},
/turf/template_noop,
/area/template_noop)
"v" = (
/obj/structure/lattice/catwalk,
/obj/structure/cable{
	icon_state = "4-8"
	},
/obj/structure/cable{
	icon_state = "1-4"
	},
/obj/structure/cable{
	icon_state = "2-4"
	},
/turf/template_noop,
/area/template_noop)
"w" = (
/obj/structure/lattice/catwalk,
/obj/structure/cable{
	icon_state = "1-4"
	},
/obj/structure/cable{
	icon_state = "2-4"
	},
/turf/template_noop,
/area/template_noop)
"x" = (
/obj/structure/lattice,
/obj/structure/window/reinforced/spawner,
/turf/template_noop,
/area/ruin/space/has_grav/syndiederelict/engineering)
"y" = (
/turf/template_noop,
/area/ruin/space/has_grav/syndiederelict/arrivals)
"z" = (
/obj/effect/spawner/structure/solars/solar_96,
/obj/structure/cable{
	icon_state = "0-2"
	},
/turf/open/floor/plasteel/airless/solarpanel,
/area/template_noop)
"A" = (
/obj/structure/cable{
	icon_state = "0-4"
	},
/obj/structure/frame/machine,
/turf/open/floor/plating,
/area/ruin/space/has_grav/syndiederelict/engineering)
"B" = (
/obj/machinery/power/smes/empty,
/turf/open/floor/plating,
/area/ruin/space/has_grav/syndiederelict/engineering)
"C" = (
/obj/structure/lattice/catwalk,
/obj/structure/cable{
	icon_state = "4-8"
	},
/obj/structure/cable{
	icon_state = "2-8"
	},
/obj/structure/cable{
	icon_state = "1-8"
	},
/turf/template_noop,
/area/template_noop)
"D" = (
/obj/structure/lattice/catwalk,
/obj/structure/cable{
	icon_state = "1-2"
	},
/turf/template_noop,
/area/template_noop)
"E" = (
/turf/template_noop,
/area/ruin/space/has_grav/syndiederelict/hydroponics)
"F" = (
/obj/machinery/door/airlock/external{
	req_access_txt = "150";
	name = "Solar Array Access"
	},
/obj/machinery/atmospherics/pipe/layer_manifold/visible,
/obj/structure/cable{
	icon_state = "1-2"
	},
/turf/open/floor/plating,
/area/ruin/space/has_grav/syndiederelict/engineering)
"G" = (
/obj/structure/lattice/catwalk,
/obj/structure/cable{
	icon_state = "1-2"
	},
/obj/structure/cable{
	icon_state = "1-8"
	},
/obj/structure/cable{
	icon_state = "1-4"
	},
/turf/template_noop,
/area/template_noop)
"H" = (
/obj/structure/cable{
	icon_state = "2-4"
	},
/obj/structure/cable{
	icon_state = "2-8"
	},
/obj/structure/cable{
	icon_state = "0-2"
	},
/obj/structure/frame/machine,
/turf/open/floor/plating,
/area/ruin/space/has_grav/syndiederelict/engineering)
"J" = (
/turf/template_noop,
/area/ruin/space/has_grav/syndiederelict/hallway)
"K" = (
/obj/machinery/door/airlock/external{
	req_access_txt = "150";
	name = "Solar Array Access"
	},
/obj/machinery/atmospherics/pipe/simple/scrubbers/hidden/layer4,
/obj/machinery/atmospherics/pipe/simple/supply/hidden/layer2,
/obj/structure/cable{
	icon_state = "1-2"
	},
/turf/open/floor/plating,
/area/ruin/space/has_grav/syndiederelict/engineering)
"L" = (
/obj/machinery/power/solar_control{
	dir = 1
	},
/obj/structure/cable{
	icon_state = "0-8"
	},
/turf/open/floor/plating,
/area/ruin/space/has_grav/syndiederelict/engineering)
"M" = (
/obj/machinery/door/airlock/maintenance/external/glass{
	name = "Solar Array Access"
	},
/obj/machinery/atmospherics/pipe/simple/scrubbers/hidden/layer4{
	dir = 4
	},
/obj/machinery/atmospherics/pipe/simple/supply/hidden/layer2{
	dir = 4
	},
/turf/open/floor/plating,
/area/ruin/space/has_grav/syndiederelict/engineering)
"N" = (
/turf/template_noop,
/area/ruin/space/has_grav/syndiederelict/comms)
"O" = (
/obj/structure/lattice,
/turf/template_noop,
/area/template_noop)
"P" = (
/turf/template_noop,
/area/ruin/space/has_grav/syndiederelict/engineering)
"Q" = (
/turf/open/floor/plasteel/airless/solarpanel,
/area/template_noop)
"R" = (
/obj/structure/lattice,
/obj/structure/window/reinforced/spawner/north,
/turf/template_noop,
/area/ruin/space/has_grav/syndiederelict/engineering)
"S" = (
/obj/effect/spawner/structure/window/plastitanium,
/obj/machinery/door/firedoor/window{
	desc = "A second window that slides in when the original window is broken, designed to protect against hull breaches. Truly a work of genius by Cybersun engineers."
	},
/turf/open/floor/plating,
/area/ruin/space/has_grav/syndiederelict/engineering)
"T" = (
/obj/structure/cable{
	icon_state = "0-4"
	},
/turf/open/floor/plating/airless,
/area/template_noop)
"U" = (
/obj/effect/spawner/structure/solars/solar_96,
/turf/open/floor/plating/airless,
/area/template_noop)
"V" = (
/turf/template_noop,
/area/ruin/space/has_grav/syndiederelict/vault)
"W" = (
/turf/closed/wall/mineral/plastitanium/nodiagonal,
/area/ruin/space/has_grav/syndiederelict/engineering)
"X" = (
/obj/item/solar_assembly,
/turf/template_noop,
/area/template_noop)
"Y" = (
/obj/structure/lattice/catwalk,
/obj/structure/cable{
	icon_state = "1-2"
	},
/obj/structure/cable{
	icon_state = "1-4"
	},
/obj/structure/cable{
	icon_state = "1-8"
	},
/turf/template_noop,
/area/template_noop)
"Z" = (
/turf/template_noop,
/area/ruin/space/has_grav/syndiederelict/crew)

(1,1,1) = {"
a
a
a
a
a
a
a
a
a
a
a
a
a
a
a
a
a
a
a
a
a
a
a
a
a
a
a
a
a
a
a
a
a
a
a
a
a
a
a
a
a
a
a
a
"}
(2,1,1) = {"
a
a
a
a
a
a
a
a
a
a
a
a
a
a
a
a
a
a
a
a
a
a
a
a
a
a
a
a
a
a
a
a
a
a
a
a
a
a
a
a
a
a
a
a
"}
(3,1,1) = {"
a
a
a
a
Z
Z
Z
Z
Z
Z
Z
N
N
N
N
N
N
N
N
N
N
N
N
N
l
l
l
l
l
l
l
l
l
l
l
l
l
y
y
y
y
y
y
a
"}
(4,1,1) = {"
a
a
a
a
Z
Z
Z
Z
Z
Z
Z
N
N
N
N
N
N
N
N
N
N
N
N
N
l
l
l
l
l
l
l
l
l
l
l
l
l
y
y
y
y
y
y
a
"}
(5,1,1) = {"
a
a
a
a
Z
Z
Z
Z
Z
Z
Z
N
N
N
N
N
N
N
N
N
N
N
N
N
l
l
l
l
l
l
l
l
l
l
l
l
l
y
y
y
y
y
y
a
"}
(6,1,1) = {"
a
a
a
a
Z
Z
Z
Z
Z
Z
Z
N
N
N
N
N
N
N
N
N
N
N
N
N
l
l
l
l
l
l
l
l
l
l
l
l
l
y
y
y
y
y
y
a
"}
(7,1,1) = {"
a
a
a
a
Z
Z
Z
Z
Z
Z
Z
N
N
N
N
N
N
N
N
N
N
N
N
N
l
l
l
l
l
l
l
l
l
l
l
l
l
y
y
y
y
y
y
a
"}
(8,1,1) = {"
a
a
a
a
Z
Z
Z
Z
Z
Z
Z
N
N
N
N
N
N
N
N
N
N
N
N
N
l
l
l
l
l
l
l
l
l
l
l
l
l
y
y
y
y
y
y
a
"}
(9,1,1) = {"
a
a
a
a
Z
Z
Z
Z
Z
Z
Z
J
J
J
J
J
J
J
J
J
J
J
J
J
l
l
l
l
l
l
l
l
l
l
l
l
l
y
y
y
y
y
y
a
"}
(10,1,1) = {"
a
a
a
a
Z
Z
Z
Z
Z
Z
Z
J
J
J
J
J
J
J
J
J
J
J
J
J
l
l
l
l
l
l
l
l
l
l
l
l
l
y
y
y
y
y
y
a
"}
(11,1,1) = {"
a
a
a
a
Z
Z
Z
Z
Z
Z
Z
J
J
J
J
J
J
J
J
J
J
J
J
J
l
l
l
l
l
l
l
l
l
l
l
l
l
y
y
y
y
y
y
a
"}
(12,1,1) = {"
a
a
a
a
Z
Z
Z
Z
Z
Z
Z
J
J
J
a
a
a
a
a
a
a
a
a
a
l
l
l
l
l
l
l
l
l
l
l
l
l
y
y
y
y
y
y
a
"}
(13,1,1) = {"
a
a
a
a
c
c
c
c
c
c
c
J
J
J
a
V
V
V
V
V
V
V
a
a
l
l
l
l
l
l
l
l
l
l
l
l
l
y
y
y
y
y
y
a
"}
(14,1,1) = {"
a
a
a
a
c
c
c
c
c
c
c
J
J
J
a
V
V
V
V
V
V
V
a
a
l
l
l
l
l
l
l
l
l
l
l
l
l
y
y
y
y
y
y
a
"}
(15,1,1) = {"
a
a
a
a
c
c
c
c
c
c
c
J
J
J
a
V
V
V
V
V
V
V
V
V
l
l
l
l
l
l
l
l
l
l
l
l
l
y
y
y
y
y
y
a
"}
(16,1,1) = {"
a
a
a
a
c
c
c
c
c
c
c
J
J
J
a
V
V
V
V
V
V
V
V
V
l
l
l
l
l
l
l
l
l
l
l
l
l
y
y
y
y
y
y
a
"}
(17,1,1) = {"
a
a
a
a
c
c
c
c
c
c
c
J
J
J
a
V
V
V
V
V
V
V
V
V
l
l
l
l
l
l
l
l
l
l
l
l
l
y
y
y
y
y
y
a
"}
(18,1,1) = {"
a
a
a
a
c
c
c
c
c
c
c
J
J
J
a
V
V
V
V
V
V
V
a
a
l
l
l
l
l
l
l
l
l
l
l
l
l
y
y
y
y
y
y
a
"}
(19,1,1) = {"
a
a
a
a
P
P
P
P
P
P
P
J
J
J
a
V
V
V
V
V
V
V
a
a
l
l
l
l
l
l
l
l
l
l
l
l
l
y
y
y
y
y
y
a
"}
(20,1,1) = {"
a
a
a
a
P
P
P
P
P
P
P
J
J
J
a
a
a
a
a
a
a
a
a
a
l
l
l
l
l
l
l
l
l
l
l
l
l
y
y
y
y
y
y
a
"}
(21,1,1) = {"
a
a
a
a
P
P
P
P
P
P
P
J
J
J
J
J
J
J
J
J
J
J
J
J
l
l
l
l
l
l
l
l
l
l
l
l
l
y
y
y
y
y
y
a
"}
(22,1,1) = {"
a
a
a
a
P
P
P
P
P
P
P
J
J
J
J
J
J
J
J
J
J
J
J
J
l
l
l
l
l
l
l
l
l
l
l
l
l
y
y
y
y
y
y
a
"}
(23,1,1) = {"
a
a
a
a
P
P
P
P
P
P
P
J
J
J
J
J
J
J
J
J
J
J
J
J
l
l
l
l
l
l
l
l
l
l
l
l
l
y
y
y
y
y
y
a
"}
(24,1,1) = {"
a
a
a
a
P
P
P
P
P
P
P
E
E
E
E
E
E
e
e
e
e
e
e
e
l
l
l
l
l
l
l
l
l
l
l
l
l
y
y
y
y
y
y
a
"}
(25,1,1) = {"
a
a
a
a
W
P
P
P
P
P
P
E
E
E
E
E
E
e
e
e
e
e
e
e
l
l
l
l
l
l
l
l
l
l
l
l
l
y
y
y
y
y
y
a
"}
(26,1,1) = {"
a
a
a
a
W
P
P
P
P
P
P
E
E
E
E
E
E
e
e
e
e
e
e
e
l
l
l
l
l
l
l
l
l
l
l
l
l
y
y
y
y
y
y
a
"}
(27,1,1) = {"
a
a
a
a
W
P
P
P
P
P
P
E
E
E
E
E
E
e
e
e
e
e
e
e
l
l
l
l
l
l
l
l
l
l
l
l
l
y
y
y
y
y
y
a
"}
(28,1,1) = {"
a
a
a
a
W
P
P
P
P
P
P
E
E
E
E
E
E
e
e
e
e
e
e
e
l
l
l
l
l
l
l
l
l
l
l
l
l
y
y
y
y
y
y
a
"}
(29,1,1) = {"
a
a
a
a
W
P
P
P
P
P
P
E
E
E
E
E
E
e
e
e
e
e
e
e
l
l
l
l
l
l
l
l
l
l
l
l
l
y
y
y
y
y
y
a
"}
(30,1,1) = {"
a
a
a
a
W
P
P
P
P
P
P
E
E
E
E
E
E
e
e
e
e
e
e
e
l
l
l
l
l
l
l
l
l
l
l
l
l
y
y
y
y
y
y
a
"}
(31,1,1) = {"
a
a
a
a
W
P
P
P
P
P
P
E
E
E
E
E
E
e
e
e
e
e
e
e
l
l
l
l
l
l
l
l
l
l
l
l
l
y
y
y
y
y
y
a
"}
(32,1,1) = {"
a
a
a
a
W
W
W
M
W
W
W
E
E
E
E
E
E
e
e
e
e
e
e
e
l
l
l
l
l
l
l
l
l
l
l
l
l
y
y
y
y
y
y
a
"}
(33,1,1) = {"
a
a
a
a
a
a
x
h
R
a
a
a
a
a
a
a
a
a
a
a
a
a
X
a
a
T
a
a
a
a
a
a
a
a
a
a
a
a
a
a
a
a
a
a
"}
(34,1,1) = {"
a
a
a
a
a
a
x
h
R
a
a
a
a
t
w
z
a
n
j
n
a
a
a
a
O
a
a
X
a
b
j
b
a
a
a
a
a
a
a
a
a
a
a
a
"}
(35,1,1) = {"
a
a
a
a
a
W
W
M
W
W
a
a
a
t
v
z
a
n
s
n
X
O
a
a
a
a
a
a
a
b
j
b
a
a
a
a
a
a
a
a
a
a
a
a
"}
(36,1,1) = {"
a
a
a
a
a
S
A
m
B
W
W
W
a
a
s
a
a
a
s
a
a
a
a
a
a
a
j
a
a
a
j
a
a
a
a
a
a
a
a
a
a
a
a
a
"}
(37,1,1) = {"
a
a
a
a
a
S
H
f
q
K
o
F
D
D
G
D
D
D
Y
D
O
a
a
j
O
a
j
O
j
j
j
j
j
p
a
a
a
a
a
a
a
a
a
a
"}
(38,1,1) = {"
a
a
a
a
a
S
r
g
L
W
W
W
a
a
s
a
a
a
s
a
a
a
a
a
a
a
j
a
a
a
j
a
a
a
a
a
a
a
a
a
a
a
a
a
"}
(39,1,1) = {"
a
a
a
a
a
W
W
W
W
W
a
a
a
z
C
t
a
n
s
n
a
a
a
O
a
d
j
Q
a
b
j
i
a
a
a
a
a
a
a
a
a
a
a
a
"}
(40,1,1) = {"
a
a
a
a
a
a
a
a
a
a
a
a
a
z
u
t
a
n
j
U
a
j
a
a
X
d
j
Q
a
b
j
b
a
a
a
a
a
a
a
a
a
a
a
a
"}
