//MAP CONVERTED BY dmm2tgm.py THIS HEADER COMMENT PREVENTS RECONVERSION, DO NOT REMOVE
"a" = (
/turf/closed/mineral/random/asteroid,
/area/space)
"f" = (
/obj/effect/mob_spawn/corpse/human/miner/explorer,
/obj/effect/decal/cleanable/blood,
/turf/open/misc/asteroid/airless/tospace,
/area/space)
"l" = (
/turf/open/space/basic,
/area/space)
"q" = (
/obj/item/reagent_containers/hypospray/medipen,
/obj/effect/decal/cleanable/blood,
/turf/open/misc/asteroid/airless/tospace,
/area/space)
"w" = (
/obj/effect/mob_spawn/corpse/goliath,
/obj/effect/decal/cleanable/blood,
/turf/open/misc/asteroid/airless/tospace,
/area/space)
"x" = (
/obj/item/pickaxe,
/obj/effect/decal/cleanable/blood,
/turf/open/misc/asteroid/airless/tospace,
/area/space)
"P" = (
/obj/effect/decal/cleanable/blood,
/turf/open/misc/asteroid/airless/tospace,
/area/space)

(1,1,1) = {"
l
a
a
a
a
a
l
"}
(2,1,1) = {"
a
a
a
a
a
a
a
"}
(3,1,1) = {"
a
a
f
q
P
a
a
"}
(4,1,1) = {"
a
a
x
P
P
a
a
"}
(5,1,1) = {"
a
a
P
P
w
a
a
"}
(6,1,1) = {"
a
a
a
a
a
a
a
"}
(7,1,1) = {"
l
a
a
a
a
a
l
"}
