//MAP CONVERTED BY dmm2tgm.py THIS HEADER COMMENT PREVENTS RECONVERSION, DO NOT REMOVE
"a" = (
/turf/open/space/basic,
/area/space)
"s" = (
/turf/closed/mineral/artifact,
/area/space)

(1,1,1) = {"
a
a
a
s
s
s
a
a
a
"}
(2,1,1) = {"
a
s
s
s
s
s
s
s
a
"}
(3,1,1) = {"
a
s
s
s
s
s
s
s
a
"}
(4,1,1) = {"
s
s
s
s
s
s
s
s
s
"}
(5,1,1) = {"
s
s
s
s
s
s
s
s
s
"}
(6,1,1) = {"
s
s
s
s
s
s
s
s
s
"}
(7,1,1) = {"
a
s
s
s
s
s
s
s
a
"}
(8,1,1) = {"
a
s
s
s
s
s
s
s
a
"}
(9,1,1) = {"
a
a
a
s
s
s
a
a
a
"}
