//MAP CONVERTED BY dmm2tgm.py THIS HEADER COMMENT PREVENTS RECONVERSION, DO NOT REMOVE
"a" = (
/turf/closed/mineral/random/asteroid/tospace,
/area/space)
"e" = (
/turf/open/space/basic,
/area/space)

(1,1,1) = {"
e
e
e
e
e
e
e
a
e
e
e
e
e
e
e
"}
(2,1,1) = {"
e
e
e
e
e
a
a
a
a
a
e
e
e
e
e
"}
(3,1,1) = {"
e
e
e
a
a
a
a
a
a
a
a
a
e
e
e
"}
(4,1,1) = {"
e
e
a
a
a
a
a
a
a
a
a
a
a
e
e
"}
(5,1,1) = {"
e
e
a
a
a
a
a
a
a
a
a
a
a
e
e
"}
(6,1,1) = {"
e
a
a
a
a
a
a
a
a
a
a
a
a
a
e
"}
(7,1,1) = {"
e
a
a
a
a
a
a
a
a
a
a
a
a
a
e
"}
(8,1,1) = {"
a
a
a
a
a
a
a
a
a
a
a
a
a
a
a
"}
(9,1,1) = {"
e
a
a
a
a
a
a
a
a
a
a
a
a
a
e
"}
(10,1,1) = {"
e
a
a
a
a
a
a
a
a
a
a
a
a
a
e
"}
(11,1,1) = {"
e
e
a
a
a
a
a
a
a
a
a
a
a
e
e
"}
(12,1,1) = {"
e
e
a
a
a
a
a
a
a
a
a
a
a
e
e
"}
(13,1,1) = {"
e
e
e
a
a
a
a
a
a
a
a
a
e
e
e
"}
(14,1,1) = {"
e
e
e
e
e
a
a
a
a
a
e
e
e
e
e
"}
(15,1,1) = {"
e
e
e
e
e
e
e
a
e
e
e
e
e
e
e
"}
