//MAP CONVERTED BY dmm2tgm.py THIS HEADER COMMENT PREVENTS RECONVERSION, DO NOT REMOVE
"a" = (
/turf/closed/mineral/random/asteroid/tospace/highchance,
/area/space)
"W" = (
/turf/open/space/basic,
/area/space)

(1,1,1) = {"
W
a
a
a
a
a
W
"}
(2,1,1) = {"
a
a
a
a
a
a
a
"}
(3,1,1) = {"
a
a
a
a
a
a
a
"}
(4,1,1) = {"
a
a
a
a
a
a
a
"}
(5,1,1) = {"
a
a
a
a
a
a
a
"}
(6,1,1) = {"
a
a
a
a
a
a
a
"}
(7,1,1) = {"
W
a
a
a
a
a
W
"}
