//MAP CONVERTED BY dmm2tgm.py THIS HEADER COMMENT PREVENTS RECONVERSION, DO NOT REMOVE
"a" = (
/turf/open/space/basic,
/area/space)
"K" = (
/turf/open/misc/asteroid/airless/tospace,
/area/space)
"M" = (
/turf/closed/mineral/random/asteroid/tospace,
/area/space)

(1,1,1) = {"
a
a
a
a
a
a
a
M
a
a
a
a
a
a
a
"}
(2,1,1) = {"
a
a
a
a
a
M
M
M
M
M
a
a
a
a
a
"}
(3,1,1) = {"
a
a
a
M
M
M
M
M
M
M
M
M
a
a
a
"}
(4,1,1) = {"
a
a
M
M
M
M
M
M
M
M
M
M
M
a
a
"}
(5,1,1) = {"
a
a
M
M
M
M
M
M
M
M
M
K
M
a
a
"}
(6,1,1) = {"
a
M
M
M
K
M
M
M
M
M
K
M
M
M
a
"}
(7,1,1) = {"
a
M
M
M
M
M
M
M
M
M
K
M
M
M
a
"}
(8,1,1) = {"
M
M
M
M
M
M
M
K
M
M
K
M
M
M
M
"}
(9,1,1) = {"
a
M
M
M
M
M
M
M
M
M
K
M
M
M
a
"}
(10,1,1) = {"
a
M
M
M
K
M
M
M
M
M
K
M
M
M
a
"}
(11,1,1) = {"
a
a
M
M
M
M
M
M
M
M
M
K
M
a
a
"}
(12,1,1) = {"
a
a
M
M
M
M
M
M
M
M
M
M
M
a
a
"}
(13,1,1) = {"
a
a
a
M
M
M
M
M
M
M
M
M
a
a
a
"}
(14,1,1) = {"
a
a
a
a
a
M
M
M
M
M
a
a
a
a
a
"}
(15,1,1) = {"
a
a
a
a
a
a
a
M
a
a
a
a
a
a
a
"}
