// This map has been converted using maphash
"sjn" = (/turf/open/indestructible/hotelwood,/area/hilbertshotelstorage)
"xXN" = (/turf/closed/indestructible/hotelwall,/area/hilbertshotelstorage)

(1,1,1) = {"
xXN
xXN
xXN
"}
(2,1,1) = {"
xXN
sjn
xXN
"}
(3,1,1) = {"
xXN
xXN
xXN
"}
