// This map has been converted using maphash
"eMp" = (/turf/closed/indestructible/hotelwall,/area/hilbertshotel)
"fAq" = (/turf/closed/indestructible/hoteldoor,/area/hilbertshotel)
"gkf" = (/turf/open/indestructible/hoteltile,/area/hilbertshotel)
"lIa" = (/turf/open/indestructible/hotelwood,/area/hilbertshotel)
"tWP" = (/turf/open/space/bluespace,/area/hilbertshotel)

(1,1,1) = {"
tWP
tWP
tWP
tWP
tWP
tWP
tWP
tWP
tWP
tWP
tWP
tWP
tWP
tWP
tWP
"}
(2,1,1) = {"
tWP
eMp
eMp
eMp
eMp
eMp
fAq
eMp
eMp
eMp
eMp
eMp
eMp
eMp
tWP
"}
(3,1,1) = {"
tWP
eMp
lIa
lIa
lIa
lIa
lIa
lIa
lIa
lIa
lIa
lIa
lIa
eMp
tWP
"}
(4,1,1) = {"
tWP
eMp
lIa
lIa
lIa
lIa
lIa
lIa
lIa
lIa
lIa
lIa
lIa
eMp
tWP
"}
(5,1,1) = {"
tWP
eMp
lIa
lIa
lIa
lIa
lIa
lIa
lIa
lIa
lIa
lIa
lIa
eMp
tWP
"}
(6,1,1) = {"
tWP
eMp
lIa
lIa
lIa
lIa
lIa
lIa
lIa
lIa
lIa
lIa
lIa
eMp
tWP
"}
(7,1,1) = {"
tWP
eMp
lIa
lIa
lIa
lIa
lIa
lIa
lIa
lIa
lIa
lIa
lIa
eMp
tWP
"}
(8,1,1) = {"
tWP
eMp
eMp
eMp
eMp
lIa
eMp
eMp
eMp
eMp
eMp
eMp
eMp
eMp
tWP
"}
(9,1,1) = {"
tWP
eMp
lIa
lIa
lIa
lIa
lIa
lIa
gkf
gkf
gkf
gkf
gkf
eMp
tWP
"}
(10,1,1) = {"
tWP
eMp
lIa
lIa
lIa
lIa
lIa
eMp
gkf
gkf
gkf
gkf
gkf
eMp
tWP
"}
(11,1,1) = {"
tWP
eMp
lIa
lIa
lIa
lIa
lIa
eMp
gkf
gkf
gkf
gkf
gkf
eMp
tWP
"}
(12,1,1) = {"
tWP
eMp
lIa
lIa
lIa
lIa
lIa
eMp
gkf
gkf
gkf
gkf
gkf
eMp
tWP
"}
(13,1,1) = {"
tWP
eMp
lIa
lIa
lIa
lIa
lIa
eMp
gkf
gkf
gkf
gkf
gkf
eMp
tWP
"}
(14,1,1) = {"
tWP
eMp
lIa
lIa
lIa
lIa
lIa
eMp
gkf
gkf
gkf
gkf
gkf
eMp
tWP
"}
(15,1,1) = {"
tWP
eMp
eMp
eMp
eMp
eMp
eMp
eMp
eMp
eMp
eMp
eMp
eMp
eMp
tWP
"}
(16,1,1) = {"
tWP
tWP
tWP
tWP
tWP
tWP
tWP
tWP
tWP
tWP
tWP
tWP
tWP
tWP
tWP
"}
