// This map has been converted using maphash
"arG" = (/turf/template_noop,/area/template_noop)
"czH" = (/obj/machinery/door/airlock/external/glass,/turf/open/floor/plating,/area/ruin/powered/shuttle/medium_1)
"dpg" = (/obj/structure/table,/obj/item/storage/firstaid/regular,/obj/effect/turf_decal/tile/blue{dir = 1},/obj/effect/turf_decal/tile/blue,/obj/effect/turf_decal/tile/blue{dir = 4},/obj/effect/turf_decal/tile/blue{dir = 8},/turf/open/floor/plasteel/dark,/area/ruin/powered/shuttle/medium_1)
"fAW" = (/obj/effect/spawner/structure/window/shuttle,/turf/open/floor/plating,/area/ruin/powered/shuttle/medium_1)
"iyn" = (/obj/machinery/power/smes/magical,/turf/open/floor/plasteel,/area/ruin/powered/shuttle/medium_1)
"jPM" = (/turf/open/floor/plasteel/dark,/area/ruin/powered/shuttle/medium_1)
"kmi" = (/obj/structure/shuttle/engine/propulsion/burst/left{dir = 8},/turf/open/space,/area/ruin/powered/shuttle/medium_1)
"mqQ" = (/obj/machinery/door/airlock/public/glass,/turf/open/floor/plasteel,/area/ruin/powered/shuttle/medium_1)
"nrD" = (/obj/structure/shuttle/engine/heater{dir = 8},/obj/structure/window/reinforced{dir = 4},/turf/open/floor/plating/airless,/area/ruin/powered/shuttle/medium_1)
"pqm" = (/turf/closed/wall/mineral/titanium/overspace,/area/ruin/powered/shuttle/medium_1)
"qSy" = (/obj/machinery/sleeper,/obj/effect/turf_decal/tile/blue{dir = 1},/obj/effect/turf_decal/tile/blue,/obj/effect/turf_decal/tile/blue{dir = 4},/obj/effect/turf_decal/tile/blue{dir = 8},/turf/open/floor/plasteel/dark,/area/ruin/powered/shuttle/medium_1)
"rov" = (/obj/structure/shuttle/engine/propulsion/burst/right{dir = 8},/turf/open/space,/area/ruin/powered/shuttle/medium_1)
"sHR" = (/turf/closed/wall/mineral/titanium,/area/ruin/powered/shuttle/medium_1)
"txt" = (/obj/structure/table/reinforced,/obj/effect/turf_decal/tile/yellow{dir = 1},/obj/effect/turf_decal/tile/yellow,/obj/effect/turf_decal/tile/yellow{dir = 4},/obj/effect/turf_decal/tile/yellow{dir = 8},/turf/open/floor/plasteel/dark,/area/ruin/powered/shuttle/medium_1)
"tPz" = (/obj/effect/spawner/structure/window/reinforced,/turf/open/floor/plating,/area/ruin/powered/shuttle/medium_1)
"tTX" = (/obj/effect/turf_decal/tile/blue{dir = 1},/obj/effect/turf_decal/tile/blue,/obj/effect/turf_decal/tile/blue{dir = 4},/obj/effect/turf_decal/tile/blue{dir = 8},/turf/open/floor/plasteel/dark,/area/ruin/powered/shuttle/medium_1)
"vXc" = (/turf/open/floor/plasteel,/area/ruin/powered/shuttle/medium_1)
"wIP" = (/obj/structure/chair/comfy{dir = 4},/obj/effect/turf_decal/tile/yellow{dir = 1},/obj/effect/turf_decal/tile/yellow,/obj/effect/turf_decal/tile/yellow{dir = 4},/obj/effect/turf_decal/tile/yellow{dir = 8},/turf/open/floor/plasteel/dark,/area/ruin/powered/shuttle/medium_1)
"wWi" = (/obj/effect/turf_decal/tile/yellow{dir = 1},/obj/effect/turf_decal/tile/yellow,/obj/effect/turf_decal/tile/yellow{dir = 4},/obj/effect/turf_decal/tile/yellow{dir = 8},/turf/open/floor/plasteel/dark,/area/ruin/powered/shuttle/medium_1)
"xuN" = (/turf/closed/wall/mineral/plastitanium,/area/ruin/powered/shuttle/medium_1)
"ykR" = (/obj/machinery/door/airlock/public/glass,/turf/open/floor/plasteel/dark,/area/ruin/powered/shuttle/medium_1)

(1,1,1) = {"
arG
arG
arG
arG
arG
pqm
czH
sHR
czH
pqm
arG
arG
arG
arG
arG
"}
(2,1,1) = {"
arG
arG
arG
arG
arG
sHR
vXc
vXc
vXc
sHR
arG
arG
arG
arG
arG
"}
(3,1,1) = {"
arG
arG
arG
pqm
sHR
sHR
mqQ
sHR
mqQ
sHR
sHR
pqm
arG
arG
arG
"}
(4,1,1) = {"
kmi
kmi
kmi
sHR
jPM
sHR
vXc
vXc
vXc
sHR
jPM
sHR
rov
rov
rov
"}
(5,1,1) = {"
nrD
nrD
nrD
sHR
jPM
ykR
vXc
iyn
vXc
ykR
jPM
sHR
nrD
nrD
nrD
"}
(6,1,1) = {"
xuN
xuN
sHR
sHR
ykR
sHR
sHR
sHR
sHR
sHR
ykR
sHR
sHR
xuN
xuN
"}
(7,1,1) = {"
xuN
xuN
sHR
jPM
jPM
sHR
jPM
jPM
jPM
sHR
jPM
jPM
sHR
xuN
xuN
"}
(8,1,1) = {"
xuN
xuN
sHR
jPM
jPM
ykR
jPM
jPM
jPM
ykR
jPM
jPM
sHR
xuN
xuN
"}
(9,1,1) = {"
xuN
xuN
sHR
jPM
jPM
sHR
jPM
jPM
jPM
sHR
jPM
jPM
sHR
xuN
arG
"}
(10,1,1) = {"
arG
xuN
sHR
sHR
sHR
sHR
ykR
sHR
ykR
sHR
sHR
sHR
sHR
arG
arG
"}
(11,1,1) = {"
arG
arG
czH
jPM
ykR
jPM
jPM
fAW
jPM
jPM
ykR
jPM
czH
arG
arG
"}
(12,1,1) = {"
arG
arG
czH
jPM
sHR
jPM
jPM
fAW
jPM
jPM
sHR
jPM
czH
arG
arG
"}
(13,1,1) = {"
arG
arG
pqm
sHR
sHR
sHR
ykR
sHR
ykR
sHR
sHR
sHR
pqm
arG
arG
"}
(14,1,1) = {"
arG
arG
arG
arG
sHR
dpg
tTX
fAW
jPM
jPM
sHR
arG
arG
arG
arG
"}
(15,1,1) = {"
arG
arG
arG
arG
sHR
qSy
tTX
fAW
jPM
jPM
sHR
arG
arG
arG
arG
"}
(16,1,1) = {"
arG
arG
arG
arG
sHR
sHR
ykR
sHR
ykR
sHR
sHR
arG
arG
arG
arG
"}
(17,1,1) = {"
arG
arG
arG
arG
sHR
jPM
jPM
sHR
jPM
jPM
sHR
arG
arG
arG
arG
"}
(18,1,1) = {"
arG
arG
arG
arG
sHR
jPM
jPM
sHR
jPM
jPM
sHR
arG
arG
arG
arG
"}
(19,1,1) = {"
arG
arG
arG
arG
pqm
sHR
ykR
sHR
ykR
sHR
pqm
arG
arG
arG
arG
"}
(20,1,1) = {"
arG
arG
arG
arG
arG
sHR
wWi
wWi
wWi
sHR
arG
arG
arG
arG
arG
"}
(21,1,1) = {"
arG
arG
arG
arG
arG
sHR
wWi
wIP
wWi
sHR
arG
arG
arG
arG
arG
"}
(22,1,1) = {"
arG
arG
arG
arG
arG
sHR
txt
txt
txt
sHR
arG
arG
arG
arG
arG
"}
(23,1,1) = {"
arG
arG
arG
arG
arG
pqm
tPz
tPz
tPz
pqm
arG
arG
arG
arG
arG
"}
